21,"{'华安基金管理有限公司', '100000', '宿明杰', '华泰财产保险股份有限公司', '吴梅林', '珠海稳健投资有限公司', '易方达基金管理有限公司', '李从武', '兴业证券股份有限公司', '1050000', '定价', '200000', '800000', '鹏华基金管理有限公司', '50000', '3200000', '370000', '红塔证券股份有限公司', '180000', '1000000', '12'}",541613,0,set(),4,"{'华泰财产保险股份有限公司', '定价', '12', '鹏华基金管理有限公司'}",21,"{'华安基金管理有限公司', '100000', '宿明杰', '华泰财产保险股份有限公司', '吴梅林', '珠海稳健投资有限公司', '易方达基金管理有限公司', '李从武', '兴业证券股份有限公司', '1050000', '定价', '200000', '800000', '鹏华基金管理有限公司', '50000', '3200000', '370000', '红塔证券股份有限公司', '180000', '1000000', '12'}"
12,"{'11206328', '现金', '339999991.5', '169999995.8', '5603164', '嘉实基金管理有限公司', '竞价', '9190508', '上海中汇金锐投资管理有限公司', '前海开源基金管理有限公司', '12', '278840012.7'}",15903490,2,"{'竞价', '169999995.8'}",5,"{'现金', '12', '嘉实基金管理有限公司', '前海开源基金管理有限公司', '上海中汇金锐投资管理有限公司'}",10,"{'11206328', '现金', '339999991.5', '5603164', '12', '嘉实基金管理有限公司', '9190508', '前海开源基金管理有限公司', '上海中汇金锐投资管理有限公司', '278840012.7'}"
6,"{'现金', '8521516', '梁桂秋', '竞价', '200000000', '36'}",4952968,1,{'竞价'},3,"{'现金', '36', '梁桂秋'}",5,"{'现金', '8521516', '梁桂秋', '200000000', '36'}"
7,"{'威海保利', '现金', '定价', '563960000', '508590000', '36', '保利壹期'}",15723090,2,"{'508590000', '563960000'}",5,"{'威海保利', '现金', '定价', '36', '保利壹期'}",5,"{'威海保利', '现金', '定价', '36', '保利壹期'}"
4,"{'陈邦', '竞价', '现金', '36'}",15524198,0,set(),4,"{'陈邦', '竞价', '现金', '36'}",4,"{'陈邦', '竞价', '现金', '36'}"
18,"{'大同煤矿集团有限责任公司', '现金', '138121546', '12', '267000000', '国开泰富基金管理有限责任公司', '泰达宏利基金管理有限公司', '财通基金管理有限公司', '23204423', '276243093', '1000000000', '竞价', '82872928', '300000000', '500000000', '中投知本汇(北京)资产管理有限公司', '华安未来资产管理(上海)有限公司', '36'}",15658716,1,{'竞价'},7,"{'36', '大同煤矿集团有限责任公司', '现金', '国开泰富基金管理有限责任公司', '财通基金管理有限公司', '泰达宏利基金管理有限公司', '12'}",17,"{'大同煤矿集团有限责任公司', '现金', '138121546', '12', '267000000', '国开泰富基金管理有限责任公司', '泰达宏利基金管理有限公司', '财通基金管理有限公司', '23204423', '276243093', '1000000000', '82872928', '300000000', '500000000', '中投知本汇(北京)资产管理有限公司', '华安未来资产管理(上海)有限公司', '36'}"
2,"{'竞价', '天津滨海发展投资控股有限公司'}",224128,1,{'竞价'},1,{'天津滨海发展投资控股有限公司'},1,{'天津滨海发展投资控股有限公司'}
24,"{'光大证券股份有限公司', '165000000', '4000000', '3000000', '33000000', '8000000', '5000000', '新华人寿保险股份有限公司', '上投摩根基金管理有限公司', '定价', '99000000', '264000000', '66000000', '无锡亿利大机械有限公司', 'JF资产管理有限公司', '长盛基金管理有限公司', '中信证券股份有限公司', '中融国际信托投资有限公司', '2000000', '红塔证券股份有限公司', '132000000', '1000000', '中海基金管理有限公司', '12'}",545345,6,"{'66000000', '165000000', '99000000', '33000000', '132000000', '264000000'}",11,"{'光大证券股份有限公司', '上投摩根基金管理有限公司', '新华人寿保险股份有限公司', '无锡亿利大机械有限公司', '定价', '长盛基金管理有限公司', '红塔证券股份有限公司', '中信证券股份有限公司', '中融国际信托投资有限公司', '中海基金管理有限公司', '12'}",18,"{'5000000', '光大证券股份有限公司', '8000000', '无锡亿利大机械有限公司', '新华人寿保险股份有限公司', 'JF资产管理有限公司', '上投摩根基金管理有限公司', '4000000', '长盛基金管理有限公司', '定价', '2000000', '红塔证券股份有限公司', '3000000', '中信证券股份有限公司', '中融国际信托投资有限公司', '1000000', '中海基金管理有限公司', '12'}"
15,"{'南京瑞森投资管理合伙企业(有限合伙)', '北方凌云工业集团有限公司', '中兵投资管理有限责任公司', '现金', '150000000', '3684598', '400000000', '长城国融投资管理有限公司', '14738393', '苏州瑞顺创业投资企业(有限合伙)', '29476787', '11053795', '50000000', '200000000', '36'}",292459,0,set(),5,"{'北方凌云工业集团有限公司', '中兵投资管理有限责任公司', '现金', '长城国融投资管理有限公司', '36'}",15,"{'南京瑞森投资管理合伙企业(有限合伙)', '北方凌云工业集团有限公司', '中兵投资管理有限责任公司', '现金', '150000000', '3684598', '400000000', '长城国融投资管理有限公司', '14738393', '苏州瑞顺创业投资企业(有限合伙)', '29476787', '11053795', '50000000', '200000000', '36'}"
4,"{'上海六禾投资有限公司', '兴业财富资产管理有限公司', '东吴基金管理有限公司', '财通基金管理有限公司'}",16193636,0,set(),4,"{'上海六禾投资有限公司', '兴业财富资产管理有限公司', '东吴基金管理有限公司', '财通基金管理有限公司'}",4,"{'上海六禾投资有限公司', '兴业财富资产管理有限公司', '东吴基金管理有限公司', '财通基金管理有限公司'}"
10,"{'郑伟光', '现金', '10645848', '西藏莱美', '瑞森投资', '7097232', '8871540', '20581973', '36', '六禾世元'}",98454,0,set(),6,"{'36', '现金', '西藏莱美', '瑞森投资', '郑伟光', '六禾世元'}",10,"{'36', '现金', '10645848', '西藏莱美', '瑞森投资', '7097232', '8871540', '20581973', '郑伟光', '六禾世元'}"
24,"{'西藏丹巴达杰科技有限公司', '196205680', '现金', '256401576.1', '竞价', '上海纪辉资产管理有限公司', '184670300', '47089363', '1111073529', '共青城量能投资管理合伙企业(有限合伙)', '102026954', '北京新华富时资产管理有限公司', '512803164.6', '天安人寿保险股份有限公司', '西藏格桑梅朵科技有限公司', '62785818', '2011059567', '23544681', '769204750.1', '余斌', '2136679855', '70634045', '683737558', '36'}",14111106,4,"{'512803164.6', '竞价', '256401576.1', '769204750.1'}",8,"{'现金', '北京新华富时资产管理有限公司', '天安人寿保险股份有限公司', '西藏丹巴达杰科技有限公司', '上海纪辉资产管理有限公司', '西藏格桑梅朵科技有限公司', '余斌', '36'}",20,"{'共青城量能投资管理合伙企业(有限合伙)', '102026954', '62785818', '现金', '北京新华富时资产管理有限公司', '天安人寿保险股份有限公司', '1111073529', '西藏丹巴达杰科技有限公司', '23544681', '上海纪辉资产管理有限公司', '184670300', '2136679855', '西藏格桑梅朵科技有限公司', '余斌', '47089363', '196205680', '70634045', '683737558', '36', '2011059567'}"
16,"{'羚锐发展', '银高投资', '11500000', '现金', '百瑞信托', '124200000', '4000000', '定价', '京裕投资', '118800000', '11000000', '4629629', '49999993.2', '43200000', '上海证券', '36'}",1150097,8,"{'11500000', '124200000', '4000000', '118800000', '11000000', '4629629', '49999993.2', '43200000'}",8,"{'羚锐发展', '银高投资', '现金', '百瑞信托', '定价', '京裕投资', '上海证券', '36'}",8,"{'羚锐发展', '银高投资', '现金', '百瑞信托', '定价', '京裕投资', '上海证券', '36'}"
6,"{'现金', '1818600000', '竞价', '上港集团', '420000000', '36'}",314490,3,"{'竞价', '420000000', '1818600000'}",3,"{'36', '上港集团', '现金'}",3,"{'现金', '上港集团', '36'}"
24,"{'10638297', '国投瑞银基金管理有限公司', '11702127', '现金', '109999995.7', '西部证券股份有限公司', '财通基金管理有限公司', '竞价', '5718090', '诺德基金管理有限公司', '17420212', '北信瑞丰基金管理有限公司', '10771276', '130999994.2', '87999995.04', '14627659', '九泰基金管理有限公司', '瑞元资本管理有限公司', '天弘基金管理有限公司', '孙晓光', '43000036.8', '79999993.44', '80999995.52', '12'}",15335815,5,"{'109999995.7', '竞价', '79999993.44', '80999995.52', '87999995.04'}",11,"{'现金', '北信瑞丰基金管理有限公司', '九泰基金管理有限公司', '瑞元资本管理有限公司', '西部证券股份有限公司', '财通基金管理有限公司', '天弘基金管理有限公司', '孙晓光', '国投瑞银基金管理有限公司', '诺德基金管理有限公司', '12'}",19,"{'11702127', '现金', '北信瑞丰基金管理有限公司', '九泰基金管理有限公司', '10638297', '瑞元资本管理有限公司', '西部证券股份有限公司', '财通基金管理有限公司', '天弘基金管理有限公司', '孙晓光', '43000036.8', '10771276', '130999994.2', '5718090', '国投瑞银基金管理有限公司', '诺德基金管理有限公司', '17420212', '12', '14627659'}"
11,"{'天津康荣股权投资合伙企业(有限合伙)', '现金', '天津六禾碧云股权投资基金合伙企业(有限合伙)', '3610000', '博时基金管理有限公司', '2400000', '竞价', '3000000', '博弘数君(天津)股权投资基金合伙企业(有限合伙)', '8000000', '12'}",1219384,10,"{'天津康荣股权投资合伙企业(有限合伙)', '现金', '天津六禾碧云股权投资基金合伙企业(有限合伙)', '3610000', '博时基金管理有限公司', '2400000', '竞价', '3000000', '博弘数君(天津)股权投资基金合伙企业(有限合伙)', '8000000'}",1,{'12'},1,{'12'}
6,"{'现金', '423000000', '定价', '天津开发区德源投资发展有限公司', '20200000', '36'}",1423666,2,"{'423000000', '20200000'}",4,"{'天津开发区德源投资发展有限公司', '现金', '定价', '36'}",4,"{'天津开发区德源投资发展有限公司', '定价', '现金', '36'}"
19,"{'6000000', '现金', '中国国际金融有限公司*', '华安基金管理有限公司', '5000000', '江苏瑞华投资发展有限公司', '定价', '15000000', '德意志银行', '7000000', '24', '深圳市海丰源投资股份有限公司', '富国基金管理有限公司', '中再资产管理有限公司', '中化化肥有限公司', '10000000', '国联证券有限责任公司', '上海证券有限责任公司', '12'}",532151,2,"{'10000000', '定价'}",13,"{'6000000', '现金', '华安基金管理有限公司', '江苏瑞华投资发展有限公司', '德意志银行', '24', '深圳市海丰源投资股份有限公司', '富国基金管理有限公司', '中再资产管理有限公司', '中化化肥有限公司', '国联证券有限责任公司', '上海证券有限责任公司', '12'}",17,"{'6000000', '现金', '中国国际金融有限公司*', '华安基金管理有限公司', '5000000', '江苏瑞华投资发展有限公司', '15000000', '德意志银行', '7000000', '24', '深圳市海丰源投资股份有限公司', '富国基金管理有限公司', '中再资产管理有限公司', '中化化肥有限公司', '国联证券有限责任公司', '上海证券有限责任公司', '12'}"
9,"{'2069356300', '现金', '451328200', '云南黄金', '竞价', '601770900', '云铜集团', '迪庆州投', '36'}",15328374,3,"{'2069356300', '451328200', '601770900'}",6,"{'现金', '云南黄金', '竞价', '云铜集团', '迪庆州投', '36'}",6,"{'现金', '云南黄金', '竞价', '云铜集团', '迪庆州投', '36'}"
21,"{'华安基金管理有限公司', '浙商证券有限责任公司', '1900000', '杭州财通网络科技有限公司', '39864000', '泰康人寿保险股份有限公司', '兴业证券股份有限公司', '1200000', '国泰君安证券股份有限公司', '9060000', '10872000', '17214000', '上海申能资产管理有限公司', '4400000', '七匹狼投资股份有限公司', '1500000', 'Deutsche Bank Aktiengesellschaft', '13590000', '台州市恒焜基础工程有限公司', '1000000', '12'}",972134,9,"{'17214000', '1900000', '4400000', '10872000', '1200000', '1500000', '39864000', '9060000', '13590000'}",2,"{'Deutsche Bank Aktiengesellschaft', '12'}",12,"{'华安基金管理有限公司', '兴业证券股份有限公司', '上海申能资产管理有限公司', '浙商证券有限责任公司', '台州市恒焜基础工程有限公司', '杭州财通网络科技有限公司', '七匹狼投资股份有限公司', '国泰君安证券股份有限公司', 'Deutsche Bank Aktiengesellschaft', '泰康人寿保险股份有限公司', '1000000', '12'}"
7,"{'现金', '90000000', '任思龙', '竞价', '30000000', '36', '卢生江'}",1785712,2,"{'90000000', '30000000'}",5,"{'现金', '任思龙', '竞价', '36', '卢生江'}",5,"{'现金', '任思龙', '竞价', '36', '卢生江'}"
18,"{'浙江富春江通信集团有限公司', '130590955.4', '吴斌', '民生加银-西南证券鑫牛定向增发42号资产管理计划', '113557358', '张忠梅', '24130940.1', '1248799', '9226532.2', '竞价', '191145988.1', '15369839', '深圳潇湘君秀投资企业(有限合伙)', '17675314', '3266091', '张杰', '25871358', '36'}",1711257,1,{'竞价'},6,"{'36', '浙江富春江通信集团有限公司', '吴斌', '张忠梅', '深圳潇湘君秀投资企业(有限合伙)', '张杰'}",17,"{'浙江富春江通信集团有限公司', '130590955.4', '吴斌', '民生加银-西南证券鑫牛定向增发42号资产管理计划', '113557358', '张忠梅', '24130940.1', '1248799', '9226532.2', '191145988.1', '15369839', '深圳潇湘君秀投资企业(有限合伙)', '17675314', '3266091', '张杰', '25871358', '36'}"
8,"{'中国建材股份有限公司', '30900000', '103000000', '竞价', '3000000', '泰达宏利基金管理有限公司', '10000000', '12'}",572574,2,"{'30900000', '103000000'}",3,"{'泰达宏利基金管理有限公司', '竞价', '12'}",6,"{'中国建材股份有限公司', '竞价', '3000000', '泰达宏利基金管理有限公司', '10000000', '12'}"
4,"{'现金', '233639000', '36', '惠而浦(中国)投资有限公司'}",333921,1,{'233639000'},2,"{'现金', '36'}",3,"{'现金', '36', '惠而浦(中国)投资有限公司'}"
15,"{'郑建国', '8317983', '7089608', '18947587', '光明食品(集团)有限公司', '定价', '211981831', '上海大都市资产经营管理有限公司', '张智刚', '沈宏泽', '李艳', '2184847', '321277459', '529819', '上海农工商绿化有限公司'}",1762407,8,"{'8317983', '18947587', '7089608', '定价', '211981831', '2184847', '321277459', '529819'}",6,"{'郑建国', '上海大都市资产经营管理有限公司', '沈宏泽', '张智刚', '李艳', '上海农工商绿化有限公司'}",7,"{'郑建国', '光明食品(集团)有限公司', '上海大都市资产经营管理有限公司', '张智刚', '沈宏泽', '李艳', '上海农工商绿化有限公司'}"
4,"{'现金', '竞价', '步步高投资集团股份有限公司', '36'}",1848768,0,set(),4,"{'36', '竞价', '步步高投资集团股份有限公司', '现金'}",4,"{'竞价', '现金', '36', '步步高投资集团股份有限公司'}"
3,"{'上海均瑶(集团)有限公司', '现金', '36'}",2140630,0,set(),2,"{'现金', '36'}",3,"{'上海均瑶(集团)有限公司', '现金', '36'}"
19,"{'现金', '博时资本管理有限公司', '上海兴瀚资产管理有限公司', '217510259', '1015391705', '1559999995', '12', '定价', '138904474', '东方集团投资控股有限公司', '339309850', '1589999993', '2057253300', '申万宏源证券有限公', '281430000', '创金合信基金管理有限公司', '36', '2480355004', '213406292'}",4923893,3,"{'1559999995', '1015391705', '2480355004'}",8,"{'36', '现金', '博时资本管理有限公司', '上海兴瀚资产管理有限公司', '定价', '东方集团投资控股有限公司', '申万宏源证券有限公', '12'}",16,"{'现金', '博时资本管理有限公司', '上海兴瀚资产管理有限公司', '217510259', '12', '定价', '138904474', '东方集团投资控股有限公司', '339309850', '1589999993', '2057253300', '申万宏源证券有限公', '281430000', '创金合信基金管理有限公司', '36', '213406292'}"
6,"{'现金', '天通高新集团有限公司', '50000000', '10000000', '36', '杜海利'}",1166058,1,{'10000000'},4,"{'现金', '天通高新集团有限公司', '36', '杜海利'}",5,"{'现金', '天通高新集团有限公司', '50000000', '36', '杜海利'}"
27,"{'13214505', '143999994.2', '8850645', '2028272', '10141364', '3073140', '财通基金管理有限公司', '竞价', '294999993.1', '鹏华基金管理有限公司', '79999996.75', '4917025', '北信瑞丰基金管理有限公司', '18131530', '博时基金管理有限公司', '49999987.8', '214999996.4', '富国基金管理有限公司', '华商基金管理有限公司', '华融证券股份有限公司', '17701290', '164999992.3', '32999985.44', '287999988.3', '嘉实基金管理有限公司', '安徽高新毅达皖江产业发展创业投资基金(有限合伙)', '12'}",18887429,15,"{'164999992.3', '10141364', '79999996.75', '18131530', '3073140', '13214505', '32999985.44', '287999988.3', '49999987.8', '214999996.4', '竞价', '294999993.1', '143999994.2', '8850645', '2028272'}",9,"{'北信瑞丰基金管理有限公司', '博时基金管理有限公司', '嘉实基金管理有限公司', '财通基金管理有限公司', '鹏华基金管理有限公司', '富国基金管理有限公司', '华商基金管理有限公司', '华融证券股份有限公司', '12'}",12,"{'北信瑞丰基金管理有限公司', '博时基金管理有限公司', '4917025', '嘉实基金管理有限公司', '财通基金管理有限公司', '安徽高新毅达皖江产业发展创业投资基金(有限合伙)', '富国基金管理有限公司', '鹏华基金管理有限公司', '华商基金管理有限公司', '华融证券股份有限公司', '12', '17701290'}"
28,"{'3754367', '285980000', '青岛煜明投资中心(有限合伙)', '7000000', '110600000', '59318998.6', '8000000', '兴业全球基金管理有限公司', '定价', '招商基金管理有限公司', '财通基金管理有限公司', '宝盈基金管理有限公司', '126400000', '9000000', '东海瑞京资产管理(上海)有限公司', '36', '民生加银基金管理有限公司', '142200000', '18100000', '7700000', '120001000', '兴证证券资产管理有限公司', '123240000', '7595000', '天弘基金管理有限公司', '121660000', '7800000', '12'}",308667,12,"{'3754367', '120001000', '285980000', '123240000', '7000000', '110600000', '142200000', '121660000', '7800000', '59318998.6', '126400000', '7700000'}",9,"{'民生加银基金管理有限公司', '兴证证券资产管理有限公司', '兴业全球基金管理有限公司', '12', '定价', '招商基金管理有限公司', '天弘基金管理有限公司', '宝盈基金管理有限公司', '36'}",16,"{'东海瑞京资产管理(上海)有限公司', '36', '民生加银基金管理有限公司', '兴证证券资产管理有限公司', '兴业全球基金管理有限公司', '定价', '招商基金管理有限公司', '青岛煜明投资中心(有限合伙)', '财通基金管理有限公司', '7595000', '天弘基金管理有限公司', '9000000', '宝盈基金管理有限公司', '18100000', '8000000', '12'}"
12,"{'150000000', '现金', '31250000', '350000000', '1000000000', '竞价', '万永兴', '上海豫辉投资管理中心(有限合伙)', '89285714', '13392857', '刘轶', '36'}",1685132,3,"{'150000000', '竞价', '350000000'}",4,"{'万永兴', '现金', '刘轶', '36'}",9,"{'现金', '31250000', '1000000000', '万永兴', '上海豫辉投资管理中心(有限合伙)', '89285714', '13392857', '刘轶', '36'}"
7,"{'现金', '鹏华资产管理有限公司', '15292096', '定价', '华信期货股份有限公司', '56707904', '12'}",16945791,0,set(),4,"{'华信期货股份有限公司', '定价', '12', '鹏华资产管理有限公司'}",7,"{'现金', '鹏华资产管理有限公司', '15292096', '定价', '华信期货股份有限公司', '56707904', '12'}"
8,"{'现金', '16402116', '123999997', '东海基金管理有限责任公司', '黄建新', '竞价', '屠榕皓', '12'}",19351874,2,"{'竞价', '123999997'}",3,"{'黄建新', '现金', '12'}",6,"{'现金', '16402116', '东海基金管理有限责任公司', '黄建新', '屠榕皓', '12'}"
5,"{'定价', '73690000', '资产', '许继集团有限公司', '36'}",1360468,1,{'73690000'},4,"{'资产', '定价', '许继集团有限公司', '36'}",4,"{'资产', '定价', '许继集团有限公司', '36'}"
5,"{'现金', '指点投资', '丰实基金', '中电投集团', '36'}",679551,0,set(),5,"{'现金', '指点投资', '丰实基金', '中电投集团', '36'}",5,"{'现金', '指点投资', '丰实基金', '中电投集团', '36'}"
10,"{'任颂柳', '现金', '郑康定', '5700000', '15000000', '宁波汇峰投资控股股份有限公司', '6300000', '30000000', '36', '任伟达'}",213963,4,"{'6300000', '5700000', '15000000', '30000000'}",6,"{'郑康定', '任颂柳', '现金', '宁波汇峰投资控股股份有限公司', '36', '任伟达'}",6,"{'郑康定', '任颂柳', '现金', '宁波汇峰投资控股股份有限公司', '36', '任伟达'}"
21,"{'4000000', '3000000', '现金', 'Fortis Bank SA/NV', '9800000', '深圳市天威盛电力设备有限公司', '2700000', '9000000', '北新物流有限公司', '36', '深圳市柏越实业有限公司', '1500000', '中国电力财务有限公司', '甘肃省信托投资有限责任公司', 'Bill& Melinda Gates Foundation', 'Martin Currie Investment Management Limited', '保定天威集团有限公司', '2000000', '1000000', '12', '海富通基金管理有限公司'}",481901,11,"{'现金', 'Bill& Melinda Gates Foundation', '4000000', '2000000', '9000000', '1500000', '3000000', '9800000', '2700000', '1000000', '36'}",3,"{'12', 'Fortis Bank SA/NV', 'Martin Currie Investment Management Limited'}",10,"{'甘肃省信托投资有限责任公司', 'Fortis Bank SA/NV', '12', 'Martin Currie Investment Management Limited', '保定天威集团有限公司', '深圳市柏越实业有限公司', '中国电力财务有限公司', '深圳市天威盛电力设备有限公司', '北新物流有限公司', '海富通基金管理有限公司'}"
16,"{'招商财富资产管理有限公司', '上银瑞金资产管理有限公司', '490000000', '现金', '14000000', '东海基金管理有限责任公司', '5714285', '财通基金管理有限公司', '110000030', '竞价', '499999990', '3142858', '14285714', '汇添富基金管理股份有限公司', '12', '199999975'}",1642445,9,"{'490000000', '14000000', '5714285', '110000030', '竞价', '499999990', '3142858', '14285714', '199999975'}",2,"{'现金', '12'}",7,"{'招商财富资产管理有限公司', '上银瑞金资产管理有限公司', '现金', '东海基金管理有限责任公司', '财通基金管理有限公司', '汇添富基金管理股份有限公司', '12'}"
9,"{'现金', '5400000000', '定价', '435506000', '中江定增1号', '拉萨昆吾', '6164494000', '九鼎投资', '36'}",1771944,3,"{'6164494000', '435506000', '5400000000'}",5,"{'现金', '定价', '拉萨昆吾', '九鼎投资', '36'}",6,"{'现金', '定价', '中江定增1号', '拉萨昆吾', '九鼎投资', '36'}"
6,"{'1599999996', '现金', '浙江航民实业集团有限公司', '竞价', '266222961', '12'}",4932851,2,"{'1599999996', '竞价'}",3,"{'浙江航民实业集团有限公司', '现金', '12'}",4,"{'浙江航民实业集团有限公司', '现金', '12', '266222961'}"
19,"{'新余市君创铭石投资中心(有限合伙)', '现金', '广东恒润互兴资产管理有限公司', '23406655', '无锡天乐润点投资管理合伙企业(有限合伙)', '定价', '18725324', '276666700', '61333300', '9362662', '221333300', '新余市咸城信阳投资中心(有限合伙)', '朱洁', '6768189', '80000000', '5188945', '36', '新余高新区逸帆投资管理中心(有限合伙)', '110666700'}",1763580,4,"{'221333300', '61333300', '276666700', '110666700'}",5,"{'现金', '广东恒润互兴资产管理有限公司', '定价', '朱洁', '36'}",15,"{'新余市君创铭石投资中心(有限合伙)', '现金', '广东恒润互兴资产管理有限公司', '23406655', '无锡天乐润点投资管理合伙企业(有限合伙)', '定价', '18725324', '9362662', '新余市咸城信阳投资中心(有限合伙)', '朱洁', '6768189', '80000000', '5188945', '36', '新余高新区逸帆投资管理中心(有限合伙)'}"
15,"{'8700000', '现金', '11100000', '华鑫国际信托有限公司', '宁波瑞林股权投资合伙企业(有限合伙)', '中航证券有限公司', '13800000', '15700000', '西藏自治区投资有限公司', '竞价', '5200000', '长城证券有限责任公司', '北京安泰汇银投资管理有限公司', '12', '太平资产管理有限公司'}",1224157,2,"{'竞价', '5200000'}",8,"{'现金', '华鑫国际信托有限公司', '中航证券有限公司', '西藏自治区投资有限公司', '长城证券有限责任公司', '北京安泰汇银投资管理有限公司', '12', '太平资产管理有限公司'}",13,"{'8700000', '现金', '11100000', '华鑫国际信托有限公司', '宁波瑞林股权投资合伙企业(有限合伙)', '中航证券有限公司', '13800000', '15700000', '西藏自治区投资有限公司', '长城证券有限责任公司', '北京安泰汇银投资管理有限公司', '12', '太平资产管理有限公司'}"
22,"{'499935397.5', '799999969.3', '安徽省铁路建设投资基金有限公司', '10282286', '安徽国元控股(集团)有限责任公司', '嘉华优势(天津)投资企业(有限合伙)', '35281256', '现金', '定价', '143952011', '145699992.6', '2039799996', '72849982.14', '36', '60', '56457302', '5141142', '广东省高速公路发展股份有限公司', '建安投资控股集团有限公司', '51411432', '728499991.4', '安徽全柴集团有限公司'}",14761835,3,"{'72849982.14', '2039799996', '安徽国元控股(集团)有限责任公司'}",8,"{'36', '现金', '广东省高速公路发展股份有限公司', '安徽省铁路建设投资基金有限公司', '定价', '建安投资控股集团有限公司', '60', '安徽全柴集团有限公司'}",19,"{'35281256', '499935397.5', '5141142', '现金', '广东省高速公路发展股份有限公司', '安徽全柴集团有限公司', '799999969.3', '安徽省铁路建设投资基金有限公司', '定价', '60', '建安投资控股集团有限公司', '143952011', '51411432', '728499991.4', '10282286', '56457302', '145699992.6', '嘉华优势(天津)投资企业(有限合伙)', '36'}"
4,"{'Holchin B.V.', '竞价', '现金', '36'}",391443,0,set(),3,"{'Holchin B.V.', '竞价', '现金'}",4,"{'Holchin B.V.', '竞价', '现金', '36'}"
12,"{'现金', '1000000000', '21720243', '竞价', '43440486', '65160729', '1500000000', '500000000', '京京国瑞国企改革发展基金(有限合伙)', '三胞集团南京投资管理有限公司', '上海懿兆实业投资有限公司', '36'}",2332291,3,"{'1000000000', '竞价', '1500000000'}",4,"{'三胞集团南京投资管理有限公司', '现金', '上海懿兆实业投资有限公司', '36'}",9,"{'现金', '21720243', '43440486', '65160729', '500000000', '京京国瑞国企改革发展基金(有限合伙)', '三胞集团南京投资管理有限公司', '上海懿兆实业投资有限公司', '36'}"
20,"{'孙军', '李鹏', '刘夷', '1100000', '丰琪投资', '定价', '1600000', '9776000', '95891980', '翁祖翔', '6110000', '585899997.8', '魏立平', '薛建', '6721000', '宋克均', '聂慧', '刘晓鸣', '1000000', '36'}",120485,0,set(),12,"{'孙军', '36', '刘夷', '李鹏', '丰琪投资', '定价', '翁祖翔', '宋克均', '薛建', '聂慧', '刘晓鸣', '魏立平'}",20,"{'孙军', '36', '刘夷', '李鹏', '1100000', '丰琪投资', '定价', '1600000', '9776000', '95891980', '翁祖翔', '6110000', '585899997.8', '薛建', '6721000', '宋克均', '聂慧', '刘晓鸣', '1000000', '魏立平'}"
18,"{'1142857', '49999985', '39999995', '现金', '714285', '浙江浙商证券资产管理有限公司', '拉萨经济技术开发区天合宇通投资基金管理有限公司', '24999975', '上银瑞金资本管理有限公司', '1714285', '定价', '博时基金管理有限公司', '深圳市国能金汇资产管理有限公司', '1428571', '40000065', '59999975', '1142859', '12'}",1685348,0,set(),8,"{'现金', '拉萨经济技术开发区天合宇通投资基金管理有限公司', '浙江浙商证券资产管理有限公司', '上银瑞金资本管理有限公司', '定价', '博时基金管理有限公司', '深圳市国能金汇资产管理有限公司', '12'}",18,"{'1142857', '49999985', '39999995', '现金', '714285', '浙江浙商证券资产管理有限公司', '拉萨经济技术开发区天合宇通投资基金管理有限公司', '24999975', '上银瑞金资本管理有限公司', '1714285', '博时基金管理有限公司', '定价', '深圳市国能金汇资产管理有限公司', '1428571', '40000065', '59999975', '1142859', '12'}"
4,"{'竞价', '美克集团', '36', '600000000'}",12036322,1,{'600000000'},3,"{'竞价', '美克集团', '36'}",3,"{'竞价', '美克集团', '36'}"
14,"{'现金', '董建新', '万跃龙', '吕平', '10000000', '800000', '张泉', '5200000', '恒健通', '当代科技', '邓勇', '刘冬燕', '36', '刘丹军'}",725624,2,"{'800000', '5200000'}",11,"{'现金', '董建新', '万跃龙', '吕平', '张泉', '恒健通', '当代科技', '邓勇', '刘冬燕', '36', '刘丹军'}",12,"{'现金', '董建新', '万跃龙', '吕平', '10000000', '张泉', '恒健通', '当代科技', '邓勇', '刘冬燕', '36', '刘丹军'}"
15,"{'甘肃兴陇资本管理有限公司', '373898000', '125163989.3', '499578000', '125680000', '财通基金管理有限公司', '31800000', '竞价', '23800000', '7967154', '8000000', '兰州永新大贸贸易有限责任公司', '八冶建设集团有限公司', '12', '华融证券股份有限公司'}",1861043,1,{'竞价'},1,{'12'},14,"{'甘肃兴陇资本管理有限公司', '373898000', '125163989.3', '499578000', '125680000', '财通基金管理有限公司', '31800000', '23800000', '7967154', '8000000', '兰州永新大贸贸易有限责任公司', '八冶建设集团有限公司', '12', '华融证券股份有限公司'}"
10,"{'3210571', '现金', '1104362', '平安资管', '平安养老险', '1380452', '久远银海1号定向资管计划', '1206877', '广发恒定24号集合资管计划', '36'}",2098779,4,"{'3210571', '1206877', '1104362', '1380452'}",4,"{'平安养老险', '现金', '36', '平安资管'}",6,"{'现金', '平安资管', '平安养老险', '久远银海1号定向资管计划', '广发恒定24号集合资管计划', '36'}"
4,"{'322761557', '定价', '36', '上海建工(集团)总公司'}",1497042,1,{'定价'},1,{'36'},3,"{'322761557', '36', '上海建工(集团)总公司'}"
6,"{'现金', '23931583', '景德镇市焦化工业集团有限责任公司', '景德镇井冈山北汽创新发展投资中心(有限合伙)', '96068417', '36'}",12064151,3,"{'23931583', '96068417', '景德镇井冈山北汽创新发展投资中心(有限合伙)'}",3,"{'现金', '36', '景德镇市焦化工业集团有限责任公司'}",3,"{'现金', '36', '景德镇市焦化工业集团有限责任公司'}"
11,"{'金鹰基金管理有限公司', '现金', '1446364', '35999999.96', '1401390', '107999999.9', '竞价', '34880597.1', '4339092', '深圳市创东方富捷投资企业(有限合伙)', '广州市玄元投资管理有限公司'}",15767399,2,"{'竞价', '107999999.9'}",3,"{'广州市玄元投资管理有限公司', '金鹰基金管理有限公司', '现金'}",9,"{'金鹰基金管理有限公司', '现金', '1446364', '35999999.96', '1401390', '34880597.1', '4339092', '深圳市创东方富捷投资企业(有限合伙)', '广州市玄元投资管理有限公司'}"
5,"{'现金', '郭现生', '竞价', '宋全启', '36'}",399835,0,set(),5,"{'现金', '郭现生', '竞价', '宋全启', '36'}",5,"{'现金', '郭现生', '竞价', '宋全启', '36'}"
10,"{'10854816', '现金', '199511518.1', '奥鑫控股', '吴艳', '雄健投资', '997557663.9', '竞价', '54274084', '36'}",2355343,2,"{'199511518.1', '竞价'}",5,"{'现金', '奥鑫控股', '吴艳', '雄健投资', '36'}",8,"{'10854816', '现金', '奥鑫控股', '吴艳', '雄健投资', '997557663.9', '54274084', '36'}"
14,"{'深圳平安大华汇通财富管理有限公司', '36', '东海基金管理有限责任公司', '中广核财务有限责任公司', '财通基金管理有限公司', '竞价', '8800000', '涂善忠', '李留根', '19300000', '山东省国有资产投资控股有限公司', '8473000', '12', '14800000'}",305413,2,"{'8473000', '14800000'}",4,"{'36', '竞价', '涂善忠', '12'}",12,"{'深圳平安大华汇通财富管理有限公司', '36', '东海基金管理有限责任公司', '中广核财务有限责任公司', '财通基金管理有限公司', '竞价', '8800000', '涂善忠', '李留根', '19300000', '山东省国有资产投资控股有限公司', '12'}"
24,"{'27956990', '25806451', '27956987', '现金', '兴业财富资产管理有限公司', '定价', '194999996', '财通基金管理有限公司', '80805596', '鹏华基金管理有限公司', '41935483', '安徽中安资本管理有限公司', '201253999.5', '银华基金管理有限公司', '北信瑞丰基金管理有限公司', '149999993', '375746021.4', '130000003.5', '43280430', '东海基金管理有限公司', '129999989.6', '119999997.2', '12', '32258063'}",16144750,4,"{'119999997.2', '129999989.6', '194999996', '149999993'}",10,"{'安徽中安资本管理有限公司', '现金', '银华基金管理有限公司', '北信瑞丰基金管理有限公司', '兴业财富资产管理有限公司', '定价', '东海基金管理有限公司', '财通基金管理有限公司', '鹏华基金管理有限公司', '12'}",20,"{'安徽中安资本管理有限公司', '201253999.5', '银华基金管理有限公司', '北信瑞丰基金管理有限公司', '现金', '27956990', '兴业财富资产管理有限公司', '43280430', '东海基金管理有限公司', '定价', '财通基金管理有限公司', '25806451', '80805596', '鹏华基金管理有限公司', '27956987', '375746021.4', '41935483', '130000003.5', '12', '32258063'}"
14,"{'北京市海淀区国有资产投资经营有限公司', '现金', '北京海淀科技发展有限公司', '23352037', '定价', '40856275', '699867990.8', '5834746', '刘雷', '林科', '99949198.98', '400020393.8', '常州京泽永兴投资中心(有限合伙)', '36'}",1771378,1,{'699867990.8'},5,"{'现金', '北京海淀科技发展有限公司', '定价', '刘雷', '36'}",13,"{'北京市海淀区国有资产投资经营有限公司', '北京海淀科技发展有限公司', '现金', '23352037', '定价', '40856275', '5834746', '刘雷', '林科', '99949198.98', '400020393.8', '常州京泽永兴投资中心(有限合伙)', '36'}"
4,"{'现金', '竞价', '皖能集团', '36'}",1324809,0,set(),4,"{'36', '竞价', '皖能集团', '现金'}",4,"{'现金', '竞价', '皖能集团', '36'}"
5,"{'现金', '60000000', '竞价', '贺国英', '36'}",4931292,1,{'60000000'},4,"{'贺国英', '现金', '竞价', '36'}",4,"{'贺国英', '现金', '竞价', '36'}"
9,"{'现金', '先锋创业', '新余爱乐', '定价', '2400000', '11000000', '8450000', '唐进波', '36'}",1714151,0,set(),6,"{'现金', '先锋创业', '新余爱乐', '定价', '唐进波', '36'}",9,"{'现金', '先锋创业', '新余爱乐', '定价', '2400000', '11000000', '8450000', '唐进波', '36'}"
30,"{'江苏彩浩投资有限公司', '16000000', '659785800', '229020000', '124711800', '6500000', '140639100', '现金', '达孜县恒隆股权投资合伙企业(有限合伙)', '216632100', '11980000', '20790000', '南通琦艺投资有限公司', '759930000', '达孜县恒盛股权投资合伙企业(有限合伙)', '南通泓翔股权投资合伙企业(有限合伙)', '13510000', '67665000', '216423900', '商赢控股有限公司', '旭森国际控股(集团)有限公司', '20810000', '青岛盈和投资合伙企业(有限合伙)', '63380000', '江苏隆明投资有限公司', '22000000', '166560000', '73000000', '旭源投资有限公司', '36'}",340326,18,"{'20790000', '759930000', '16000000', '659785800', '20810000', '216632100', '13510000', '63380000', '229020000', '11980000', '124711800', '22000000', '166560000', '6500000', '73000000', '140639100', '67665000', '216423900'}",7,"{'江苏彩浩投资有限公司', '现金', '南通琦艺投资有限公司', '商赢控股有限公司', '江苏隆明投资有限公司', '旭源投资有限公司', '36'}",12,"{'江苏彩浩投资有限公司', '现金', '南通琦艺投资有限公司', '达孜县恒盛股权投资合伙企业(有限合伙)', '旭森国际控股(集团)有限公司', '商赢控股有限公司', '达孜县恒隆股权投资合伙企业(有限合伙)', '南通泓翔股权投资合伙企业(有限合伙)', '青岛盈和投资合伙企业(有限合伙)', '江苏隆明投资有限公司', '旭源投资有限公司', '36'}"
5,"{'现金', '南京长江油运公司', '272011822', '竞价', '36'}",1348552,1,{'竞价'},3,"{'现金', '36', '南京长江油运公司'}",4,"{'272011822', '现金', '36', '南京长江油运公司'}"
12,"{'13400000', '广晟有色2015年度员工持股计划', '现金', '15000000', '2000000', '8779500', '1202200', '国华人寿', '广晟公司', '36', '刘益谦', '珺容战略资源1号基金'}",1654138,5,"{'13400000', '15000000', '2000000', '8779500', '1202200'}",5,"{'现金', '国华人寿', '广晟公司', '36', '刘益谦'}",7,"{'广晟有色2015年度员工持股计划', '现金', '国华人寿', '广晟公司', '36', '刘益谦', '珺容战略资源1号基金'}"
28,"{'600881', '16000000', '12900000', '61864000', '浙江省铁路投资集团有限公司', '亿群投资控股有限公司', '现金', '60458000', '兴业全球基金管理有限公司', '竞价', '90687000', '新疆中乾景隆中和股权投资合伙企业(有限合伙)', '10000000', '太平资产管理有限公司', '160002800', '南京瑞森投资管理合伙企业(有限合伙)', '36', '70300000', '上海证大投资管理有限公司', '112480000', '22760000', '8800000', '8600000', '12800000', '89984000', '4224193.43', '泰康资产管理有限责任公司', '12'}",1241807,12,"{'160002800', '600881', '60458000', '70300000', '112480000', '12900000', '61864000', '22760000', '竞价', '90687000', '89984000', '4224193.43'}",9,"{'泰康资产管理有限责任公司', '36', '亿群投资控股有限公司', '现金', '兴业全球基金管理有限公司', '上海证大投资管理有限公司', '浙江省铁路投资集团有限公司', '12', '太平资产管理有限公司'}",16,"{'南京瑞森投资管理合伙企业(有限合伙)', '泰康资产管理有限责任公司', '亿群投资控股有限公司', '现金', '16000000', '兴业全球基金管理有限公司', '8600000', '12', '12800000', '上海证大投资管理有限公司', '8800000', '浙江省铁路投资集团有限公司', '10000000', '36', '新疆中乾景隆中和股权投资合伙企业(有限合伙)', '太平资产管理有限公司'}"
18,"{'10603048', '现金', '北信瑞丰基金管理有限公司', '5168987', '5434062', '81999995.58', '新沃基金管理有限公司', '78000013.83', '广州立根小额再贷款股份有限公司', '99999996.45', '159999994.3', '杭州慧乾投资管理合伙企业(有限合伙)', '竞价', '399999985.8', '6626905', '26507620', '前海开源基金管理有限公司', '12'}",15320210,1,{'竞价'},6,"{'现金', '北信瑞丰基金管理有限公司', '新沃基金管理有限公司', '广州立根小额再贷款股份有限公司', '前海开源基金管理有限公司', '12'}",17,"{'10603048', '现金', '北信瑞丰基金管理有限公司', '5168987', '5434062', '81999995.58', '新沃基金管理有限公司', '78000013.83', '广州立根小额再贷款股份有限公司', '99999996.45', '159999994.3', '杭州慧乾投资管理合伙企业(有限合伙)', '399999985.8', '6626905', '26507620', '前海开源基金管理有限公司', '12'}"
8,"{'800000000', '现金', '400000000', '19723864', '张仁华', '9861932', '汇添富基金管理股份有限公司', '36'}",477681,4,"{'19723864', '800000000', '9861932', '400000000'}",3,"{'张仁华', '现金', '汇添富基金管理股份有限公司'}",4,"{'张仁华', '现金', '汇添富基金管理股份有限公司', '36'}"
20,"{'尚建华', '高安良', '现金', '江信基金管理有限公司', '3500000', '8700000', '15500000', '华宝兴业基金管理有限公司', '鹰潭宏河投资管理有限合伙企业', '3300000', '6800000', '毕磊', '3900000', '4300000', '5500000', '华宝信托有限责任公司', '常州投资集团有限公司', '泰康资产管理有限公司', '12', '13200000'}",1214518,4,"{'15500000', '8700000', '3300000', '6800000'}",8,"{'尚建华', '高安良', '现金', '江信基金管理有限公司', '毕磊', '华宝信托有限责任公司', '常州投资集团有限公司', '12'}",16,"{'尚建华', '高安良', '华宝兴业基金管理有限公司', '江信基金管理有限公司', '3500000', '现金', '鹰潭宏河投资管理有限合伙企业', '毕磊', '3900000', '4300000', '5500000', '华宝信托有限责任公司', '常州投资集团有限公司', '泰康资产管理有限公司', '12', '13200000'}"
7,"{'现金', '锦江酒店集团', '100000000', '定价', '101277000', '弘毅投资基金', '36'}",349941,0,set(),5,"{'现金', '锦江酒店集团', '定价', '弘毅投资基金', '36'}",7,"{'现金', '锦江酒店集团', '100000000', '定价', '101277000', '弘毅投资基金', '36'}"
22,"{'武汉开发投资有限公司', '99999994.88', '6057064', '9607493', '泰达宏利基金管理有限公司', '3955697', '山东省金融资产管理股份有限公司', '东方邦信创业投资有限公司', '现金', '邦信资产管理有限公司', '153122577.9', '3955696', '竞价', '242877423', '36', '农银汇理(上海)资产管理有限公司', '100000020.2', '金鹰基金管理有限公司', '浪潮软件集团有限公司', '103999998.7', '12', '4113924'}",1879074,2,"{'100000020.2', '山东省金融资产管理股份有限公司'}",11,"{'东方邦信创业投资有限公司', '36', '金鹰基金管理有限公司', '现金', '武汉开发投资有限公司', '农银汇理(上海)资产管理有限公司', '邦信资产管理有限公司', '浪潮软件集团有限公司', '竞价', '泰达宏利基金管理有限公司', '12'}",20,"{'东方邦信创业投资有限公司', '金鹰基金管理有限公司', '现金', '武汉开发投资有限公司', '农银汇理(上海)资产管理有限公司', '邦信资产管理有限公司', '99999994.88', '12', '浪潮软件集团有限公司', '103999998.7', '153122577.9', '3955696', '竞价', '6057064', '9607493', '泰达宏利基金管理有限公司', '242877423', '3955697', '36', '4113924'}"
4,"{'东方新能源', '现金', '竞价', '36'}",1227106,0,set(),4,"{'东方新能源', '现金', '竞价', '36'}",4,"{'东方新能源', '现金', '竞价', '36'}"
4,"{'金圆控股集团有限公司', '现金', '竞价', '36'}",9872926,0,set(),4,"{'金圆控股集团有限公司', '现金', '竞价', '36'}",4,"{'金圆控股集团有限公司', '现金', '竞价', '36'}"
16,"{'平安大华基金管理有限公司', '金鹰基金管理有限公司', '现金', '21844660', '19491507', '178499997', '21662621', '160610017.7', '金元顺安基金管理有限公司', '竞价', '华商基金管理有限公司', '21116504', '179999998.4', '173999993', '12', '农银国际投资(苏州)有限公司'}",18838787,2,"{'173999993', '160610017.7'}",7,"{'平安大华基金管理有限公司', '金鹰基金管理有限公司', '现金', '金元顺安基金管理有限公司', '竞价', '华商基金管理有限公司', '12'}",14,"{'平安大华基金管理有限公司', '金鹰基金管理有限公司', '现金', '21844660', '19491507', '178499997', '21662621', '金元顺安基金管理有限公司', '竞价', '21116504', '179999998.4', '华商基金管理有限公司', '12', '农银国际投资(苏州)有限公司'}"
5,"{'现金', '3706449', '浙江天堂硅谷久盈股权投资合伙企业(有限合伙)', '50000000', '36'}",373692,3,"{'浙江天堂硅谷久盈股权投资合伙企业(有限合伙)', '50000000', '3706449'}",2,"{'现金', '36'}",2,"{'现金', '36'}"
4,"{'沈阳机床(集团)有限责任公司', '竞价', '现金', '36'}",2255975,1,{'沈阳机床(集团)有限责任公司'},3,"{'竞价', '现金', '36'}",3,"{'竞价', '现金', '36'}"
15,"{'现代种业基金', '20000000', '997920000', '现金', '中信兴业投资', '109000000', '信农投资', '1294920000', '4000000', '汇添富-优势企业定增计划5号资产管理计划', '47520000', '中信建设', '237600000', '36', '84000000'}",347637,6,"{'997920000', '109000000', '1294920000', '237600000', '47520000', '84000000'}",6,"{'现代种业基金', '中信兴业投资', '现金', '信农投资', '中信建设', '36'}",9,"{'现代种业基金', '20000000', '现金', '中信兴业投资', '信农投资', '4000000', '汇添富-优势企业定增计划5号资产管理计划', '中信建设', '36'}"
6,"{'1749309100', '现金', '定价', '418495000', '36', '上港集团2014年度员工持股计划(由受托管理该计划的资管机构长江养老设立专项产品予以认购)'}",1659531,0,set(),3,"{'定价', '现金', '36'}",6,"{'1749309100', '现金', '定价', '418495000', '36', '上港集团2014年度员工持股计划(由受托管理该计划的资管机构长江养老设立专项产品予以认购)'}"
5,"{'现金', '莞市电子工业总公司', '伟华电子有限公司', '竞价', '36'}",420832,0,set(),5,"{'莞市电子工业总公司', '现金', '伟华电子有限公司', '竞价', '36'}",5,"{'现金', '莞市电子工业总公司', '伟华电子有限公司', '竞价', '36'}"
4,"{'冶金集团', '竞价', '现金', '36'}",1829406,0,set(),4,"{'冶金集团', '竞价', '现金', '36'}",4,"{'冶金集团', '竞价', '现金', '36'}"
4,"{'当代科技', '现金', '竞价', '36'}",1149473,0,set(),4,"{'当代科技', '现金', '竞价', '36'}",4,"{'当代科技', '现金', '竞价', '36'}"
12,"{'646330000', '生态1期计划', '现金', '5252883', '定价', '财富皇庭计划', '63770000', '云投集团', '9900000', '53239703', '36', '815485'}",14590740,0,set(),5,"{'现金', '定价', '财富皇庭计划', '云投集团', '36'}",12,"{'646330000', '生态1期计划', '现金', '5252883', '定价', '财富皇庭计划', '63770000', '云投集团', '9900000', '53239703', '36', '815485'}"
4,"{'竞价', '现金', '36', '东皖能集团'}",1360429,0,set(),4,"{'竞价', '现金', '36', '东皖能集团'}",4,"{'竞价', '现金', '36', '东皖能集团'}"
4,"{'江苏爱康实业集团有限公司', '竞价', '现金', '36'}",307300,1,{'竞价'},3,"{'江苏爱康实业集团有限公司', '现金', '36'}",3,"{'江苏爱康实业集团有限公司', '现金', '36'}"
5,"{'现金', '竞价', '华天集团', '75000000', '36'}",1307144,1,{'75000000'},3,"{'竞价', '现金', '华天集团'}",4,"{'竞价', '现金', '华天集团', '36'}"
10,"{'现金', '安徽皖投工业投资有限公司', '70499998', '安徽省铁路建设投资基金有限公司', '定价', '淮北矿业(集团)有限责任公司', '24867724', '281999990', '6216931', '36'}",16022963,3,"{'70499998', '281999990', '24867724'}",5,"{'现金', '安徽皖投工业投资有限公司', '安徽省铁路建设投资基金有限公司', '定价', '36'}",7,"{'现金', '安徽皖投工业投资有限公司', '安徽省铁路建设投资基金有限公司', '淮北矿业(集团)有限责任公司', '定价', '6216931', '36'}"
13,"{'2951593', '现金', '9604902', '上海证券聚赢定增1号', '5950000', '定价', '吴涛', '前海开源嘉得天晟定增1号', '1770956', '浙商定增资管计划', '上海证券聚赢定增2号', '上海证券聚赢定增3号', '36'}",89879,0,set(),5,"{'36', '现金', '吴涛', '定价', '浙商定增资管计划'}",13,"{'2951593', '现金', '9604902', '上海证券聚赢定增1号', '5950000', '定价', '吴涛', '前海开源嘉得天晟定增1号', '1770956', '浙商定增资管计划', '上海证券聚赢定增2号', '上海证券聚赢定增3号', '36'}"
30,"{'1758999991', '91182640', '1521629989', '1708999987', '海通证券股份有限公司', '119760100', '现金', '兴业全球基金管理有限公司', '1986820059', '120101265', '竞价', '纳爱斯集团有限公司', '中国海洋石油总公司', '1512719998', '太平洋资产管理有限责任公司', '1512110000', '平安资产管理有限责任公司', '雅戈尔集团股份有限公司', '91719710', '1992479986', '1504139998', '90665461', '90542495', '103013863', '106027727', '刘益谦', '1502099992', '91145871', '泰康资产管理有限责任公司', '12'}",1286131,5,"{'1512110000', '1758999991', '1521629989', '1504139998', '1512719998'}",12,"{'太平洋资产管理有限责任公司', '现金', '兴业全球基金管理有限公司', '平安资产管理有限责任公司', '雅戈尔集团股份有限公司', '竞价', '中国海洋石油总公司', '海通证券股份有限公司', '纳爱斯集团有限公司', '泰康资产管理有限责任公司', '12', '刘益谦'}",25,"{'91182640', '1708999987', '海通证券股份有限公司', '119760100', '现金', '兴业全球基金管理有限公司', '1986820059', '120101265', '竞价', '纳爱斯集团有限公司', '中国海洋石油总公司', '太平洋资产管理有限责任公司', '平安资产管理有限责任公司', '雅戈尔集团股份有限公司', '91719710', '1992479986', '90665461', '90542495', '103013863', '106027727', '刘益谦', '1502099992', '91145871', '泰康资产管理有限责任公司', '12'}"
15,"{'227999989', '上海常春藤资产管理有限公司', '9306122', '8606442', '9224489', '210857829', '竞价', '225999980.5', '云禧(北京)投资基金管理有限公司', '合众人寿保险股份有限公司', '235999998.5', '国投瑞银基金管理有限公司', '前海开源基金管理有限公司', '12', '9632653'}",15461920,1,{'竞价'},1,{'12'},14,"{'227999989', '上海常春藤资产管理有限公司', '9306122', '8606442', '9224489', '210857829', '225999980.5', '云禧(北京)投资基金管理有限公司', '合众人寿保险股份有限公司', '235999998.5', '国投瑞银基金管理有限公司', '前海开源基金管理有限公司', '12', '9632653'}"
14,"{'馨羽实业', '20000000', '现金', '戴氏实业', '钱峰投资', '8600000', '驭健投资', '13000000', '宏望资产', '源进投资', '泓泽资产', '上海泓泽', '10000000', '36'}",151342,1,{'13000000'},10,"{'馨羽实业', '现金', '戴氏实业', '钱峰投资', '驭健投资', '宏望资产', '源进投资', '泓泽资产', '上海泓泽', '36'}",13,"{'馨羽实业', '20000000', '现金', '戴氏实业', '钱峰投资', '8600000', '驭健投资', '宏望资产', '源进投资', '泓泽资产', '上海泓泽', '10000000', '36'}"
6,"{'现金', '上海大华国化国际贸易有限公司', '定价', '上海华信石油集团有限公司', '大生商业有限公司', '36'}",227591,0,set(),6,"{'现金', '上海大华国化国际贸易有限公司', '定价', '上海华信石油集团有限公司', '大生商业有限公司', '36'}",6,"{'现金', '上海大华国化国际贸易有限公司', '定价', '上海华信石油集团有限公司', '大生商业有限公司', '36'}"
6,"{'430000000', '现金', '竞价', '50000000', '株洲市国有资产投资控股集团有限公司', '12'}",19743270,1,{'竞价'},3,"{'现金', '12', '株洲市国有资产投资控股集团有限公司'}",5,"{'430000000', '现金', '50000000', '株洲市国有资产投资控股集团有限公司', '12'}"
12,"{'华商基金管理有限公司--华商领先企业混合型开放式基金', '北京怡广投资管理有限公司', '5000000', '汇鑫期货经纪有限公司', '安徽安粮兴业有限公司', '4000000', '清华大学教育基金会', '3000000', '苏州海竞信息科技集团有限公司', '山东省企业托管经营股份有限公司', '12', '上海源海实业有限公司'}",818959,0,set(),8,"{'北京怡广投资管理有限公司', '汇鑫期货经纪有限公司', '安徽安粮兴业有限公司', '清华大学教育基金会', '苏州海竞信息科技集团有限公司', '山东省企业托管经营股份有限公司', '12', '上海源海实业有限公司'}",12,"{'华商基金管理有限公司--华商领先企业混合型开放式基金', '北京怡广投资管理有限公司', '5000000', '汇鑫期货经纪有限公司', '安徽安粮兴业有限公司', '4000000', '清华大学教育基金会', '3000000', '苏州海竞信息科技集团有限公司', '山东省企业托管经营股份有限公司', '12', '上海源海实业有限公司'}"
26,"{'17530460', '泰达宏利基金管理有限公司', '26451708', '张郁', '117100001.2', '178019994.8', '定价', '137999996', '财通基金管理有限公司', '13326867', '159059996.6', '253839999.9', '太平资产管理有限公司', '平安大华基金管理有限公司', '曹鲁江', '117100196.4', '深圳市保腾丰利创业投资企业(有限合伙)', '20505200', '117979995.8', '北京郁金香股权投资中心(有限合伙)', '37717682', '23634472', '17399732', '89689814.91', '12', '17399703'}",220604,4,"{'117100196.4', '117100001.2', '253839999.9', '159059996.6'}",8,"{'平安大华基金管理有限公司', '曹鲁江', '定价', '财通基金管理有限公司', '张郁', '泰达宏利基金管理有限公司', '12', '太平资产管理有限公司'}",22,"{'17530460', '泰达宏利基金管理有限公司', '26451708', '张郁', '178019994.8', '定价', '137999996', '财通基金管理有限公司', '13326867', '太平资产管理有限公司', '平安大华基金管理有限公司', '曹鲁江', '深圳市保腾丰利创业投资企业(有限合伙)', '20505200', '117979995.8', '北京郁金香股权投资中心(有限合伙)', '37717682', '23634472', '17399732', '89689814.91', '12', '17399703'}"
31,"{'胡卫红', '广州瑞德金晟投资管理合伙企业(有限合伙)', '11272439', '何琳', '现金', '江德湖', '摩登大道时尚集团股份有限公司—第一期员工持股计划', '18299998.46', '竞价', '27449997.69', '1610348', '11014771', '15249995.56', '东莞市长久创业投资行(有限合伙)', '76249996.74', '翁华银', '8051742', '梁美玲', '1932418', '138774999.4', '152499993.5', '李恩平', '59474942.91', '14654171', '6280353', '106749997.3', '16103484', '2898627', '寇凤英', '36', '104309881.4'}",10796231,4,"{'104309881.4', '竞价', '138774999.4', '152499993.5'}",9,"{'何琳', '胡卫红', '现金', '翁华银', '江德湖', '梁美玲', '寇凤英', '李恩平', '36'}",27,"{'胡卫红', '广州瑞德金晟投资管理合伙企业(有限合伙)', '11272439', '何琳', '现金', '江德湖', '摩登大道时尚集团股份有限公司—第一期员工持股计划', '18299998.46', '27449997.69', '1610348', '11014771', '15249995.56', '东莞市长久创业投资行(有限合伙)', '76249996.74', '翁华银', '8051742', '梁美玲', '1932418', '李恩平', '59474942.91', '14654171', '6280353', '106749997.3', '16103484', '2898627', '寇凤英', '36'}"
3,"{'36', '菱石投资', '134752300'}",1253683,0,set(),2,"{'菱石投资', '36'}",3,"{'36', '菱石投资', '134752300'}"
6,"{'中盛集团', '现金', '100000000', '8650519', '竞价', '36'}",4933450,2,"{'100000000', '8650519'}",4,"{'中盛集团', '现金', '竞价', '36'}",4,"{'中盛集团', '现金', '竞价', '36'}"
5,"{'现金', '40000000', '北京恒利创新投资有限公司', '竞价', '36'}",1348207,2,"{'竞价', '40000000'}",3,"{'36', '现金', '北京恒利创新投资有限公司'}",3,"{'36', '现金', '北京恒利创新投资有限公司'}"
4,"{'竞价', '现金', '36', '苏州通博'}",1335672,0,set(),4,"{'竞价', '现金', '36', '苏州通博'}",4,"{'竞价', '现金', '36', '苏州通博'}"
5,"{'240000000', '定价', '资产', '珠海格力集团有限公司', '36'}",1161318,0,set(),4,"{'资产', '定价', '珠海格力集团有限公司', '36'}",5,"{'240000000', '定价', '资产', '珠海格力集团有限公司', '36'}"
13,"{'现金、股权', '现金', '中节投', '37142343', '931529962.4', '定价', '中材股份', '8571771', '214980000', '4285886', '三峡新能源', '36', '107490000'}",1152881,6,"{'现金、股权', '37142343', '931529962.4', '214980000', '4285886', '107490000'}",6,"{'中节投', '现金', '定价', '中材股份', '三峡新能源', '36'}",7,"{'中节投', '现金', '定价', '中材股份', '8571771', '三峡新能源', '36'}"
21,"{'33101264', '11438607', '180729990.6', '现金', '22183543', '长城(天津)股权投资基金管理有限责任公司', '武汉东湖国隆股权投资基金管理有限公司', '定价', '12', '鹏华基金管理有限公司', '522999971.2', '12658227', '350499979.4', '199999986.6', '华融瑞通股权投资管理有限公司', '南通金玖锐信投资管理有限公司', '安信基金管理有限责任公司', '372070060.4', '11455696', '180999996.8', '23548738'}",17402454,3,"{'定价', '33101264', '522999971.2'}",7,"{'现金', '武汉东湖国隆股权投资基金管理有限公司', '南通金玖锐信投资管理有限公司', '鹏华基金管理有限公司', '安信基金管理有限责任公司', '华融瑞通股权投资管理有限公司', '12'}",18,"{'12658227', '350499979.4', '现金', '22183543', '180999996.8', '武汉东湖国隆股权投资基金管理有限公司', '11438607', '长城(天津)股权投资基金管理有限责任公司', '199999986.6', '372070060.4', '南通金玖锐信投资管理有限公司', '鹏华基金管理有限公司', '安信基金管理有限责任公司', '华融瑞通股权投资管理有限公司', '11455696', '180729990.6', '12', '23548738'}"
5,"{'现金', '721150000', '南航集团', '2278834000', '36'}",366404,2,"{'2278834000', '721150000'}",3,"{'现金', '36', '南航集团'}",3,"{'现金', '36', '南航集团'}"
13,"{'1999999996', '800000000.1', '现金', '郑州冬青企业管理中心(普通合伙)', '北京天证远洋基金管理中心(有限合伙)', '定价', '1000000002', '郭留希', '朱登营', '499999996.8', '287999997.6', '36', '北京天空鸿鼎投资中心(有限合伙)'}",15346793,1,{'1999999996'},5,"{'现金', '定价', '郭留希', '朱登营', '36'}",12,"{'800000000.1', '现金', '郑州冬青企业管理中心(普通合伙)', '北京天证远洋基金管理中心(有限合伙)', '1000000002', '定价', '郭留希', '朱登营', '499999996.8', '287999997.6', '36', '北京天空鸿鼎投资中心(有限合伙)'}"
20,"{'3800000', '8000000', '143250000', '上海瑞投投资管理有限公司', '7000000', '40110000', '9000000', '51570000', '45840000', '青岛锦盈投资有限公司', '25000000', '21774000', '上海顺泰创业投资有限公司', '57300000', '徐柏良', '10000000', '中海基金管理有限公司', '广东中汇合创房地产有限公司', '12', '上海昊阳创业投资有限公司'}",813114,11,"{'3800000', '8000000', '143250000', '40110000', '45840000', '51570000', '9000000', '25000000', '21774000', '57300000', '10000000'}",1,{'12'},9,"{'7000000', '青岛锦盈投资有限公司', '上海顺泰创业投资有限公司', '徐柏良', '上海瑞投投资管理有限公司', '中海基金管理有限公司', '广东中汇合创房地产有限公司', '12', '上海昊阳创业投资有限公司'}"
13,"{'3357958', '现金', '华夏基金管理有限公司', '株洲南车时代高新投资担保有限责任公司', '13420418', '定价', '中国食品发酵工业研究院', '中国轻工集团公司', '10073875', '6715916', '北京鸿道投资管理有限责任公司', '36', '福建嘉通资产管理有限公司'}",1709489,0,set(),8,"{'现金', '华夏基金管理有限公司', '株洲南车时代高新投资担保有限责任公司', '中国食品发酵工业研究院', '定价', '中国轻工集团公司', '北京鸿道投资管理有限责任公司', '福建嘉通资产管理有限公司'}",13,"{'3357958', '现金', '华夏基金管理有限公司', '株洲南车时代高新投资担保有限责任公司', '中国食品发酵工业研究院', '13420418', '定价', '中国轻工集团公司', '10073875', '6715916', '北京鸿道投资管理有限责任公司', '36', '福建嘉通资产管理有限公司'}"
15,"{'14047600', '现金', '泽熙增煦', '广发恒定18号', '106966700', '翁霖', '8428600', '定价', '404334100', '53100000', '16857100', '63720000', '31860000', '翁耀根', '36'}",1771092,8,"{'14047600', '8428600', '404334100', '53100000', '16857100', '63720000', '31860000', '106966700'}",6,"{'现金', '泽熙增煦', '翁霖', '定价', '翁耀根', '36'}",7,"{'现金', '泽熙增煦', '广发恒定18号', '翁霖', '定价', '翁耀根', '36'}"
5,"{'滨州市国有资产经营有限公司', '现金', '60000000', '竞价', '36'}",1793644,1,{'60000000'},4,"{'滨州市国有资产经营有限公司', '现金', '竞价', '36'}",4,"{'滨州市国有资产经营有限公司', '现金', '竞价', '36'}"
4,"{'36', '银鸽集团', '现金', '423728813'}",371457,1,{'423728813'},3,"{'36', '银鸽集团', '现金'}",3,"{'现金', '银鸽集团', '36'}"
26,"{'3978954', '华安基金管理有限公司', '504538000', '广发基金管理有限公司', '250088000', '36300000', '844774000', '现金', '17200000', '工银瑞信基金管理有限公司', '808424000', '55600000', '34700000', '34500000', '新华资产管理股份有限公司', '博时基金管理有限公司', '中国电子科技集团公司', '58100000', '501630000', '527802000', '南方工业资产管理有限责任公司', '中国人寿资产管理有限公司', '上海锐懿资产管理有限公司', '57853991.16', '12', '海富通基金管理有限公司'}",900266,5,"{'3978954', '17200000', '55600000', '36300000', '58100000'}",2,"{'现金', '12'}",21,"{'华安基金管理有限公司', '504538000', '广发基金管理有限公司', '250088000', '844774000', '现金', '工银瑞信基金管理有限公司', '808424000', '34700000', '34500000', '新华资产管理股份有限公司', '博时基金管理有限公司', '中国电子科技集团公司', '501630000', '527802000', '南方工业资产管理有限责任公司', '中国人寿资产管理有限公司', '上海锐懿资产管理有限公司', '57853991.16', '12', '海富通基金管理有限公司'}"
17,"{'9404537', '华录集团', '现金', '博时资本', '长城国融', '14177693', '550000000', '定价', '25992439', '199000000', '申万菱信基金', '300000000', '28355387', '2362949', '50000000', '36', '博时基金'}",1812687,2,"{'199000000', '550000000'}",8,"{'华录集团', '现金', '博时资本', '长城国融', '定价', '申万菱信基金', '36', '博时基金'}",15,"{'9404537', '华录集团', '现金', '博时资本', '长城国融', '14177693', '定价', '25992439', '申万菱信基金', '300000000', '28355387', '2362949', '50000000', '36', '博时基金'}"
5,"{'现金', '226666625', '豫联集团', '竞价', '36'}",395640,1,{'竞价'},2,"{'豫联集团', '现金'}",4,"{'豫联集团', '现金', '226666625', '36'}"
16,"{'3800000', '工银瑞信基金管理有限公司', '华夏基金管理有限公司', '季峰', '12', '观唐投资控股有限公司', '定价', '15000000', '昝圣达', '3400000', '北京市融成源投资有限公司', '7600000', '上海鼎基投资有限公司', '10000000', '36', '天津证大金兔股权投资基金合伙企业(有限合伙)'}",423731,3,"{'3800000', '3400000', '7600000'}",10,"{'工银瑞信基金管理有限公司', '华夏基金管理有限公司', '季峰', '12', '观唐投资控股有限公司', '定价', '昝圣达', '北京市融成源投资有限公司', '上海鼎基投资有限公司', '36'}",13,"{'36', '工银瑞信基金管理有限公司', '华夏基金管理有限公司', '季峰', '观唐投资控股有限公司', '定价', '15000000', '昝圣达', '北京市融成源投资有限公司', '上海鼎基投资有限公司', '10000000', '12', '天津证大金兔股权投资基金合伙企业(有限合伙)'}"
21,"{'华安基金管理有限公司', '财通证券有限责任公司', '195300000', '122850000', '海通证券股份有限公司', '93500000', '工银瑞信基金管理有限公司', '196500000', '定价', '152700000', '景顺长城基金管理有限公司', '208800000', '华安财产保险股份有限公司', '光大保德信基金管理有限公司', '246500000', '汇添富基金管理有限公司', '北京瑞鑫网科技发展有限公司', '257950000', '融通基金管理有限公司', '294850000', '12'}",163423,7,"{'208800000', '257950000', '195300000', '122850000', '196500000', '93500000', '152700000'}",2,"{'定价', '12'}",14,"{'景顺长城基金管理有限公司', '华安财产保险股份有限公司', '华安基金管理有限公司', '工银瑞信基金管理有限公司', '北京瑞鑫网科技发展有限公司', '财通证券有限责任公司', '定价', '融通基金管理有限公司', '光大保德信基金管理有限公司', '海通证券股份有限公司', '246500000', '294850000', '12', '汇添富基金管理有限公司'}"
9,"{'761800000', '现金', '586000000', '吴长江', '100000000', '定价', '130000000', '芜湖德豪投资', '36'}",581024,3,"{'100000000', '761800000', '586000000'}",5,"{'现金', '吴长江', '定价', '芜湖德豪投资', '36'}",6,"{'现金', '吴长江', '定价', '130000000', '芜湖德豪投资', '36'}"
4,"{'现金', '定价', '36', '高树华'}",12040863,0,set(),4,"{'36', '定价', '现金', '高树华'}",4,"{'现金', '定价', '36', '高树华'}"
29,"{'346560000', '汇石混改1号', '45066480', '华沅投资', '1276800000', '684000000', '140000000', '云南煤化工集团有限公司', '现金', '西藏瑞华', '40000000', '定价', '150000000', '36', '66000000', '638400000', '364800000', '云能基金', '员工持股计划', '云南云维集团有限公司', '182400000', '云南东源煤业集团有限公司', '华泰云帆1号', '280000000', '9883000', '大美中和', '80000000', '76000000', '300960000'}",1779733,0,set(),11,"{'现金', '西藏瑞华', '华沅投资', '云能基金', '定价', '员工持股计划', '云南云维集团有限公司', '大美中和', '云南东源煤业集团有限公司', '36', '云南煤化工集团有限公司'}",29,"{'346560000', '汇石混改1号', '45066480', '华沅投资', '1276800000', '684000000', '140000000', '云南煤化工集团有限公司', '西藏瑞华', '40000000', '现金', '定价', '150000000', '36', '66000000', '638400000', '364800000', '云能基金', '员工持股计划', '云南云维集团有限公司', '182400000', '云南东源煤业集团有限公司', '华泰云帆1号', '280000000', '9883000', '大美中和', '80000000', '76000000', '300960000'}"
12,"{'现金', '29108639', '991440267', '定价', '87325918', '495720133', '北京京国瑞国企改革发展基金(有限合伙)', '三胞集团南京投资管理有限公司', '上海懿兆实业投资有限公司', '36', '1487160400', '58217279'}",4953705,3,"{'991440267', '495720133', '1487160400'}",5,"{'现金', '定价', '三胞集团南京投资管理有限公司', '上海懿兆实业投资有限公司', '36'}",9,"{'现金', '定价', '87325918', '北京京国瑞国企改革发展基金(有限合伙)', '三胞集团南京投资管理有限公司', '上海懿兆实业投资有限公司', '36', '29108639', '58217279'}"
17,"{'190000064.8', '中华联合', '现金', '同药集团', '99999972.8', '定价', '412088', '浙江商裕', '1373626', '陈德康', '15000003.2', '2747252', '平安资产鑫享7号资产管理产品', '东丰药业', '5219782', '36', '49999986.4'}",15553135,0,set(),9,"{'中华联合', '现金', '同药集团', '定价', '浙江商裕', '陈德康', '平安资产鑫享7号资产管理产品', '东丰药业', '36'}",17,"{'190000064.8', '中华联合', '现金', '同药集团', '99999972.8', '定价', '412088', '浙江商裕', '1373626', '陈德康', '15000003.2', '2747252', '平安资产鑫享7号资产管理产品', '东丰药业', '5219782', '36', '49999986.4'}"
22,"{'17658666', '申万菱信(上海)资产管理有限公司', '申万菱信基金管理有限公司', '172012795.5', '前海开源基金管理有限公司', '现金', '172171993.5', '定价', '52923077', '厦门象屿集团有限公司', '财通基金管理有限公司', '202599998.3', '17642338', '36', '141299213.3', '14492227', '20779487', '516000000.8', '515915994.8', '52914461', '安信基金管理有限责任公司', '12'}",317510,22,"{'36', '141299213.3', '14492227', '17658666', '申万菱信(上海)资产管理有限公司', '20779487', '申万菱信基金管理有限公司', '516000000.8', '515915994.8', '172012795.5', '前海开源基金管理有限公司', '52914461', '现金', '172171993.5', '12', '定价', '52923077', '财通基金管理有限公司', '202599998.3', '安信基金管理有限责任公司', '17642338', '厦门象屿集团有限公司'}",0,set(),0,set()
4,"{'廖创宾', '竞价', '现金', '36'}",1215958,0,set(),4,"{'廖创宾', '竞价', '现金', '36'}",4,"{'廖创宾', '竞价', '现金', '36'}"
5,"{'现金', '海亮金属贸易集团有限公司', '竞价', '300000000', '36'}",711300,2,"{'竞价', '300000000'}",3,"{'现金', '36', '海亮金属贸易集团有限公司'}",3,"{'现金', '36', '海亮金属贸易集团有限公司'}"
24,"{'20050000', '337142857', '2076800000', '现金', '40000000', '90379870', '214204545', '616000000', '竞价', '1319500000', '92400000', '兴隆18号资管计划', '吕清明', '丰信管理', '15000000', '信利隆科技', '兴隆17号资管计划', '246400000', '100000000', '123508000', '556740000', '德勤贸易', '龙跃投资', '36'}",9027400,9,"{'337142857', '123508000', '15000000', '556740000', '616000000', '2076800000', '1319500000', '92400000', '246400000'}",8,"{'现金', '吕清明', '丰信管理', '竞价', '信利隆科技', '德勤贸易', '龙跃投资', '36'}",15,"{'现金', '40000000', '20050000', '90379870', '214204545', '100000000', '兴隆17号资管计划', '吕清明', '丰信管理', '竞价', '信利隆科技', '德勤贸易', '龙跃投资', '兴隆18号资管计划', '36'}"
12,"{'5661766', '现金', '陈显龙', '罗新伟', '198444900', '154349900', '4403706', '8523831', '江春华', '298760300', '方文', '36'}",15507011,3,"{'154349900', '198444900', '298760300'}",6,"{'现金', '陈显龙', '罗新伟', '江春华', '方文', '36'}",9,"{'5661766', '现金', '陈显龙', '罗新伟', '4403706', '8523831', '江春华', '方文', '36'}"
5,"{'56000000', '现金', '宝发1号', '竞价', '12'}",6416667,0,set(),3,"{'竞价', '现金', '12'}",5,"{'56000000', '现金', '宝发1号', '竞价', '12'}"
24,"{'20000000', '华安基金管理有限公司', '76299994.98', '40183344', '8189845', '74199995.7', '光大金控(上海)投资咨询合伙企业(有限合伙)', '光大金控(上海)投资中心(有限合伙)', '364061096.6', '72999998.7', '兴业全球基金管理有限公司', '王宏涛', '8830022', '董含斌', '73199998.2', '9460509', '中国振华电子集团有限公司', '8057395', '金鹰基金管理有限公司', '8079470', '85712211.54', '8421633', '181200000', '79999999.32'}",735576,3,"{'79999999.32', '85712211.54', '76299994.98'}",1,{'中国振华电子集团有限公司'},21,"{'20000000', '华安基金管理有限公司', '40183344', '8189845', '74199995.7', '364061096.6', '光大金控(上海)投资中心(有限合伙)', '光大金控(上海)投资咨询合伙企业(有限合伙)', '72999998.7', '兴业全球基金管理有限公司', '王宏涛', '8830022', '董含斌', '73199998.2', '9460509', '中国振华电子集团有限公司', '8057395', '金鹰基金管理有限公司', '8079470', '8421633', '181200000'}"
4,"{'集团公司', '竞价', '现金', '36'}",678268,0,set(),4,"{'集团公司', '竞价', '现金', '36'}",4,"{'集团公司', '竞价', '现金', '36'}"
15,"{'华夏人寿保险股份有限公司', '现金', '新余市合盛锦禾投资管理中心(有限合伙)', '45987804', '嘉兴天璇海容创业投资合伙企业(有限合伙)', '定价', '10219512', '8175609', '山西亚宝投资有限公司', '李天虎', '山西省经济建设投资集团有限公司', '北京民生新晖投资合伙企业(有限合伙)', '5109756', '36', '邹朝辉'}",1842888,2,"{'山西省经济建设投资集团有限公司', '山西亚宝投资有限公司'}",6,"{'华夏人寿保险股份有限公司', '现金', '定价', '李天虎', '36', '邹朝辉'}",13,"{'华夏人寿保险股份有限公司', '现金', '新余市合盛锦禾投资管理中心(有限合伙)', '45987804', '嘉兴天璇海容创业投资合伙企业(有限合伙)', '定价', '10219512', '8175609', '李天虎', '北京民生新晖投资合伙企业(有限合伙)', '5109756', '36', '邹朝辉'}"
17,"{'8500000', '现金', '5000000', '上海三宏投资有限公司', '万向财务有限公司', '上海金浙投资管理有限公司', '北京九鼎房地产开发有限公司', '7000000', '深圳市盈润投资发展有限公司', '5500000', '上海和远科技发展有限公司', '蚌埠建设投资有限公司', '常州投资集团有限公司', '深圳市东方合源投资顾问有限公司', '9000000', '12', '江苏汇鸿国际集团针棉织品进出口公司'}",943716,5,"{'8500000', '5000000', '7000000', '5500000', '9000000'}",2,"{'现金', '12'}",12,"{'现金', '上海三宏投资有限公司', '万向财务有限公司', '上海金浙投资管理有限公司', '北京九鼎房地产开发有限公司', '深圳市盈润投资发展有限公司', '上海和远科技发展有限公司', '蚌埠建设投资有限公司', '常州投资集团有限公司', '深圳市东方合源投资顾问有限公司', '12', '江苏汇鸿国际集团针棉织品进出口公司'}"
12,"{'37593984', '18796992', '银华基金管理有限公司', '400000000', '华夏基金管理有限公司', '大成基金管理有限公司', '75281954', '200000000', '金元惠理基金管理有限公司', '泰达宏利基金管理有限公司', '801000000', '12'}",1170732,3,"{'801000000', '200000000', '400000000'}",6,"{'银华基金管理有限公司', '华夏基金管理有限公司', '大成基金管理有限公司', '金元惠理基金管理有限公司', '泰达宏利基金管理有限公司', '12'}",9,"{'37593984', '18796992', '银华基金管理有限公司', '华夏基金管理有限公司', '大成基金管理有限公司', '75281954', '金元惠理基金管理有限公司', '泰达宏利基金管理有限公司', '12'}"
5,"{'现金', '50100200', '银河天成集团有限公司', '申银万国管理的宝鼎18期集合资产管理计划', '36'}",1140384,2,"{'50100200', '申银万国管理的宝鼎18期集合资产管理计划'}",3,"{'银河天成集团有限公司', '现金', '36'}",3,"{'银河天成集团有限公司', '现金', '36'}"
18,"{'济南沃达投资合伙企业(有限合伙)', '现金', '上海鑫脉投资管理有限公司', '300366000', '18000000', '东营广进投资合伙企业(有限合伙)', '80900000', '17100000', '15300000', '112914000', '126198000', '刘静', '东海基金资产管理计划', '40700000', '132840000', '湖南深泰虹科技有限公司', '36', '597042000'}",578378,9,"{'300366000', '18000000', '80900000', '17100000', '15300000', '112914000', '126198000', '132840000', '597042000'}",5,"{'现金', '上海鑫脉投资管理有限公司', '刘静', '东海基金资产管理计划', '36'}",9,"{'济南沃达投资合伙企业(有限合伙)', '现金', '上海鑫脉投资管理有限公司', '东营广进投资合伙企业(有限合伙)', '刘静', '东海基金资产管理计划', '40700000', '湖南深泰虹科技有限公司', '36'}"
29,"{'4253835', '195999999.5', '嘉实资本管理有限公司', '建信基金管理有限责任公司', '41004184', '现金', '109999998.6', '财通基金管理有限公司', '竞价', '汇添富基金管理股份有限公司', '36', '20920502', '27824267', '8507672', '199999999.1', '40666672.16', '125523012', '132999996.3', '20333331.3', '广发证券资产管理(广东)有限公司', '23012552', '中信国安投资有限公司', '599999997.4', '嘉实基金管理有限公司', '99999999.56', '泰康资产管理有限责任公司', '41841004', '12', '江西高技术产业发展有限责任公司'}",1708109,5,"{'109999998.6', '40666672.16', '99999999.56', '599999997.4', '132999996.3'}",9,"{'现金', '12', '财通基金管理有限公司', '嘉实基金管理有限公司', '竞价', '建信基金管理有限责任公司', '汇添富基金管理股份有限公司', '36', '江西高技术产业发展有限责任公司'}",24,"{'4253835', '195999999.5', '嘉实资本管理有限公司', '建信基金管理有限责任公司', '41004184', '现金', '财通基金管理有限公司', '竞价', '汇添富基金管理股份有限公司', '36', '20920502', '27824267', '8507672', '199999999.1', '125523012', '20333331.3', '广发证券资产管理(广东)有限公司', '23012552', '中信国安投资有限公司', '嘉实基金管理有限公司', '泰康资产管理有限责任公司', '41841004', '12', '江西高技术产业发展有限责任公司'}"
18,"{'20964360', '杭州新域欣源投资合伙企业(有限合伙)', '现金', '2096436', '219999993.8', '定价', '99999997.2', '中钢资产管理有限责任公司', '6988120', '299999991.6', '中航祥瑞集合资产管理计划', '10667366', '红土创新红人1号资产管理计划', '152650007.5', '江阴市长江钢管有限公司', '29999999.16', '36', '15373864'}",15527018,3,"{'99999997.2', '152650007.5', '29999999.16'}",5,"{'现金', '定价', '中钢资产管理有限责任公司', '江阴市长江钢管有限公司', '36'}",15,"{'20964360', '杭州新域欣源投资合伙企业(有限合伙)', '现金', '2096436', '219999993.8', '定价', '中钢资产管理有限责任公司', '299999991.6', '中航祥瑞集合资产管理计划', '10667366', '红土创新红人1号资产管理计划', '6988120', '江阴市长江钢管有限公司', '36', '15373864'}"
6,"{'珠海元天锦华投资管理中心(有限合伙)', '现金', '珠海颐和天成投资管理中心(有限合伙)', '竞价', '珠海富锦天佑投资管理中心(有限合伙)', '36'}",936753,4,"{'珠海元天锦华投资管理中心(有限合伙)', '珠海颐和天成投资管理中心(有限合伙)', '珠海富锦天佑投资管理中心(有限合伙)', '竞价'}",2,"{'现金', '36'}",2,"{'现金', '36'}"
5,"{'资产', '竞价', '25000000', '山东金岭铁矿', '36'}",1395003,2,"{'竞价', '山东金岭铁矿'}",2,"{'资产', '36'}",3,"{'资产', '25000000', '36'}"
4,"{'36', '定价', '深圳市机场(集团)有限公司', '250560000'}",1374446,2,"{'定价', '250560000'}",1,{'36'},2,"{'深圳市机场(集团)有限公司', '36'}"
18,"{'5000000', '现金', '理成全球视野3期投资基金', '理成南都资产管理计划', '70000000', '定价', '23000000', '64000000', '41000000', '杭州九纳投资合伙企业(有限合伙)', '588000000', '42000000', '海通定增1号定向资产管理计划', '宁波中金富盈股权投资合伙企业(有限合伙)', '896000000', '574000000', '36', '322000000'}",4957896,0,set(),4,"{'定价', '现金', '36', '理成南都资产管理计划'}",18,"{'5000000', '现金', '理成全球视野3期投资基金', '理成南都资产管理计划', '70000000', '定价', '23000000', '64000000', '41000000', '杭州九纳投资合伙企业(有限合伙)', '588000000', '42000000', '海通定增1号定向资产管理计划', '宁波中金富盈股权投资合伙企业(有限合伙)', '896000000', '574000000', '36', '322000000'}"
15,"{'5000000', '现金', '武汉荣盛投资有限公司', '3500000', '天津凯石益利股权投资基金合伙企业(有限合伙)', '傅见林', '沈振国', '3700000', '西藏自治区投资有限公司', '竞价', '常州投资集团有限公司', '3000000', '中国建设银行-工银瑞信稳健成长股票型证券投资基金', '上海天誉投资有限公司', '12'}",493402,1,{'竞价'},3,"{'沈振国', '现金', '12'}",14,"{'5000000', '武汉荣盛投资有限公司', '现金', '3500000', '天津凯石益利股权投资基金合伙企业(有限合伙)', '傅见林', '沈振国', '3700000', '西藏自治区投资有限公司', '常州投资集团有限公司', '3000000', '中国建设银行-工银瑞信稳健成长股票型证券投资基金', '上海天誉投资有限公司', '12'}"
4,"{'定价', '盛屯集团', '现金', '36'}",14792759,0,set(),4,"{'36', '现金', '定价', '盛屯集团'}",4,"{'定价', '盛屯集团', '现金', '36'}"
10,"{'90594000', '172560000', '1857176', '4000000', '80118573', '竞价', '深圳市恒泰华盛资产管理有限公司', '2100000', '上海原龙投资有限公司', '苏州市投资有限公司'}",14784727,1,{'竞价'},1,{'上海原龙投资有限公司'},9,"{'90594000', '172560000', '1857176', '4000000', '80118573', '深圳市恒泰华盛资产管理有限公司', '2100000', '上海原龙投资有限公司', '苏州市投资有限公司'}"
22,"{'41088000', '4800000', '8000000', '5000000', '现金', '定价', '4900000', '王宏涛', '41944000', '虞文雅', '40799998.8', '4766355', '中信证券股份有限公司', '42800000', '68480000', '上海哲熙投资管理合伙企业(有限合伙)', '张萍', '81320000', '深圳市中信联合创业投资有限公司', '国泰基金公司-工行-陕西省国际信托股份有限公司', '博弘数君(天津)股权投资基金合伙企业(有限合伙)', '12'}",1488765,10,"{'5000000', '40799998.8', '41088000', '4766355', '81320000', '42800000', '41944000', '4900000', '68480000', '4800000'}",8,"{'现金', '定价', '张萍', '深圳市中信联合创业投资有限公司', '王宏涛', '中信证券股份有限公司', '虞文雅', '12'}",12,"{'现金', '上海哲熙投资管理合伙企业(有限合伙)', '定价', '张萍', '深圳市中信联合创业投资有限公司', '王宏涛', '中信证券股份有限公司', '国泰基金公司-工行-陕西省国际信托股份有限公司', '博弘数君(天津)股权投资基金合伙企业(有限合伙)', '8000000', '虞文雅', '12'}"
11,"{'现金', '591619933', '股权、现金', '华君电力', '111111111', '保华兴资产', '38009696', '定价', '瑞尔德', '股权', '36'}",2032616,4,"{'38009696', '111111111', '591619933', '股权、现金'}",7,"{'现金', '华君电力', '保华兴资产', '定价', '瑞尔德', '股权', '36'}",7,"{'现金', '华君电力', '保华兴资产', '定价', '瑞尔德', '股权', '36'}"
24,"{'13500000', '81180400', '安徽省铁路建设投资基金有限公司', '23000000', '238896000', '149310000', '袁吉', '143780000', '现金', '定价', '财通基金管理有限公司', '安徽省投资集团控股有限公司', '7340000', '254380000', '13100000', '太平资产管理有限公司', '144886000', '博时基金管理有限公司', '申银万国证券股份有限公司', '浙商证券股份有限公司', '金鹰基金管理有限公司', '13000000', '21600000', '12'}",1158521,6,"{'81180400', '238896000', '149310000', '143780000', '254380000', '144886000'}",12,"{'金鹰基金管理有限公司', '现金', '安徽省铁路建设投资基金有限公司', '定价', '博时基金管理有限公司', '财通基金管理有限公司', '安徽省投资集团控股有限公司', '申银万国证券股份有限公司', '袁吉', '浙商证券股份有限公司', '12', '太平资产管理有限公司'}",18,"{'金鹰基金管理有限公司', '13500000', '现金', '安徽省铁路建设投资基金有限公司', '13000000', '博时基金管理有限公司', '23000000', '定价', '财通基金管理有限公司', '安徽省投资集团控股有限公司', '21600000', '申银万国证券股份有限公司', '袁吉', '浙商证券股份有限公司', '7340000', '12', '13100000', '太平资产管理有限公司'}"
16,"{'江西富源贸易有限公司', '20000000', '江苏瑞华投资发展有限公司', '88000000', '12', '长江证券有限责任公司', '15000000', '上海证大投资管理有限公司', '11000000', '兴业银行股份有限公司—兴业趋势投资混合型证券投资基金', '10000000', '湖北省能源集团有限公司', '中国国电集团公司', '泰康资产管理有限公司', '36', '浙江工信房地产开发有限公司'}",1126797,3,"{'88000000', '20000000', '11000000'}",6,"{'36', '上海证大投资管理有限公司', '湖北省能源集团有限公司', '中国国电集团公司', '泰康资产管理有限公司', '12'}",13,"{'江西富源贸易有限公司', '36', '江苏瑞华投资发展有限公司', '长江证券有限责任公司', '15000000', '上海证大投资管理有限公司', '兴业银行股份有限公司—兴业趋势投资混合型证券投资基金', '10000000', '湖北省能源集团有限公司', '中国国电集团公司', '泰康资产管理有限公司', '12', '浙江工信房地产开发有限公司'}"
4,"{'天津机械工程研究院', '竞价', '现金', '36'}",1158872,0,set(),4,"{'天津机械工程研究院', '竞价', '现金', '36'}",4,"{'天津机械工程研究院', '竞价', '现金', '36'}"
6,"{'现金', '华晨集团', '定价', '518000000', '200000000', '36'}",1781141,2,"{'200000000', '518000000'}",4,"{'华晨集团', '定价', '现金', '36'}",4,"{'华晨集团', '现金', '定价', '36'}"
26,"{'3000000', '5600000', '8000000', '9050000', '现金', '北京泰腾博越资本管理中心(有限合伙)', '厦门国贸控股有限公司', '12', '东海证券股份有限公司(资管账户)', '竞价', '太平资产管理有限公司', '54432000', '36', '呼怀旭', '1393830', '王世强', '29160000', '东海基金管理有限责任公司', '13548027.6', '华鑫证券有限责任公司', '山西证券股份有限公司', '77760000', '东海证券股份有限公司(自营账户)', '87966000', '205968870.4', '21190213'}",794804,10,"{'54432000', '1393830', '29160000', '77760000', '13548027.6', '竞价', '87966000', '205968870.4', '9050000', '21190213'}",5,"{'36', '现金', '厦门国贸控股有限公司', '东海基金管理有限责任公司', '12'}",16,"{'呼怀旭', '现金', '山西证券股份有限公司', '北京泰腾博越资本管理中心(有限合伙)', '王世强', '厦门国贸控股有限公司', '12', '东海证券股份有限公司(资管账户)', '东海基金管理有限责任公司', '华鑫证券有限责任公司', '3000000', '东海证券股份有限公司(自营账户)', '5600000', '8000000', '36', '太平资产管理有限公司'}"
5,"{'现金', '齐翔集团', '竞价', '356998300', '36'}",1163364,2,"{'356998300', '36'}",3,"{'齐翔集团', '竞价', '现金'}",3,"{'齐翔集团', '竞价', '现金'}"
19,"{'汇添富基金管理的仙琚制药定增盛世45号和优势医药企业定增计划6号资产管理计划', '1516797', '现金', '九鸿投资', '21276419', '11198211', '定价', '仙居国资', '22246360', '中企汇锦', '5055991', '范敏华', '李勤俭', '平安资管管理的平安创赢5号产品', '20223964', '张宇松', '2022396', '36', '财通基金管理的财通专户1号计划'}",1650395,3,"{'汇添富基金管理的仙琚制药定增盛世45号和优势医药企业定增计划6号资产管理计划', '平安资管管理的平安创赢5号产品', '财通基金管理的财通专户1号计划'}",9,"{'36', '现金', '九鸿投资', '定价', '仙居国资', '李勤俭', '中企汇锦', '张宇松', '范敏华'}",16,"{'1516797', '现金', '九鸿投资', '21276419', '11198211', '定价', '仙居国资', '22246360', '中企汇锦', '5055991', '范敏华', '李勤俭', '20223964', '张宇松', '2022396', '36'}"
3,"{'吴迪', '现金', '36'}",9887360,0,set(),3,"{'吴迪', '现金', '36'}",3,"{'吴迪', '现金', '36'}"
5,"{'现金', '100000000', '窦啟玲', '竞价', '36'}",1174272,1,{'100000000'},4,"{'窦啟玲', '竞价', '现金', '36'}",4,"{'窦啟玲', '竞价', '现金', '36'}"
4,"{'120000000', '定价', 'Reco Shine Pte Ltd', '36'}",822937,0,set(),3,"{'定价', 'Reco Shine Pte Ltd', '36'}",4,"{'定价', 'Reco Shine Pte Ltd', '120000000', '36'}"
4,"{'现金', '247000000', '36', '东药集团'}",1201262,1,{'247000000'},3,"{'现金', '36', '东药集团'}",3,"{'现金', '36', '东药集团'}"
34,"{'恶戈尔集团股份有限公司', '1000326994', '79287671', '1071476987', '205536048.6', '87000000', '现金', '宝钢集团有限公司', '新华人寿保险股份有限公司', '定价', '75675702', '1033157992', '74488680', '博时基金管枞有限公司', '77251405', '1320299988', '95191059', '上海汽车工惄(集团)旙公司', '1049621987', '36', '1000000009', '1013169990', '国华人寿保险股份有限公司', '上海润科实惄有限公司', '华安基金管枞有限公司', '1206690000', '72121629', '14818749', '72098054', '73047584', '1099719997', '泰康旇产管枞有限责任公司', '惦方达基金管枞有限公司', '12'}",1503034,4,"{'1000000009', '1049621987', '1033157992', '1099719997'}",12,"{'现金', '恶戈尔集团股份有限公司', '宝钢集团有限公司', '新华人寿保险股份有限公司', '12', '定价', '国华人寿保险股份有限公司', '上海润科实惄有限公司', '博时基金管枞有限公司', '惦方达基金管枞有限公司', '华安基金管枞有限公司', '36'}",30,"{'恶戈尔集团股份有限公司', '1000326994', '79287671', '1071476987', '205536048.6', '87000000', '现金', '宝钢集团有限公司', '新华人寿保险股份有限公司', '75675702', '定价', '74488680', '博时基金管枞有限公司', '77251405', '1320299988', '95191059', '上海汽车工惄(集团)旙公司', '36', '1013169990', '国华人寿保险股份有限公司', '上海润科实惄有限公司', '华安基金管枞有限公司', '1206690000', '72121629', '14818749', '72098054', '73047584', '泰康旇产管枞有限责任公司', '惦方达基金管枞有限公司', '12'}"
6,"{'现金', '定价', '锦江国际(集团)有限公司', '222222200', '999999900', '36'}",1160724,2,"{'999999900', '定价'}",2,"{'现金', '36'}",4,"{'锦江国际(集团)有限公司', '36', '现金', '222222200'}"
18,"{'华夏人寿保险股份有限公司', '现金', '中再资产管理股份有限公司', '刘宏光', '4000000', '定价', '申万菱信(上海)资产管理有限公司', '东海基金管理有限公司', '天安财产保险股份有限公司', '7000000', '4600000', '财通基金管理有限公司', '渤海证券股份有限公司', '1195800', '4200000', '4800000', '8000000', '12'}",310555,3,"{'1195800', '4800000', '4200000'}",10,"{'华夏人寿保险股份有限公司', '中再资产管理股份有限公司', '现金', '刘宏光', '定价', '东海基金管理有限公司', '天安财产保险股份有限公司', '财通基金管理有限公司', '渤海证券股份有限公司', '12'}",15,"{'华夏人寿保险股份有限公司', '中再资产管理股份有限公司', '现金', '刘宏光', '4000000', '4600000', '申万菱信(上海)资产管理有限公司', '东海基金管理有限公司', '7000000', '天安财产保险股份有限公司', '财通基金管理有限公司', '定价', '渤海证券股份有限公司', '8000000', '12'}"
6,"{'现金', '天通高新集团有限公司', '50000000', '10000000', '36', '杜海利'}",925539,0,set(),4,"{'现金', '天通高新集团有限公司', '36', '杜海利'}",6,"{'现金', '天通高新集团有限公司', '50000000', '10000000', '36', '杜海利'}"
4,"{'现金', '宝塔石化', '36', '30870666'}",1136847,0,set(),3,"{'现金', '宝塔石化', '36'}",4,"{'现金', '宝塔石化', '36', '30870666'}"
10,"{'重庆北斗投资中心(有限合伙', '东海基金管理有限责任公司', '财通基金管理有限公司', '易方达基金管理有限公司', '竞价', '13276686', '5894848', '5841741', '12', '2850336'}",1630701,1,{'竞价'},4,"{'东海基金管理有限责任公司', '易方达基金管理有限公司', '12', '财通基金管理有限公司'}",9,"{'重庆北斗投资中心(有限合伙', '东海基金管理有限责任公司', '财通基金管理有限公司', '易方达基金管理有限公司', '13276686', '5894848', '5841741', '12', '2850336'}"
6,"{'现金', '深圳安鹏汽车后市场产业基金(有限合伙)', '竞价', '300000000', '财通资产-金固股份高管定增特定多个客户专项资产管理计划', '36'}",1815787,4,"{'深圳安鹏汽车后市场产业基金(有限合伙)', '财通资产-金固股份高管定增特定多个客户专项资产管理计划', '竞价', '300000000'}",2,"{'现金', '36'}",2,"{'现金', '36'}"
5,"{'西藏知合', '5000000000', '3000000000', '36', '昆山国创'}",14704626,3,"{'3000000000', '5000000000', '昆山国创'}",2,"{'西藏知合', '36'}",2,"{'西藏知合', '36'}"
14,"{'5000000', '现金', '太平洋资产管理有限责任公司', '2936532', '中国中材股份有限公司', '12', '4000000', '中国银河投资管理有限公司', '易方达基金管理有限公司', '10000000', '叶祥尧', '王士亮', '36', '49975012'}",1238271,0,set(),9,"{'36', '太平洋资产管理有限责任公司', '现金', '中国中材股份有限公司', '中国银河投资管理有限公司', '易方达基金管理有限公司', '叶祥尧', '王士亮', '12'}",14,"{'5000000', '现金', '太平洋资产管理有限责任公司', '2936532', '中国中材股份有限公司', '12', '4000000', '中国银河投资管理有限公司', '易方达基金管理有限公司', '10000000', '叶祥尧', '王士亮', '36', '49975012'}"
8,"{'600000000', '债权、现金', '竞价', '宝钢集团', '300000000', '中船集团', '36', '中国海运'}",500722,3,"{'300000000', '债权、现金', '600000000'}",5,"{'竞价', '宝钢集团', '中船集团', '36', '中国海运'}",5,"{'竞价', '宝钢集团', '中船集团', '36', '中国海运'}"
9,"{'5000000', '现金', '定价', '航联保险经纪有限公司', '2800000', '兴业基金管理有限公司', '7200000', '泰康资产管理有限公司', '12'}",550995,3,"{'2800000', '7200000', '定价'}",5,"{'现金', '航联保险经纪有限公司', '兴业基金管理有限公司', '泰康资产管理有限公司', '12'}",6,"{'5000000', '现金', '航联保险经纪有限公司', '兴业基金管理有限公司', '泰康资产管理有限公司', '12'}"
19,"{'5000000', '中航鑫港担保有限公司', '141000000', '高勇', '博时基金管理有限公司', '131600000', '嘉实基金管理有限公司', '中国银河投资管理有限公司', '4953191', '竞价', '中信证券股份有限公司', '中国对外经济贸易信托有限公司', '117500000', '235000000', '6000000', '10000000', '116399988.5', '12', '5600000'}",53878,7,"{'141000000', '131600000', '4953191', '竞价', '117500000', '235000000', '116399988.5'}",2,"{'中国银河投资管理有限公司', '12'}",12,"{'5000000', '中航鑫港担保有限公司', '12', '高勇', '博时基金管理有限公司', '中国银河投资管理有限公司', '嘉实基金管理有限公司', '中信证券股份有限公司', '6000000', '10000000', '中国对外经济贸易信托有限公司', '5600000'}"
6,"{'现金', '定价', '阳煤金陵', '金陵阳明', '36', '金陵恒毅'}",15572296,0,set(),6,"{'现金', '定价', '阳煤金陵', '金陵阳明', '36', '金陵恒毅'}",6,"{'现金', '定价', '阳煤金陵', '金陵阳明', '36', '金陵恒毅'}"
11,"{'平安大华基金管理有限公司', '现金', '5696202', '9493670', '蒋根青', '广西铁路发展投资基金(有限合伙)', '安徽中安资本投资基金有限公司', '19367091', '国投瑞银基金管理有限公司', '6329113', '12'}",1806902,0,set(),6,"{'平安大华基金管理有限公司', '现金', '蒋根青', '安徽中安资本投资基金有限公司', '国投瑞银基金管理有限公司', '12'}",11,"{'平安大华基金管理有限公司', '现金', '5696202', '9493670', '蒋根青', '广西铁路发展投资基金(有限合伙)', '安徽中安资本投资基金有限公司', '19367091', '国投瑞银基金管理有限公司', '6329113', '12'}"
5,"{'现金', '定价', '31000000', '36', '大连市国有资产投资经营集团有限公司'}",186967,0,set(),4,"{'定价', '现金', '36', '大连市国有资产投资经营集团有限公司'}",5,"{'现金', '定价', '31000000', '36', '大连市国有资产投资经营集团有限公司'}"
5,"{'现金', '德力西集团有限公司', '120000000', '813600000', '36'}",1141612,1,{'813600000'},3,"{'现金', '德力西集团有限公司', '36'}",4,"{'现金', '德力西集团有限公司', '120000000', '36'}"
4,"{'竞价', '现金', '36', '煜明投资'}",355688,0,set(),4,"{'竞价', '现金', '36', '煜明投资'}",4,"{'竞价', '现金', '36', '煜明投资'}"
12,"{'孔鑫明', '现金', '北京鑫达唯特投资管理中心', '7050000', '上海晨灿投资中心', '泰达宏利基金管理有限公司-价值成长定向增发235号资产管理计划', '深圳市创东方长盈投资企业', '鹏华基金管理有限公司-全国社保基金104、503组合', '杭州君达投资管理有限公司', '36', '14100000', '浙江硅谷天堂产业投资管理有限公司-健盛投资基金'}",2040591,1,{'14100000'},7,"{'孔鑫明', '现金', '北京鑫达唯特投资管理中心', '上海晨灿投资中心', '深圳市创东方长盈投资企业', '杭州君达投资管理有限公司', '36'}",11,"{'孔鑫明', '现金', '北京鑫达唯特投资管理中心', '7050000', '上海晨灿投资中心', '泰达宏利基金管理有限公司-价值成长定向增发235号资产管理计划', '深圳市创东方长盈投资企业', '鹏华基金管理有限公司-全国社保基金104、503组合', '杭州君达投资管理有限公司', '36', '浙江硅谷天堂产业投资管理有限公司-健盛投资基金'}"
5,"{'230000000', '现金', '龙高集团', '102678571', '36'}",395590,1,{'230000000'},2,"{'现金', '龙高集团'}",4,"{'102678571', '现金', '36', '龙高集团'}"
4,"{'航天投资控股有限公司', '竞价', '现金', '36'}",1432260,0,set(),4,"{'航天投资控股有限公司', '竞价', '现金', '36'}",4,"{'航天投资控股有限公司', '竞价', '现金', '36'}"
8,"{'现金', '洪都集团', '350000000', '250000000', '竞价', '资产', '中航科工', '36'}",1395384,2,"{'350000000', '250000000'}",6,"{'现金', '洪都集团', '资产', '竞价', '中航科工', '36'}",6,"{'现金', '洪都集团', '资产', '竞价', '中航科工', '36'}"
13,"{'现金', '泰康资管', '20358300', '28501620', '西域和谐定增5号基金', '潮人共赢壹号资管计划', '西藏纳兰德投资', '时尚消费优选资管计划', '美丽生活资管计划', '刘振宇', '廖创宾', '36', '12214980'}",1629961,0,set(),9,"{'现金', '泰康资管', '潮人共赢壹号资管计划', '西藏纳兰德投资', '时尚消费优选资管计划', '美丽生活资管计划', '刘振宇', '廖创宾', '36'}",13,"{'现金', '泰康资管', '20358300', '28501620', '西域和谐定增5号基金', '潮人共赢壹号资管计划', '西藏纳兰德投资', '时尚消费优选资管计划', '美丽生活资管计划', '刘振宇', '廖创宾', '36', '12214980'}"
19,"{'36', '3821559', '3289490', '2966560', '3175684', '6369427', '财通基金管理有限公司', '东方基金管理有限责任公司', '3057324', '易方达基金管理有限公司', '竞价', '8598725', '海通证券股份有限公司', '568364', '信达证券股份有限公司', '泰达宏利基金管理有限公司', '云南惠潮投资合伙企业(有限合伙)', '12', '中国电子信息产业集团有限公司'}",289452,1,{'竞价'},3,"{'36', '12', '中国电子信息产业集团有限公司'}",18,"{'36', '3821559', '3289490', '2966560', '3175684', '6369427', '财通基金管理有限公司', '东方基金管理有限责任公司', '3057324', '易方达基金管理有限公司', '8598725', '海通证券股份有限公司', '568364', '信达证券股份有限公司', '泰达宏利基金管理有限公司', '云南惠潮投资合伙企业(有限合伙)', '12', '中国电子信息产业集团有限公司'}"
22,"{'航天科工财务有限责任公司', '35000000', '667260000', '中国大唐集团公司', '166000000', '天津市津能投资公司', '200000000', '工银瑞信基金管理有限公司', '内蒙古伊泰集团有限公司', '哈尔滨动力设备股份有限公司', '定价', '中国东方电气集团有限公司', '674000000', '99000000', '上海彤卉实业有限公司', '36', '1118840000', '1348000000', '100000000', '上海电气(集团)总公司', '235900000', '12'}",425831,0,set(),11,"{'36', '航天科工财务有限责任公司', '工银瑞信基金管理有限公司', '内蒙古伊泰集团有限公司', '哈尔滨动力设备股份有限公司', '定价', '中国东方电气集团有限公司', '中国大唐集团公司', '天津市津能投资公司', '12', '上海彤卉实业有限公司'}",22,"{'航天科工财务有限责任公司', '35000000', '667260000', '中国大唐集团公司', '166000000', '天津市津能投资公司', '200000000', '工银瑞信基金管理有限公司', '内蒙古伊泰集团有限公司', '哈尔滨动力设备股份有限公司', '12', '定价', '中国东方电气集团有限公司', '674000000', '99000000', '上海彤卉实业有限公司', '1118840000', '1348000000', '100000000', '上海电气(集团)总公司', '235900000', '36'}"
23,"{'119999970', '2666666', '4000000', '申万菱信(上海)资产管理有限公司', '159999975', '2733333', '2644448', '119000160', '财通基金管理有限公司', '竞价', '180000000', '中国华电集团财务有限公司', '深圳修能资本管理有限公司', '中信证券股份有限公司', '广东温氏投资有限公司', '137999970', '招商财富资产管理有限公司', '3555555', '创金合信基金管理有限公司', '3066666', '刘晖', '122999985', '12'}",1870812,1,{'竞价'},9,"{'招商财富资产管理有限公司', '财通基金管理有限公司', '刘晖', '中信证券股份有限公司', '广东温氏投资有限公司', '中国华电集团财务有限公司', '创金合信基金管理有限公司', '12', '深圳修能资本管理有限公司'}",22,"{'119999970', '2666666', '4000000', '申万菱信(上海)资产管理有限公司', '159999975', '2733333', '2644448', '119000160', '财通基金管理有限公司', '180000000', '中国华电集团财务有限公司', '深圳修能资本管理有限公司', '中信证券股份有限公司', '广东温氏投资有限公司', '137999970', '招商财富资产管理有限公司', '3555555', '创金合信基金管理有限公司', '3066666', '刘晖', '122999985', '12'}"
28,"{'建投传媒', '11460200', '199999020', '四川信托', '文创产业基金——文创定增基金', '22316600', '256250072', '青岛同印信', '华信超越', '文建发展基金', '定价', '250000452', '190008572', '凯石资管——凯石3号基金', '18101400', '4472200', '299999648', '404747304', '99998392', '13416800', '文创产业基金——屹唐定增基金', '汇邦国际', '498999176', '耀莱文化', '8497700', '8944500', '11180700', '36'}",1922515,8,"{'299999648', '404747304', '256250072', '498999176', '199999020', '99998392', '250000452', '190008572'}",10,"{'建投传媒', '青岛同印信', '耀莱文化', '汇邦国际', '华信超越', '文建发展基金', '定价', '四川信托', '文创产业基金——文创定增基金', '36'}",20,"{'22316600', '凯石资管——凯石3号基金', '建投传媒', '11460200', '耀莱文化', '4472200', '华信超越', '文建发展基金', '青岛同印信', '汇邦国际', '定价', '8497700', '13416800', '8944500', '四川信托', '文创产业基金——文创定增基金', '11180700', '18101400', '36', '文创产业基金——屹唐定增基金'}"
3,"{'现金', '36', '江西永联'}",438215,0,set(),3,"{'现金', '36', '江西永联'}",3,"{'现金', '36', '江西永联'}"
17,"{'平安大华基金管理有限公司', '现金', '40715200', '551400420', '30206300', '295999504', '财通基金管理有限公司', '199999881', '中国银河证券股份有限公司', '219599801', '74690500', '泰康资产管理有限责任公司', '75846000', '542999935', '华安未来资产管理(上海)有限公司', '12', '27510300'}",1924838,4,"{'199999881', '551400420', '542999935', '295999504'}",6,"{'平安大华基金管理有限公司', '现金', '财通基金管理有限公司', '中国银河证券股份有限公司', '泰康资产管理有限责任公司', '12'}",13,"{'平安大华基金管理有限公司', '现金', '40715200', '30206300', '财通基金管理有限公司', '中国银河证券股份有限公司', '219599801', '74690500', '泰康资产管理有限责任公司', '75846000', '华安未来资产管理(上海)有限公司', '12', '27510300'}"
3,"{'现金', '36', '华电集团'}",1208444,0,set(),3,"{'现金', '36', '华电集团'}",3,"{'现金', '36', '华电集团'}"
24,"{'299999992.4', '599999996.3', '16218563', '479999999.4', '银河资本资产管理有限公司', '现金', '34692107', '长城(天津)股权投资基金管理有限责任公司', '浙江卫星控股股份有限公司', '财通基金管理有限公司', '竞价', '41630529', '26019080', '36', '399999993.7', '北信瑞丰基金管理有限公司', '187000031.4', '432999995.2', '37554206', '52038161', '中国银河证券股份有限公司', '华安未来资产管理(上海)有限公司', '12', '汇安基金管理有限责任公司'}",16488274,4,"{'竞价', '479999999.4', '187000031.4', '432999995.2'}",9,"{'现金', '北信瑞丰基金管理有限公司', '12', '浙江卫星控股股份有限公司', '财通基金管理有限公司', '汇安基金管理有限责任公司', '中国银河证券股份有限公司', '36', '银河资本资产管理有限公司'}",20,"{'银河资本资产管理有限公司', '399999993.7', '现金', '北信瑞丰基金管理有限公司', '37554206', '16218563', '34692107', '52038161', '12', '长城(天津)股权投资基金管理有限责任公司', '浙江卫星控股股份有限公司', '财通基金管理有限公司', '汇安基金管理有限责任公司', '299999992.4', '599999996.3', '中国银河证券股份有限公司', '41630529', '华安未来资产管理(上海)有限公司', '36', '26019080'}"
4,"{'广东宝丽华集团有限公司', '竞价', '现金', '36'}",1656979,1,{'36'},3,"{'广东宝丽华集团有限公司', '竞价', '现金'}",3,"{'广东宝丽华集团有限公司', '竞价', '现金'}"
32,"{'23848600', '友依昌隆', '19717100', '尊雅锦绣', '经武纬文', '507835200', '鸿康众望', '36479700', '现金', '270000000', '27359700', '999999200', '9529900', '208990700', '799999800', '定价', '嘉润鸿实', '54666211', '522999800', '恒益达昌', '432396000', '旭日隆昌', '599998200', '誉致衡远', '12311900', '458951000', '45599600', '23157100', '瑞宏嘉业', '20928000', '1198830000', '36'}",90766,10,"{'599998200', '270000000', '507835200', '999999200', '208990700', '799999800', '458951000', '522999800', '432396000', '1198830000'}",12,"{'瑞宏嘉业', '旭日隆昌', '现金', '誉致衡远', '经武纬文', '尊雅锦绣', '友依昌隆', '定价', '鸿康众望', '嘉润鸿实', '恒益达昌', '36'}",22,"{'23848600', '友依昌隆', '19717100', '尊雅锦绣', '经武纬文', '鸿康众望', '36479700', '现金', '27359700', '9529900', '定价', '嘉润鸿实', '54666211', '恒益达昌', '旭日隆昌', '誉致衡远', '12311900', '45599600', '23157100', '瑞宏嘉业', '20928000', '36'}"
21,"{'499999989.3', '34330110', '299999999.4', '151899992.9', '中航航空产业投资有限公司', '现金', '定价', '20718232', '27624309', '中航证券“启航3号”集合资产管理计划', '149999999.7', '华菱津杉特定客户资产管理计划', '399999994.3', '中航证券“机电振兴1号”集合资产管理计划', '34530386', '497099992.8', '10359116', '宁波景盛股权投资合伙企业(有限合伙)', '10490331', '36', '国联安基金“国联安定增贰号”特定客户资产管理计划'}",1932132,4,"{'151899992.9', '499999989.3', '149999999.7', '299999999.4'}",5,"{'36', '现金', '定价', '华菱津杉特定客户资产管理计划', '中航航空产业投资有限公司'}",17,"{'现金', '中航航空产业投资有限公司', '34330110', '定价', '497099992.8', '国联安基金“国联安定增贰号”特定客户资产管理计划', '中航证券“启航3号”集合资产管理计划', '中航证券“机电振兴1号”集合资产管理计划', '10359116', '华菱津杉特定客户资产管理计划', '20718232', '27624309', '399999994.3', '10490331', '36', '34530386', '宁波景盛股权投资合伙企业(有限合伙)'}"
24,"{'24739263', '8255098', '174182567.8', '205499989.6', '易方达基金管理有限公司', '192182998.9', '9108199', '9739336', '现金', '定价', '财通基金管理有限公司', '8246446', '鹏华基金管理有限公司', '357794577.9', '521998449.3', '北信瑞丰基金管理有限公司', '114341385.3', '5419023', '招商财富资产管理有限公司', '金鹰基金管理有限公司', '16957089', '天弘基金管理有限公司', '174000010.6', '12'}",280311,11,"{'114341385.3', '16957089', '357794577.9', '205499989.6', '192182998.9', '5419023', '174182567.8', '174000010.6', '9108199', '9739336', '521998449.3'}",3,"{'定价', '现金', '12'}",13,"{'招商财富资产管理有限公司', '金鹰基金管理有限公司', '现金', '24739263', '北信瑞丰基金管理有限公司', '8255098', '定价', '财通基金管理有限公司', '天弘基金管理有限公司', '易方达基金管理有限公司', '8246446', '鹏华基金管理有限公司', '12'}"
18,"{'新余创裕投资中心(有限合伙)', '29000000', '现金', '450000', '于洪涛', '何建锋', '李刚', '500000', '300000', '200000', '刘海金', '金鹰筠业琢石资产管理计划', '李礼', '180000', '3970000', '赵洪武', '李景相', '36'}",352356,4,"{'180000', '450000', '300000', '200000'}",10,"{'现金', '于洪涛', '何建锋', '李刚', '刘海金', '金鹰筠业琢石资产管理计划', '李礼', '赵洪武', '李景相', '36'}",14,"{'新余创裕投资中心(有限合伙)', '29000000', '现金', '于洪涛', '何建锋', '李刚', '500000', '刘海金', '金鹰筠业琢石资产管理计划', '李礼', '3970000', '赵洪武', '李景相', '36'}"
4,"{'竞价', '现金', '36', '金圆控股'}",15644806,0,set(),4,"{'竞价', '现金', '36', '金圆控股'}",4,"{'竞价', '现金', '36', '金圆控股'}"
6,"{'现金', '132510000', '南航集团', '竞价', '1500000000', '36'}",1315163,2,"{'132510000', '1500000000'}",4,"{'竞价', '现金', '36', '南航集团'}",4,"{'竞价', '现金', '36', '南航集团'}"
13,"{'万胜实业', '现金', '400000000', '智胜高新', '100000000', '定价', '国晟能源', '瑞安信息', '300000000', '31578947', '10526315', '36', '42105263'}",10789776,3,"{'10526315', '42105263', '31578947'}",7,"{'万胜实业', '现金', '智胜高新', '定价', '国晟能源', '瑞安信息', '36'}",10,"{'万胜实业', '现金', '400000000', '智胜高新', '100000000', '定价', '国晟能源', '瑞安信息', '300000000', '36'}"
27,"{'181999995.2', '74497487', '100502512', '22613065', '239999993.9', '长信-刚泰-聚利1号资产管理计划', '现金', '淮茂投资', '592999996.5', '499999997.2', '799999995.5', '299999998.3', '见乙实业', '六禾嘉睿', '179999997.4', '珂澜投资', '30150753', '赫连剑茹', '刚泰集团', '南通元鼎', '62814070', '腾讯计算机', '21356783', '22864321', '36', '37688442', '169999992.7'}",1861798,3,"{'169999992.7', '181999995.2', '239999993.9'}",9,"{'珂澜投资', '现金', '赫连剑茹', '淮茂投资', '刚泰集团', '见乙实业', '腾讯计算机', '六禾嘉睿', '南通元鼎'}",24,"{'100502512', '22613065', '长信-刚泰-聚利1号资产管理计划', '现金', '淮茂投资', '592999996.5', '499999997.2', '799999995.5', '299999998.3', '见乙实业', '六禾嘉睿', '179999997.4', '珂澜投资', '30150753', '赫连剑茹', '刚泰集团', '南通元鼎', '62814070', '腾讯计算机', '21356783', '22864321', '36', '37688442', '74497487'}"
16,"{'1999999999', '现金', '郑州冬青企业管理中心(普通合伙)', '287999999.8', '1000000004', '北京天证远洋基金管理中心(有限合伙)', '定价', '33065442', '499999997.5', '57405281', '郭留希', '朱登营', '114810563', '229621125', '36', '北京天空鸿鼎投资中心(有限合伙)'}",1766389,1,{'1000000004'},5,"{'现金', '定价', '郭留希', '朱登营', '36'}",15,"{'1999999999', '现金', '郑州冬青企业管理中心(普通合伙)', '287999999.8', '北京天证远洋基金管理中心(有限合伙)', '33065442', '499999997.5', '定价', '57405281', '郭留希', '朱登营', '114810563', '229621125', '36', '北京天空鸿鼎投资中心(有限合伙)'}"
13,"{'现金', '136191100', '263612000', '陈显龙', '罗新伟', '7536079', '3893400', '5005672', '竞价', '175098400', '江春华', '方文', '36'}",16730386,7,"{'136191100', '263612000', '3893400', '7536079', '5005672', '竞价', '175098400'}",6,"{'现金', '陈显龙', '罗新伟', '江春华', '方文', '36'}",6,"{'现金', '陈显龙', '罗新伟', '江春华', '方文', '36'}"
4,"{'现金', '竞价', '盛晖投资', '36'}",170540,0,set(),4,"{'现金', '竞价', '盛晖投资', '36'}",4,"{'现金', '竞价', '盛晖投资', '36'}"
5,"{'现金', '927152317', '华菱集团', '竞价', '36'}",1702027,1,{'927152317'},4,"{'竞价', '现金', '36', '华菱集团'}",4,"{'竞价', '现金', '36', '华菱集团'}"
6,"{'现金', '科达商贸', '12', '其他发行对象', '竞价', '36'}",1105741,0,set(),6,"{'36', '现金', '科达商贸', '其他发行对象', '竞价', '12'}",6,"{'36', '现金', '科达商贸', '其他发行对象', '竞价', '12'}"
8,"{'12000000', '现金', '195120000', '21000000', '上海界龙集团有限公司', '建信基金管理有限责任公司', '341460000', '36'}",14696264,2,"{'341460000', '195120000'}",4,"{'建信基金管理有限责任公司', '现金', '36', '上海界龙集团有限公司'}",6,"{'12000000', '现金', '21000000', '上海界龙集团有限公司', '建信基金管理有限责任公司', '36'}"
16,"{'613599998.6', '36', '现金', '东吴基金管理有限公司', '65602836', '17801419', '中国电建地产集团有限公司', '东海基金管理有限责任公司', '108794326', '竞价', '79787234', '100400003.2', '浙商基金管理有限公司', '369999995', '449999999.8', '12'}",7176277,6,"{'17801419', '108794326', '竞价', '100400003.2', '65602836', '449999999.8'}",6,"{'东吴基金管理有限公司', '现金', '12', '东海基金管理有限责任公司', '浙商基金管理有限公司', '36'}",10,"{'36', '现金', '东吴基金管理有限公司', '中国电建地产集团有限公司', '东海基金管理有限责任公司', '79787234', '浙商基金管理有限公司', '369999995', '613599998.6', '12'}"
16,"{'20000000', '5000000', '中信国安集团公司', '新华人寿保险股份有限公司', '21500000', '12', '13000000', '博时基金管理有限公司', '15000000', '易方达基金管理有限公司', '广发基金管理有限公司', '南方基金管理有限公司', '中国人寿资产管理有限公司', '12500000', '36', '中国国际金融有限公司'}",973115,3,"{'21500000', '15000000', '12500000'}",4,"{'36', '中国国际金融有限公司', '12', '中信国安集团公司'}",13,"{'20000000', '36', '5000000', '中信国安集团公司', '新华人寿保险股份有限公司', '13000000', '博时基金管理有限公司', '易方达基金管理有限公司', '广发基金管理有限公司', '南方基金管理有限公司', '中国人寿资产管理有限公司', '12', '中国国际金融有限公司'}"
27,"{'508474576', '长沙恒健', '华安资产航盛1号专项资产管理计划', '国金鼎兴资本-中润定增基金', '2799999999', '现金', '3468136780', '南午北安财富', '定价', '610169492', '杉杉正盛', '3600000003', '温州合瑞', '博乐公司', '2181999997', '36', '天时(深圳)基金', '338983051', '2000000001', '369830508', '587819793', '2999999998', '474576271', '中英益利-京盛资产管理计划', '横琴鸿拓', '2318000000', '392881356'}",1671112,3,"{'2000000001', '2799999999', '3600000003'}",9,"{'长沙恒健', '现金', '南午北安财富', '定价', '杉杉正盛', '横琴鸿拓', '温州合瑞', '博乐公司', '36'}",24,"{'508474576', '长沙恒健', '华安资产航盛1号专项资产管理计划', '国金鼎兴资本-中润定增基金', '现金', '3468136780', '南午北安财富', '定价', '610169492', '杉杉正盛', '温州合瑞', '博乐公司', '2181999997', '36', '天时(深圳)基金', '338983051', '369830508', '587819793', '2999999998', '474576271', '中英益利-京盛资产管理计划', '横琴鸿拓', '2318000000', '392881356'}"
22,"{'昆明盈鑫壹柒投资中心(有限合伙)', '昆明盈鑫壹捌投资中心(有限合伙)', '昆明盈鑫伍捌投资中心(有限合伙)', '356310000', '424255000', '74400000', '74700000', '79100000', '460635000', '昆明盈鑫伍陆投资中心(有限合伙)', '399645000', '66600000', '514135000', '79300000', '423185000', '汇添富基金管理有限公司', '86100000', '398040000', '昆明盈鑫伍叁投资中心(有限合伙)', '96100000', '12', '昆明盈鑫伍肆投资中心(有限合伙)'}",408904,7,"{'424255000', '514135000', '398040000', '460635000', '423185000', '399645000', '356310000'}",2,"{'12', '汇添富基金管理有限公司'}",15,"{'昆明盈鑫壹柒投资中心(有限合伙)', '昆明盈鑫壹捌投资中心(有限合伙)', '86100000', '74400000', '74700000', '昆明盈鑫伍捌投资中心(有限合伙)', '昆明盈鑫伍肆投资中心(有限合伙)', '79100000', '昆明盈鑫伍叁投资中心(有限合伙)', '96100000', '79300000', '昆明盈鑫伍陆投资中心(有限合伙)', '12', '汇添富基金管理有限公司', '66600000'}"
18,"{'金鹰基金管理有限公司', '23415928', '现金', '北信瑞丰基金管理有限公司', '九泰基金管理有限公司', '江信基金管理有限公司', '7517783', '1012219387', '460122985.2', '51512437', '74297262', '竞价', '1519991991', '1459941198', '安信基金管理有限责任公司', '77353282', '147724436', '12'}",15202388,1,{'147724436'},8,"{'金鹰基金管理有限公司', '现金', '北信瑞丰基金管理有限公司', '九泰基金管理有限公司', '江信基金管理有限公司', '竞价', '安信基金管理有限责任公司', '12'}",17,"{'金鹰基金管理有限公司', '23415928', '现金', '北信瑞丰基金管理有限公司', '九泰基金管理有限公司', '江信基金管理有限公司', '7517783', '1012219387', '460122985.2', '51512437', '74297262', '1519991991', '1459941198', '竞价', '安信基金管理有限责任公司', '77353282', '12'}"
5,"{'82758624', '天宝秋石', '现金', '竞价', '36'}",1892163,1,{'竞价'},3,"{'36', '天宝秋石', '现金'}",4,"{'现金', '82758624', '天宝秋石', '36'}"
4,"{'现金', '70000000', '郭留希', '36'}",92956,1,{'70000000'},3,"{'36', '郭留希', '现金'}",3,"{'36', '郭留希', '现金'}"
3,"{'现金', '36', '大通集团'}",677797,0,set(),3,"{'现金', '36', '大通集团'}",3,"{'现金', '36', '大通集团'}"
6,"{'现金', '览海投资', '竞价', '291970802', '1999999994', '36'}",2012404,3,"{'竞价', '291970802', '1999999994'}",3,"{'览海投资', '现金', '36'}",3,"{'览海投资', '现金', '36'}"
19,"{'2345002', '19819819', '现金', '华安基金管理有限公司', '22072072', '深圳市创新投资集团有限公司', '博时基金管理有限公司', '申万菱信(上海)资产管理有限公司', '财通基金管理有限公司', '易方达基金管理有限公司', '天弘基金管理有限公司', '竞价', '23423423', '26126126', '39639639', '32252252', '汇添富基金管理股份有限公司', '12', '24324324'}",12056606,1,{'竞价'},2,"{'现金', '12'}",18,"{'2345002', '19819819', '现金', '华安基金管理有限公司', '22072072', '深圳市创新投资集团有限公司', '博时基金管理有限公司', '申万菱信(上海)资产管理有限公司', '财通基金管理有限公司', '易方达基金管理有限公司', '天弘基金管理有限公司', '23423423', '26126126', '39639639', '32252252', '汇添富基金管理股份有限公司', '12', '24324324'}"
4,"{'现金', '竞价', '蒙东能源', '36'}",675987,0,set(),4,"{'36', '竞价', '蒙东能源', '现金'}",4,"{'现金', '竞价', '蒙东能源', '36'}"
6,"{'现金', '29852620', '1160371300', '广东温氏食品集团股份有限公司2016年度员工持股计划', '定价', '36'}",1890220,3,"{'29852620', '广东温氏食品集团股份有限公司2016年度员工持股计划', '1160371300'}",3,"{'36', '定价', '现金'}",3,"{'定价', '现金', '36'}"
4,"{'竞价', '现金', '36', '江苏新潮科技集团有限公司'}",1160303,1,{'竞价'},3,"{'现金', '36', '江苏新潮科技集团有限公司'}",3,"{'现金', '36', '江苏新潮科技集团有限公司'}"
5,"{'现金', '申能集团', '上海海烟投资', '上海报业集团', '36'}",15707347,0,set(),5,"{'现金', '申能集团', '上海海烟投资', '上海报业集团', '36'}",5,"{'现金', '申能集团', '上海海烟投资', '上海报业集团', '36'}"
18,"{'广发证券资产管理(广东)有限公司', '中国水务投资有限公司', '6874200', '12', '申万菱信(上海)资产管理有限公司', '112362555', '10205500', '财通基金管理有限公司', '竞价', '浙江省水利水电投资集团有限公司', '17000000', '75684942', '330300000', '39482498.58', '187170000', '30000000', '36', '3586058'}",81442,1,{'竞价'},5,"{'中国水务投资有限公司', '12', '财通基金管理有限公司', '浙江省水利水电投资集团有限公司', '36'}",17,"{'广发证券资产管理(广东)有限公司', '中国水务投资有限公司', '6874200', '12', '申万菱信(上海)资产管理有限公司', '112362555', '10205500', '财通基金管理有限公司', '浙江省水利水电投资集团有限公司', '17000000', '75684942', '330300000', '39482498.58', '187170000', '30000000', '36', '3586058'}"
4,"{'竞价', '现金', '36', '万泽集团'}",439998,1,{'竞价'},3,"{'现金', '36', '万泽集团'}",3,"{'现金', '36', '万泽集团'}"
20,"{'17987012', '红塔红土基金管理有限公司', '金鹰基金管理有限公司', '现金', '9870006', '浙江浙商证券资产管理有限公司', '农银汇理(上海)资产管理有限公司', '35974025', '定价', '276999992.5', '199999984.8', '18116883', '139499999.1', '金元顺安基金管理有限公司', '宁波梅山保税港区东杲投资合伙企业(有限合伙)', '安信基金管理有限责任公司', '75999046.2', '25974024', '12', '138499992.4'}",16803620,0,set(),8,"{'金鹰基金管理有限公司', '现金', '浙江浙商证券资产管理有限公司', '定价', '金元顺安基金管理有限公司', '安信基金管理有限责任公司', '12', '红塔红土基金管理有限公司'}",20,"{'17987012', '红塔红土基金管理有限公司', '金鹰基金管理有限公司', '现金', '9870006', '浙江浙商证券资产管理有限公司', '农银汇理(上海)资产管理有限公司', '35974025', '276999992.5', '199999984.8', '18116883', '139499999.1', '定价', '金元顺安基金管理有限公司', '宁波梅山保税港区东杲投资合伙企业(有限合伙)', '安信基金管理有限责任公司', '75999046.2', '25974024', '12', '138499992.4'}"
15,"{'1123762400', '73904449', '现金', '1105610600', '1107260800', '远津投资', '75117805', '润田投资', '竞价', '富骏投资', '崇光投资', '1163366300', '36', '77765129', '74014756'}",1759022,5,"{'1123762400', '1105610600', '1107260800', '竞价', '1163366300'}",6,"{'现金', '远津投资', '润田投资', '富骏投资', '崇光投资', '36'}",10,"{'73904449', '现金', '远津投资', '75117805', '润田投资', '富骏投资', '崇光投资', '36', '77765129', '74014756'}"
17,"{'深圳平安大华汇通财富管理有限公司', '14341268', '中融基金管理有限公司', '安信基金管理有限公司', '安徽省铁路建设投资基金有限公司', '10126582', '199999994.5', '财通基金管理有限公司', '易方达基金管理有限公司', '竞价', '24151898', '476999985.5', '283240043', '398999987.3', '20202531', '鹏华资产管理(深圳)有限公司', '12'}",2331274,2,"{'竞价', '398999987.3'}",7,"{'深圳平安大华汇通财富管理有限公司', '中融基金管理有限公司', '安信基金管理有限公司', '安徽省铁路建设投资基金有限公司', '财通基金管理有限公司', '易方达基金管理有限公司', '12'}",15,"{'深圳平安大华汇通财富管理有限公司', '14341268', '中融基金管理有限公司', '安信基金管理有限公司', '安徽省铁路建设投资基金有限公司', '10126582', '199999994.5', '财通基金管理有限公司', '易方达基金管理有限公司', '24151898', '476999985.5', '283240043', '20202531', '鹏华资产管理(深圳)有限公司', '12'}"
4,"{'92000000', '成都高新投资集团有限公司', '竞价', '36'}",1617239,1,{'竞价'},2,"{'成都高新投资集团有限公司', '36'}",3,"{'92000000', '成都高新投资集团有限公司', '36'}"
15,"{'149999998.5', '现金', '15252525', '150999997.5', '浙江浙商产融控股有限公司', '15151515', '财通基金管理有限公司', '申万宏源证券有限公司', '竞价', '144128803.5', '泰达宏利基金管理有限公司', '14558465', '36363636', '12', '359999996.4'}",18887833,1,{'竞价'},5,"{'现金', '浙江浙商产融控股有限公司', '申万宏源证券有限公司', '泰达宏利基金管理有限公司', '12'}",14,"{'149999998.5', '15252525', '现金', '150999997.5', '浙江浙商产融控股有限公司', '15151515', '财通基金管理有限公司', '申万宏源证券有限公司', '144128803.5', '泰达宏利基金管理有限公司', '14558465', '36363636', '12', '359999996.4'}"
19,"{'4883761', '合肥惟同投资中心(有限合伙)', '现金', '45866657.27', '3306714', '37266666.78', '4680273', '威海北洋电气集团股份有限公司', '52746676.71', '定价', '丛强滋', '55039986.47', '118106669.8', '威海国有资产经营(集团)有限公司', '10479740', '华菱津杉—新北洋专项资产管理计划', '4069801', '36', '鲁信创晟股权投资有限公司'}",6102060,4,"{'52746676.71', '45866657.27', '55039986.47', '37266666.78'}",6,"{'现金', '威海北洋电气集团股份有限公司', '丛强滋', '华菱津杉—新北洋专项资产管理计划', '36', '鲁信创晟股权投资有限公司'}",15,"{'4883761', '合肥惟同投资中心(有限合伙)', '现金', '3306714', '4680273', '威海北洋电气集团股份有限公司', '定价', '丛强滋', '118106669.8', '威海国有资产经营(集团)有限公司', '10479740', '华菱津杉—新北洋专项资产管理计划', '4069801', '36', '鲁信创晟股权投资有限公司'}"
13,"{'中车金证投资有限公司', '信诚基金管理有限公司', '财通基金管理有限公司', '10528170', '10598591', '300999984.4', '竞价', '10563380', '299999992', '299000028', '汇添富基金管理股份有限公司', '12', '华泰柏瑞基金管理有限公司'}",14591370,1,{'竞价'},1,{'12'},12,"{'中车金证投资有限公司', '信诚基金管理有限公司', '财通基金管理有限公司', '10528170', '10598591', '300999984.4', '10563380', '299999992', '299000028', '汇添富基金管理股份有限公司', '12', '华泰柏瑞基金管理有限公司'}"
21,"{'800000000', '舟山创投', '北京海厚泰', '现金', '400000000', '定价', '43525571', '国开金泰', '150000000', '900000000', '8161044', '48966267', '罗相斌', '许木林', '21762785', '100000000', '5440696', '苏州海厚泰', '36', '横琴远诚', '罗恒'}",1701826,4,"{'100000000', '150000000', '900000000', '舟山创投'}",10,"{'现金', '罗相斌', '定价', '许木林', '国开金泰', '北京海厚泰', '苏州海厚泰', '36', '横琴远诚', '罗恒'}",17,"{'800000000', '横琴远诚', '现金', '8161044', '48966267', '400000000', '罗相斌', '定价', '43525571', '许木林', '5440696', '北京海厚泰', '21762785', '苏州海厚泰', '36', '国开金泰', '罗恒'}"
8,"{'现金', '100000000', '钱文龙', '竞价', '300000000', '50000000', '陈瀚海', '36'}",301919,3,"{'100000000', '300000000', '50000000'}",5,"{'现金', '钱文龙', '竞价', '陈瀚海', '36'}",5,"{'现金', '钱文龙', '竞价', '陈瀚海', '36'}"
17,"{'江苏和谐科技股份有限公司', '厦门永红电子有限公司', '5000000', '现金', '江阴长江电子有限公司', '信诚基金管理有限公司', '15000000', '9000000', '上海彤源投资发展有限公司', '鹏华基金管理有限公司', '杭州士兰微电子股份有限公司', '浙江硅谷天堂鲲诚创业投资有限公司', '6000000', '10000000', '国联证券有限责任公司', '12', '无锡市宝联投资有限公司'}",537471,0,set(),5,"{'厦门永红电子有限公司', '现金', '江阴长江电子有限公司', '杭州士兰微电子股份有限公司', '12'}",17,"{'江苏和谐科技股份有限公司', '厦门永红电子有限公司', '5000000', '现金', '江阴长江电子有限公司', '信诚基金管理有限公司', '15000000', '9000000', '上海彤源投资发展有限公司', '鹏华基金管理有限公司', '杭州士兰微电子股份有限公司', '浙江硅谷天堂鲲诚创业投资有限公司', '6000000', '10000000', '国联证券有限责任公司', '12', '无锡市宝联投资有限公司'}"
16,"{'5000000', '现金', '中原信托有限公司', '江苏瑞华投资发展有限公司', '天津硅谷天堂鲲祥股权投资基金合伙企业(有限合伙)', '上海力利投资管理合伙企业(有限合伙)', '金明哲', '天津信托有限责任公司', '7000000', '竞价', '4370000', '天津武科创盈联股权投资基金合伙企业(有限合伙)', '博弘数君(天津)股权投资基金合伙企业(有限合伙)', '6000000', '10000000', '12'}",1494731,2,"{'竞价', '4370000'}",3,"{'现金', '12', '中原信托有限公司'}",14,"{'5000000', '中原信托有限公司', '现金', '江苏瑞华投资发展有限公司', '天津硅谷天堂鲲祥股权投资基金合伙企业(有限合伙)', '上海力利投资管理合伙企业(有限合伙)', '金明哲', '天津信托有限责任公司', '7000000', '天津武科创盈联股权投资基金合伙企业(有限合伙)', '博弘数君(天津)股权投资基金合伙企业(有限合伙)', '6000000', '10000000', '12'}"
17,"{'曲立新', '东方邦信创业投资有限公司', '现金', '2077923', '12987013', '4329005', '巩新民', '济南国融东方企业管理咨询中心(有限合伙', '29148368', '曹积生', '纪永梅', '北京富国通达投资管理中心(有限合伙)', '迟汉东', '17316018', '521250', '耿培梁', '36'}",1600840,0,set(),9,"{'曲立新', '东方邦信创业投资有限公司', '现金', '巩新民', '曹积生', '纪永梅', '迟汉东', '耿培梁', '36'}",17,"{'曲立新', '东方邦信创业投资有限公司', '2077923', '现金', '12987013', '4329005', '巩新民', '济南国融东方企业管理咨询中心(有限合伙', '29148368', '曹积生', '纪永梅', '北京富国通达投资管理中心(有限合伙)', '迟汉东', '17316018', '521250', '耿培梁', '36'}"
11,"{'162699000', '现金', '前海新旺兆', '1600958160', '汇通正源', '399996000', '陈永弟', '6000000', '36', '59040000', '40650000'}",83243,0,set(),5,"{'现金', '前海新旺兆', '汇通正源', '陈永弟', '36'}",11,"{'162699000', '现金', '前海新旺兆', '1600958160', '汇通正源', '399996000', '陈永弟', '6000000', '36', '59040000', '40650000'}"
11,"{'现金', '工银瑞信基金管理有限公司', '华夏基金管理有限公司', '2000000', '广发基金管理有限公司', '1200000', '竞价', '1000000', '中海基金管理有限公司', '上海证券有限责任公司', '12'}",128040,0,set(),8,"{'现金', '工银瑞信基金管理有限公司', '华夏基金管理有限公司', '广发基金管理有限公司', '竞价', '中海基金管理有限公司', '上海证券有限责任公司', '12'}",11,"{'现金', '工银瑞信基金管理有限公司', '华夏基金管理有限公司', '2000000', '广发基金管理有限公司', '1200000', '竞价', '1000000', '中海基金管理有限公司', '上海证券有限责任公司', '12'}"
16,"{'44879940', '5898200', '现金', '兴全睿众定增3号特定多客户专项资产管理计划', '4130000', '李建林', '定价', '东方证券股份有限公司', '1860000', '5859000', '三川股份第1期员工持股计划', '770000', '14247600', '31635800', '江西三川集团有限公司', '36'}",1731643,4,"{'14247600', '44879940', '5898200', '31635800'}",6,"{'现金', '李建林', '定价', '东方证券股份有限公司', '江西三川集团有限公司', '36'}",12,"{'现金', '兴全睿众定增3号特定多客户专项资产管理计划', '4130000', '李建林', '定价', '东方证券股份有限公司', '1860000', '5859000', '三川股份第1期员工持股计划', '770000', '江西三川集团有限公司', '36'}"
16,"{'24000000', '中国华电集团资本控股有限公司', '江苏荣华资产管理有限公司', '现金', '8000000', '36', '定价', '永泰投资控股有限公司', '华宝信托有限责任公司', '江苏宗申三轮摩托车制造有限公司', '8800000', '海通证券股份有限公司', '济南北安投资有限公司', '10000000', '12', '13200000'}",1505882,1,{'定价'},4,"{'36', '永泰投资控股有限公司', '现金', '12'}",15,"{'24000000', '中国华电集团资本控股有限公司', '江苏荣华资产管理有限公司', '8000000', '36', '现金', '永泰投资控股有限公司', '华宝信托有限责任公司', '江苏宗申三轮摩托车制造有限公司', '8800000', '海通证券股份有限公司', '济南北安投资有限公司', '10000000', '12', '13200000'}"
11,"{'10416660', '现金', '33083300', '新力达集团', '博启投资', '竞价', '江西伟宸', '41666640', '36', '沈培今', '19000000'}",14398222,1,{'竞价'},6,"{'现金', '新力达集团', '博启投资', '江西伟宸', '36', '沈培今'}",10,"{'10416660', '现金', '33083300', '新力达集团', '博启投资', '江西伟宸', '41666640', '36', '沈培今', '19000000'}"
27,"{'123809524', '深圳名正', '600000000', '上海喜待', '780000000', '850000000', '上海爽达', '79365079', '玉环捷瑞', '宁波裕盛', '现金', '630000000', '400000000', '北京天晟', '定价', '上海哲萱', '宁波雨博', '63492063', '95238095', '宁波骏和', '2750000000', '100000000', '436507938', '宁波万福', '134920635', '500000000', '36'}",1674994,7,"{'630000000', '400000000', '600000000', '780000000', '850000000', '2750000000', '500000000'}",13,"{'宁波裕盛', '现金', '深圳名正', '北京天晟', '宁波骏和', '上海喜待', '定价', '宁波雨博', '宁波万福', '上海爽达', '上海哲萱', '玉环捷瑞', '36'}",20,"{'宁波裕盛', '现金', '123809524', '95238095', '深圳名正', '北京天晟', '100000000', '宁波骏和', '436507938', '上海喜待', '定价', '宁波雨博', '134920635', '宁波万福', '上海爽达', '63492063', '上海哲萱', '79365079', '玉环捷瑞', '36'}"
14,"{'东莞晨星实业投资有限公司', '太平洋资产管理有限责任公司', '6380263', '4928660', '115872796.6', '定价', '84063108.32', '国联安基金管理有限公司', '财通基金管理有限公司', '250064091.5', '149999983.1', '10636499', '12', '3575632'}",74117,2,"{'84063108.32', '250064091.5'}",6,"{'东莞晨星实业投资有限公司', '太平洋资产管理有限责任公司', '定价', '国联安基金管理有限公司', '财通基金管理有限公司', '12'}",12,"{'东莞晨星实业投资有限公司', '太平洋资产管理有限责任公司', '6380263', '4928660', '115872796.6', '定价', '149999983.1', '国联安基金管理有限公司', '财通基金管理有限公司', '10636499', '12', '3575632'}"
20,"{'12000000', '湖南湘投金天科技集团有限责任公司', '兵器财务有限责任公司', '现金', '260000000', '中航鑫港担保有限公司', '240000000', '13000000', '定价', '15000000', '中国银河投资管理有限公司', '广发基金管理有限公司', '广东恒健投资控股有限公司', '300000000', '吴轶', '2450000', '49000000', '12', '富通银行', '太平资产管理有限公司'}",1311474,4,"{'240000000', '13000000', '260000000', '49000000'}",12,"{'湖南湘投金天科技集团有限责任公司', '兵器财务有限责任公司', '现金', '中航鑫港担保有限公司', '定价', '中国银河投资管理有限公司', '广发基金管理有限公司', '广东恒健投资控股有限公司', '吴轶', '12', '富通银行', '太平资产管理有限公司'}",16,"{'12000000', '湖南湘投金天科技集团有限责任公司', '兵器财务有限责任公司', '现金', '中航鑫港担保有限公司', '定价', '15000000', '中国银河投资管理有限公司', '广发基金管理有限公司', '广东恒健投资控股有限公司', '300000000', '吴轶', '2450000', '12', '富通银行', '太平资产管理有限公司'}"
19,"{'5000000', '现金', '56738000', '宿迁华基丰润投资合伙企业(有限合伙)', '2200000', '浙商证券有限责任公司', '61896000', '北京市基础设施投资有限公司', '3200000', '128950000', '兴业全球基金管理有限公司', '232110000', '2400000', '上海国泰君安证券资产管理有限公司', '竞价', '82528000', '泰康资产管理有限责任公司', '9000000', '12'}",1279024,8,"{'56738000', '82528000', '3200000', '61896000', '128950000', '2400000', '232110000', '竞价'}",7,"{'现金', '兴业全球基金管理有限公司', '浙商证券有限责任公司', '北京市基础设施投资有限公司', '上海国泰君安证券资产管理有限公司', '泰康资产管理有限责任公司', '12'}",11,"{'5000000', '现金', '宿迁华基丰润投资合伙企业(有限合伙)', '2200000', '浙商证券有限责任公司', '兴业全球基金管理有限公司', '北京市基础设施投资有限公司', '上海国泰君安证券资产管理有限公司', '泰康资产管理有限责任公司', '9000000', '12'}"
20,"{'顺荣三七第1期员工持股计', '现金', '4363953', '汇添富基金', '1600000000', '6545930', '2181976', '100000000', '34911629', '定价', '奥娱叁特', '融捷投资', '芒果传媒', '300000000', '招商基金', '信达风盛', '200000000', '36', '万家共赢', '磐信投资'}",1629957,3,"{'300000000', '200000000', '1600000000'}",12,"{'顺荣三七第1期员工持股计', '36', '现金', '汇添富基金', '奥娱叁特', '定价', '融捷投资', '芒果传媒', '信达风盛', '招商基金', '万家共赢', '磐信投资'}",17,"{'顺荣三七第1期员工持股计', '现金', '4363953', '汇添富基金', '6545930', '2181976', '100000000', '34911629', '定价', '奥娱叁特', '融捷投资', '芒果传媒', '招商基金', '信达风盛', '36', '万家共赢', '磐信投资'}"
4,"{'现金', '竞价', '包钢集团', '36'}",1265457,0,set(),4,"{'竞价', '现金', '36', '包钢集团'}",4,"{'36', '竞价', '包钢集团', '现金'}"
14,"{'广发证券资产管理(广东)有限公司', '7541478', '199999996.6', '79999993.32', '3016591', '华泰资产管理有限公司', '财通基金管理有限公司', '80999982.96', '竞价', '1425340', '3054298', '37800016.8', '12', '泓德基金管理有限公司'}",1846916,4,"{'80999982.96', '79999993.32', '199999996.6', '竞价'}",1,{'12'},10,"{'广发证券资产管理(广东)有限公司', '7541478', '12', '3016591', '财通基金管理有限公司', '华泰资产管理有限公司', '3054298', '37800016.8', '1425340', '泓德基金管理有限公司'}"
13,"{'天津和悦', '现金', '4019053', '天津顺祺', '5180113', '天津善臻', '天津鸿勋', '4614468', '天津通明', '4048824', '8931230', '36', '天津康顺'}",578499,5,"{'4019053', '5180113', '4614468', '4048824', '8931230'}",8,"{'天津和悦', '现金', '天津顺祺', '天津善臻', '天津鸿勋', '天津通明', '36', '天津康顺'}",8,"{'现金', '天津和悦', '天津顺祺', '天津善臻', '天津鸿勋', '天津通明', '36', '天津康顺'}"
4,"{'竞价', '现金', '申达集团', '36'}",1850342,0,set(),4,"{'竞价', '现金', '申达集团', '36'}",4,"{'竞价', '现金', '申达集团', '36'}"
8,"{'齐盛电商', '20000000', '5000000', '现金', '中馀投资', '25000000', '齐泓基金', '36'}",317567,1,{'25000000'},5,"{'齐盛电商', '现金', '中馀投资', '齐泓基金', '36'}",7,"{'齐盛电商', '20000000', '5000000', '现金', '中馀投资', '齐泓基金', '36'}"
6,"{'147012578', '定价', '富鼎电子科技(嘉善)有限公司', '郑州投资控股有限公司', '25943396', '36'}",9901798,0,set(),3,"{'郑州投资控股有限公司', '定价', '36'}",6,"{'147012578', '定价', '富鼎电子科技(嘉善)有限公司', '郑州投资控股有限公司', '25943396', '36'}"
5,"{'现金', '竞价', '海航旅游', '36', '凯撒世嘉投资公司'}",15634929,0,set(),5,"{'现金', '竞价', '海航旅游', '36', '凯撒世嘉投资公司'}",5,"{'现金', '竞价', '海航旅游', '36', '凯撒世嘉投资公司'}"
11,"{'现金', '7750000', '6460000', '6470000', '竞价', '南通丰盈投资合伙企业(有限合伙)', '九江志元胜泰投资管理中心(有限合伙)', '12074300', '李新生', '36', '宁波亿华合众投资管理合伙企业(有限合伙)'}",1897770,8,"{'7750000', '6460000', '6470000', '竞价', '南通丰盈投资合伙企业(有限合伙)', '九江志元胜泰投资管理中心(有限合伙)', '12074300', '宁波亿华合众投资管理合伙企业(有限合伙)'}",3,"{'李新生', '现金', '36'}",3,"{'李新生', '现金', '36'}"
4,"{'中国建银投资有限责任公司', '现金', '竞价', '36'}",1227448,0,set(),4,"{'中国建银投资有限责任公司', '现金', '竞价', '36'}",4,"{'中国建银投资有限责任公司', '现金', '竞价', '36'}"
13,"{'常州常荣创业投资有限公司', '现金', '浪莎控股集团有限公司', '陈小兵', '2000000', '竞价', '3000000', '常州投资集团有限公司', '扬州市扬子江投资发展集团有限责任公司', '沈汉标', '1000000', '12', '2500000'}",1250575,2,"{'竞价', '1000000'}",4,"{'扬州市扬子江投资发展集团有限责任公司', '现金', '常州投资集团有限公司', '12'}",11,"{'常州常荣创业投资有限公司', '现金', '浪莎控股集团有限公司', '陈小兵', '2000000', '3000000', '常州投资集团有限公司', '扬州市扬子江投资发展集团有限责任公司', '沈汉标', '12', '2500000'}"
13,"{'131999908.6', '浙江浙商证券资产管理有限公司', '深圳天风天成资产管理有限公司', '九泰基金管理有限公司', '5062274', '国寿安保基金管理有限公司', '信诚基金管理有限公司', '5303331', '竞价', '125999999.9', '120000091.1', '4821217', '12'}",16165451,3,"{'131999908.6', '竞价', '125999999.9'}",1,{'12'},10,"{'浙江浙商证券资产管理有限公司', '深圳天风天成资产管理有限公司', '九泰基金管理有限公司', '5062274', '国寿安保基金管理有限公司', '5303331', '信诚基金管理有限公司', '120000091.1', '4821217', '12'}"
13,"{'40425530', '管理团队拟设立的合伙企业', '现金', '48510640', '16170210', '博锐奇投资', '嘉华成美', '上海原龙', '民加奥瑞金专项资管计划', '建投投资', '9788180', '36', '71062660'}",2372196,5,"{'40425530', '48510640', '16170210', '9788180', '71062660'}",8,"{'现金', '嘉华成美', '博锐奇投资', '上海原龙', '民加奥瑞金专项资管计划', '建投投资', '36', '管理团队拟设立的合伙企业'}",8,"{'现金', '嘉华成美', '博锐奇投资', '上海原龙', '民加奥瑞金专项资管计划', '建投投资', '36', '管理团队拟设立的合伙企业'}"
9,"{'19973368', '现金', '23968043', '定价', '厦门滨江资产管理有限公司', '22636485', '厦门市港中房地产开发有限公司', '36', '大洲控股集团有限公司'}",90029,3,"{'19973368', '23968043', '22636485'}",6,"{'现金', '定价', '厦门滨江资产管理有限公司', '厦门市港中房地产开发有限公司', '36', '大洲控股集团有限公司'}",6,"{'现金', '定价', '厦门滨江资产管理有限公司', '厦门市港中房地产开发有限公司', '36', '大洲控股集团有限公司'}"
25,"{'35000000', '朱麟', '32000000', '42000000', '12500000', '378880000', '6000000', '246627200', '71040000', '胡坚', '中乾景隆泰和(天津)股权投资基金合伙企业(有限合伙)', '148000000', '10000000', '汇添富基金管理股份有限公司', '16670000', '胡季强', '济宁领军基石医药股权投资企业(有限合伙)', '497280000', '深圳市领佳基石股权投资合伙企业(有限合伙)', '盐城市领佳基石股权投资合伙企业(有限合伙)', '118400000', '20830000', '414400000', '197372800', '36'}",1587793,11,"{'118400000', '414400000', '35000000', '197372800', '148000000', '497280000', '71040000', '6000000', '10000000', '246627200', '378880000'}",5,"{'胡坚', '胡季强', '朱麟', '汇添富基金管理股份有限公司', '36'}",14,"{'16670000', '胡季强', '20830000', '胡坚', '朱麟', '32000000', '盐城市领佳基石股权投资合伙企业(有限合伙)', '中乾景隆泰和(天津)股权投资基金合伙企业(有限合伙)', '济宁领军基石医药股权投资企业(有限合伙)', '42000000', '深圳市领佳基石股权投资合伙企业(有限合伙)', '12500000', '汇添富基金管理股份有限公司', '36'}"
23,"{'50905', '2520000', '南方基金管理有限公司', '申万菱信基金管理有限公司', '1655172', '99449990', '1388055', '财通基金管理有限公司', '竞价', '鹏华基金管理有限公司', '宝盈基金管理有限公司', '华泰柏瑞基金管理有限公司', '146160000', '1714655', '294839984', '95999976', '2952490', '创金合信基金管理有限公司', '1380868', '80507190', '5083448', '12', '80090344'}",1830105,0,set(),3,"{'竞价', '12', '申万菱信基金管理有限公司'}",23,"{'50905', '2520000', '南方基金管理有限公司', '申万菱信基金管理有限公司', '1655172', '99449990', '1388055', '财通基金管理有限公司', '竞价', '鹏华基金管理有限公司', '宝盈基金管理有限公司', '华泰柏瑞基金管理有限公司', '146160000', '1714655', '294839984', '95999976', '2952490', '创金合信基金管理有限公司', '1380868', '80507190', '5083448', '12', '80090344'}"
34,"{'237388724', '咸阳市金融控股有限公司', '1600000000', '陕西电子信息集团有限公司', '33857566', '合肥芯屏产业投资基金(有限合伙)', '94360000', '咸阳市城市建设投资控股集团有限公司', '194078635', '咸阳中电彩虹集团控股有限公司', '4499999998', '148367952', '51928783', '349999997.4', '14000000', '667655786', '财通基金管理有限公司', '竞价', '139349998.8', '1112759643', '36', '999999996.5', '陕西如意广电科技有限公司', '北信瑞丰基金管理有限公司', '20675074', '60', '370919881', '2499999998', '228199994.8', '7499999994', '陕西延长石油财务有限公司', '1308090000', '12', '汇安基金管理有限责任公司'}",16769828,8,"{'2499999998', '999999996.5', '4499999998', '1600000000', '竞价', '139349998.8', '7499999994', '1308090000'}",12,"{'36', '咸阳市金融控股有限公司', '咸阳市城市建设投资控股集团有限公司', '北信瑞丰基金管理有限公司', '陕西如意广电科技有限公司', '咸阳中电彩虹集团控股有限公司', '陕西电子信息集团有限公司', '60', '财通基金管理有限公司', '陕西延长石油财务有限公司', '12', '汇安基金管理有限责任公司'}",26,"{'237388724', '咸阳市金融控股有限公司', '陕西电子信息集团有限公司', '33857566', '合肥芯屏产业投资基金(有限合伙)', '94360000', '咸阳市城市建设投资控股集团有限公司', '194078635', '咸阳中电彩虹集团控股有限公司', '349999997.4', '148367952', '51928783', '14000000', '667655786', '财通基金管理有限公司', '1112759643', '36', '北信瑞丰基金管理有限公司', '陕西如意广电科技有限公司', '20675074', '60', '370919881', '228199994.8', '陕西延长石油财务有限公司', '12', '汇安基金管理有限责任公司'}"
19,"{'51718760', '海厚泰投资', '现金', '刘振光', '12836970', '22464698', '128345315', '上海泽熙增煦', '32093820', '竞价', '805778280.8', '上海苇晔', '349999994.8', '上海灏奕', '1999620008', '500021715.6', '银厥资本', '36', '199999992.6'}",1590406,2,"{'1999620008', '竞价'}",8,"{'海厚泰投资', '现金', '刘振光', '上海泽熙增煦', '上海灏奕', '上海苇晔', '银厥资本', '36'}",17,"{'51718760', '海厚泰投资', '现金', '刘振光', '12836970', '22464698', '128345315', '上海泽熙增煦', '32093820', '805778280.8', '上海苇晔', '349999994.8', '上海灏奕', '500021715.6', '银厥资本', '36', '199999992.6'}"
12,"{'顾铁峰', '现金', '10158730', '69388996.95', '95999998.5', '竞价', '黄志坚', '19999998.9', '2116402', '7342751', '汪贤忠', '12'}",18887599,1,{'竞价'},5,"{'顾铁峰', '现金', '黄志坚', '汪贤忠', '12'}",11,"{'顾铁峰', '现金', '10158730', '69388996.95', '95999998.5', '黄志坚', '19999998.9', '2116402', '7342751', '汪贤忠', '12'}"
10,"{'176678445', '现金', '353356890', '定价', '1000000000', '阳煤金陵', '500000000', '金陵阳明', '36', '金陵恒毅'}",1775337,2,"{'1000000000', '500000000'}",6,"{'现金', '定价', '阳煤金陵', '金陵阳明', '36', '金陵恒毅'}",8,"{'176678445', '现金', '353356890', '定价', '阳煤金陵', '金陵阳明', '36', '金陵恒毅'}"
4,"{'北京燕京啤酒有限公司', '竞价', '现金', '36'}",1368916,1,{'竞价'},3,"{'北京燕京啤酒有限公司', '现金', '36'}",3,"{'北京燕京啤酒有限公司', '现金', '36'}"
29,"{'250000224', '499970000', '盟科投资控股有限公司', '上海融晟置业投资顾问有限公司', '144508671', '241283236', '160000000', '500000001.7', '深圳市远致投资有限公司', '86719654', '86710000', '广东恒健投资控股有限公司', '深圳市海谷神动漫设计有限公司', '苏宁电器集团有限公司', '834839996.6', '竞价', '西部建元控股有限公司', '300050002.8', '深圳市平安创新资本投资有限公司', '36', '惠州市投资控股有限公司', '553600000', '李东生', '60693641', '209999997.9', '300016600', '144500000', '12', '72254400'}",1256225,3,"{'834839996.6', '500000001.7', '209999997.9'}",6,"{'36', '惠州市投资控股有限公司', '苏宁电器集团有限公司', '竞价', '李东生', '12'}",26,"{'250000224', '499970000', '盟科投资控股有限公司', '上海融晟置业投资顾问有限公司', '144508671', '241283236', '160000000', '深圳市远致投资有限公司', '86719654', '86710000', '广东恒健投资控股有限公司', '深圳市海谷神动漫设计有限公司', '苏宁电器集团有限公司', '西部建元控股有限公司', '竞价', '300050002.8', '深圳市平安创新资本投资有限公司', '36', '惠州市投资控股有限公司', '553600000', '李东生', '60693641', '300016600', '144500000', '12', '72254400'}"
4,"{'现金', '竞价', '周德洪', '36'}",1783633,1,{'竞价'},3,"{'现金', '周德洪', '36'}",3,"{'周德洪', '现金', '36'}"
4,"{'上海远洋', '竞价', '现金', '36'}",15725762,1,{'竞价'},3,"{'上海远洋', '现金', '36'}",3,"{'上海远洋', '现金', '36'}"
15,"{'现金', '泰康人寿保险股份有限公司—传统普通保险产品', '江苏瑞华投资发展有限公司', '都邦财产保险股份有限公司—传统保险产品*', '140000', '瑞士银行(UBS AG)', '4000000', '定价', '2000000', '上海励诚投资发展有限公司', '3000000', '中信证券股份有限公司', '3860000', '上海融昌资产管理有限公司', '12'}",1372048,3,"{'140000', '3860000', '瑞士银行(UBS AG)'}",4,"{'定价', '12', '现金', '泰康人寿保险股份有限公司—传统普通保险产品'}",12,"{'现金', '泰康人寿保险股份有限公司—传统普通保险产品', '江苏瑞华投资发展有限公司', '都邦财产保险股份有限公司—传统保险产品*', '4000000', '定价', '2000000', '上海励诚投资发展有限公司', '3000000', '中信证券股份有限公司', '上海融昌资产管理有限公司', '12'}"
9,"{'现金', '添富-定增35号', '2987917', '26789974', '竞价', '广州无线电集团有限公司', '36', '45578406', '添富-定增36号'}",1741146,1,{'竞价'},5,"{'添富-定增35号', '现金', '广州无线电集团有限公司', '36', '添富-定增36号'}",8,"{'添富-定增35号', '现金', '2987917', '26789974', '广州无线电集团有限公司', '36', '45578406', '添富-定增36号'}"
20,"{'波巴贸易', '孟凯', '现金', '40000000', '中金通合', '960000000', '泰达宏利基金', '盛达国兴', '240000000', '160000000', '60000000', '魏耀辉', '竞价', '300000000', '50000000', '中金君合', '富德昊邦', '孟勇', '360000000', '36'}",603213,9,"{'40000000', '240000000', '960000000', '160000000', '60000000', '竞价', '300000000', '50000000', '360000000'}",11,"{'孟凯', '36', '现金', '中金通合', '盛达国兴', '泰达宏利基金', '魏耀辉', '中金君合', '富德昊邦', '孟勇', '波巴贸易'}",11,"{'波巴贸易', '孟凯', '现金', '中金通合', '盛达国兴', '泰达宏利基金', '魏耀辉', '中金君合', '富德昊邦', '孟勇', '36'}"
17,"{'20000000', '太平洋资产管理有限责任公司', '现金', '金鹰基金管理有限公司', '宏源证券股份有限公司', '国华人寿保险股份有限公司', '179000000', '89500000', '华泰资产管理有限公司', '财通基金管理有限公司', '易方达基金管理有限公司', '53700000', '竞价', '中银基金管理有限公司', '6000000', '10000000', '12'}",350687,6,"{'20000000', '53700000', '179000000', '89500000', '竞价', '10000000'}",10,"{'金鹰基金管理有限公司', '太平洋资产管理有限责任公司', '现金', '宏源证券股份有限公司', '国华人寿保险股份有限公司', '华泰资产管理有限公司', '财通基金管理有限公司', '易方达基金管理有限公司', '中银基金管理有限公司', '12'}",11,"{'金鹰基金管理有限公司', '太平洋资产管理有限责任公司', '现金', '宏源证券股份有限公司', '国华人寿保险股份有限公司', '华泰资产管理有限公司', '财通基金管理有限公司', '易方达基金管理有限公司', '中银基金管理有限公司', '6000000', '12'}"
13,"{'广发证券资产管理(广东)有限公司', '韬蕴(北京)投资控股有限公司', '10938924', '上海中植鑫荞投资管理有限公司', '124999990.6', '5697356', '竞价', '5469462', '长江证券(上海)资产管理有限公司', '239999992.6', '115000001.9', '119999996.3', '5241568'}",1815836,2,"{'119999996.3', '239999992.6'}",2,"{'上海中植鑫荞投资管理有限公司', '竞价'}",11,"{'广发证券资产管理(广东)有限公司', '韬蕴(北京)投资控股有限公司', '10938924', '上海中植鑫荞投资管理有限公司', '124999990.6', '5697356', '5469462', '竞价', '长江证券(上海)资产管理有限公司', '115000001.9', '5241568'}"
29,"{'17603922', '35000000', '西藏自治区投资有限公司', '178500000', '128520000', '153000000', '兴业全球基金管理有限公司', '199999998.6', '南京中电熊猫信息产业集团有限公司', '财通基金管理有限公司', '30000000', '南京瑞森投资管理合伙企业(有限合伙)', '39215686', '49999997.1', '36', '132600000', '260100000', '北京市基础设施投资有限公司', '51000000', '25200000', '25000000', '江苏国泰华鼎投资有限公司', '89780002.2', '127500000', '西藏山南中和投资管理中心(有限合伙)', '南方工业资产管理有限责任公司', '9803921', '26000000', '12'}",406633,10,"{'49999997.1', '17603922', '132600000', '260100000', '199999998.6', '178500000', '128520000', '153000000', '89780002.2', '127500000'}",3,"{'36', '南京中电熊猫信息产业集团有限公司', '12'}",19,"{'南京瑞森投资管理合伙企业(有限合伙)', '南方工业资产管理有限责任公司', '西藏山南中和投资管理中心(有限合伙)', '39215686', '36', '9803921', '兴业全球基金管理有限公司', '35000000', '北京市基础设施投资有限公司', '51000000', '南京中电熊猫信息产业集团有限公司', '26000000', '财通基金管理有限公司', '西藏自治区投资有限公司', '25200000', '25000000', '江苏国泰华鼎投资有限公司', '30000000', '12'}"
12,"{'大通燃气员工持股计划', '现金', '李可珍', '11104166', '38687500', '竞价', '陈蓉章', '大通集团', '12812500', '10000000', '36', '李朝波'}",1593912,1,{'竞价'},7,"{'大通燃气员工持股计划', '现金', '李可珍', '李朝波', '大通集团', '36', '陈蓉章'}",11,"{'大通燃气员工持股计划', '现金', '李可珍', '11104166', '38687500', '陈蓉章', '大通集团', '12812500', '10000000', '36', '李朝波'}"
19,"{'宁波正业控股集团有限公司', '4950000', '现金', '天津证大金龙股权投资基金合伙企业(有限合伙)', '江苏瑞华投资发展有限公司', '1000000', '3850000', '4150000', '无锡滨湖企业投资担保有限公司', '上海英博企业发展有限公司', '竞价', '3950000', '济南北安投资有限公司', '4900000', '无锡天地源投资有限公司', '卜波', '12', '富通银行', '湖州天元股权投资合伙企业(有限合伙)'}",1190403,2,"{'竞价', '3850000'}",10,"{'宁波正业控股集团有限公司', '现金', '江苏瑞华投资发展有限公司', '无锡滨湖企业投资担保有限公司', '上海英博企业发展有限公司', '无锡天地源投资有限公司', '济南北安投资有限公司', '卜波', '12', '富通银行'}",17,"{'宁波正业控股集团有限公司', '4950000', '现金', '天津证大金龙股权投资基金合伙企业(有限合伙)', '江苏瑞华投资发展有限公司', '1000000', '4150000', '无锡滨湖企业投资担保有限公司', '上海英博企业发展有限公司', '3950000', '济南北安投资有限公司', '4900000', '无锡天地源投资有限公司', '卜波', '12', '富通银行', '湖州天元股权投资合伙企业(有限合伙)'}"
6,"{'现金', '85287900', '浩物机电', '42644000', '36', '鼎孚投资'}",1195251,1,{'85287900'},4,"{'鼎孚投资', '现金', '36', '浩物机电'}",5,"{'现金', '浩物机电', '42644000', '36', '鼎孚投资'}"
4,"{'同盛集团', '1764379518', '股权', '36'}",1130049,1,{'1764379518'},3,"{'同盛集团', '股权', '36'}",3,"{'同盛集团', '股权', '36'}"
27,"{'12000000', '270675000', '4000000', '金瑞浩', '阮伟祥', '陈国江', '罗斌', '6000000', '周波', '现金', '定价', '项志峰', '30000000', '72180000', '360900000', '5500000', '66165000', '144360000', '38496000', '22500000', '3200000', '阮兴祥', '何旭斌', '48120000', '姚建芳', '王勇', '36'}",106446,9,"{'270675000', '3200000', '4000000', '360900000', '48120000', '66165000', '144360000', '38496000', '72180000'}",13,"{'周波', '现金', '阮兴祥', '何旭斌', '定价', '金瑞浩', '阮伟祥', '项志峰', '陈国江', '罗斌', '姚建芳', '王勇', '36'}",18,"{'12000000', '周波', '现金', '阮兴祥', '何旭斌', '定价', '王勇', '金瑞浩', '阮伟祥', '5500000', '项志峰', '陈国江', '罗斌', '姚建芳', '22500000', '6000000', '30000000', '36'}"
16,"{'20000000', '4219409', '现金', '李俊英', '罗明远', '晋商联盟', '63291139', '中铁宇丰', '6329114', '300000000', '常青藤联创', '李冰侠', '200000000', '30000000', '36', '42194093'}",676485,8,"{'20000000', '4219409', '63291139', '6329114', '300000000', '200000000', '30000000', '42194093'}",8,"{'36', '现金', '李俊英', '罗明远', '晋商联盟', '中铁宇丰', '李冰侠', '常青藤联创'}",8,"{'现金', '李俊英', '罗明远', '晋商联盟', '中铁宇丰', '常青藤联创', '李冰侠', '36'}"
19,"{'149600000', '29920000', '6000000', '现金', '王健摄', '国金证券', '东证资管', '118096000', '李培祥', '52800000', '5370000', '17000000', '涌金控股', '47256000', '祥禾泓安', '3400000', '郑海若', '13420000', '36'}",351700,10,"{'149600000', '13420000', '118096000', '52800000', '5370000', '3400000', '17000000', '47256000', '6000000', '29920000'}",9,"{'王健摄', '现金', '国金证券', '李培祥', '东证资管', '涌金控股', '郑海若', '祥禾泓安', '36'}",9,"{'现金', '王健摄', '国金证券', '东证资管', '李培祥', '涌金控股', '郑海若', '祥禾泓安', '36'}"
14,"{'现金', '北信瑞丰基金管理有限公司', '20195838', '14075887', '定价', '18941424', '财通基金管理有限公司', '16768665', '229999993.6', '329999992.9', '安信基金管理有限责任公司', '309502868.2', '宝盈基金管理有限公司', '273999986.1'}",14704702,2,"{'229999993.6', '309502868.2'}",6,"{'现金', '北信瑞丰基金管理有限公司', '定价', '财通基金管理有限公司', '安信基金管理有限责任公司', '宝盈基金管理有限公司'}",12,"{'现金', '北信瑞丰基金管理有限公司', '20195838', '14075887', '定价', '18941424', '财通基金管理有限公司', '16768665', '329999992.9', '安信基金管理有限责任公司', '宝盈基金管理有限公司', '273999986.1'}"
17,"{'5000000', '中航鑫港担保有限公司', '江苏瑞华投资发展有限公司', '兴业全球基金管理有限公司', '广发证券股份有限公司', '1700000', '国华人寿保险股份有限公司', '卢君', '7000000', '3700000', '绍兴润鑫股权投资合伙企业(有限合伙)', '竞价', '深圳市平安创新资本投资有限公司', '4200000', '泰康资产管理有限责任公司', '3600000', '12'}",1225834,1,{'竞价'},2,"{'12', '3700000'}",16,"{'5000000', '中航鑫港担保有限公司', '江苏瑞华投资发展有限公司', '兴业全球基金管理有限公司', '广发证券股份有限公司', '1700000', '国华人寿保险股份有限公司', '卢君', '7000000', '3700000', '绍兴润鑫股权投资合伙企业(有限合伙)', '深圳市平安创新资本投资有限公司', '4200000', '泰康资产管理有限责任公司', '3600000', '12'}"
19,"{'湖南湘投金天科技集团有限责任公司', '现金', '1066374', '3200000', '方正东亚信托有限责任公司', '12', '浙江商裕开盛创业投资合伙企业(有限合伙)', '天津信托有限责任公司', '浙江省商业集团有限公司', '2800000', '上海星河数码投资有限公司', '3000000', '5858188', '广东恒健资本管理有限公司', '广东省广新控股集团有限公司', '深圳市经典一号投资合伙企业(有限合伙)', '广州安州投资管理有限公司', '3100000', '36'}",1464031,0,set(),11,"{'36', '湖南湘投金天科技集团有限责任公司', '现金', '方正东亚信托有限责任公司', '天津信托有限责任公司', '浙江省商业集团有限公司', '上海星河数码投资有限公司', '广东恒健资本管理有限公司', '广东省广新控股集团有限公司', '广州安州投资管理有限公司', '12'}",19,"{'湖南湘投金天科技集团有限责任公司', '1066374', '现金', '3200000', '方正东亚信托有限责任公司', '12', '浙江商裕开盛创业投资合伙企业(有限合伙)', '天津信托有限责任公司', '浙江省商业集团有限公司', '2800000', '上海星河数码投资有限公司', '3000000', '5858188', '广东恒健资本管理有限公司', '广东省广新控股集团有限公司', '深圳市经典一号投资合伙企业(有限合伙)', '广州安州投资管理有限公司', '3100000', '36'}"
16,"{'25252525', '12626262', '现金', '599999994', '199999998', '福建省能源集团有限责任公司', '定价', '平安资产管理有限责任公司', '福建省投资开发集团有限责任公司', '福建省汽车工业集团有限公司', '75757575', '25252527', '99999995.04', '200000013.8', '福建省交通运输集团有限责任公司', '36'}",1632566,0,set(),8,"{'现金', '福建省能源集团有限责任公司', '定价', '平安资产管理有限责任公司', '福建省投资开发集团有限责任公司', '福建省汽车工业集团有限公司', '福建省交通运输集团有限责任公司', '36'}",16,"{'25252525', '12626262', '599999994', '现金', '199999998', '福建省能源集团有限责任公司', '定价', '平安资产管理有限责任公司', '福建省投资开发集团有限责任公司', '福建省汽车工业集团有限公司', '75757575', '25252527', '99999995.04', '200000013.8', '福建省交通运输集团有限责任公司', '36'}"
11,"{'清华控股有限公司', '208913649', '工银瑞信基金管理有限公司', '紫光集团有限公司', '博时基金管理有限公司', '69637883', '2000000000', '499999999.9', '1500000000', '278551532', '36'}",82556,2,"{'2000000000', '1500000000'}",5,"{'清华控股有限公司', '工银瑞信基金管理有限公司', '紫光集团有限公司', '博时基金管理有限公司', '36'}",9,"{'清华控股有限公司', '208913649', '工银瑞信基金管理有限公司', '紫光集团有限公司', '博时基金管理有限公司', '69637883', '499999999.9', '278551532', '36'}"
4,"{'广晟公司', '现金', '36', '广发恒定15号'}",348464,0,set(),3,"{'广晟公司', '现金', '36'}",4,"{'广晟公司', '现金', '36', '广发恒定15号'}"
6,"{'100000000', '280000000', '陈卫', '竞价', '36', '力帆控股'}",14044662,2,"{'100000000', '280000000'}",4,"{'竞价', '陈卫', '36', '力帆控股'}",4,"{'竞价', '陈卫', '36', '力帆控股'}"
10,"{'5000000', '华夏基金管理有限公司', '新疆凯迪投资有限责任公司', '11000000', '竞价', '特变电工股份有限公司', '10017347', '10000000', '中海基金管理有限公司', '12'}",815058,1,{'11000000'},5,"{'华夏基金管理有限公司', '新疆凯迪投资有限责任公司', '特变电工股份有限公司', '竞价', '12'}",9,"{'5000000', '华夏基金管理有限公司', '新疆凯迪投资有限责任公司', '特变电工股份有限公司', '竞价', '10017347', '10000000', '中海基金管理有限公司', '12'}"
6,"{'现金', '100000000', '523000000', '定价', '36', '建机集团'}",411230,1,{'523000000'},4,"{'36', '定价', '现金', '建机集团'}",5,"{'现金', '100000000', '定价', '36', '建机集团'}"
5,"{'现金', '定价', '1958480', '王冠一', '36'}",1675452,0,set(),4,"{'定价', '王冠一', '现金', '36'}",5,"{'现金', '定价', '1958480', '王冠一', '36'}"
18,"{'90420000', '邱梅芳', '6100000', '6740000', '10300000', '唐建晓', '万利隆投资管理有限公司', '上海金力方股权投资合伙企业(有限合伙)', '嘉实基金管理有限公司', '7000000', '竞价', '91927000', '155221000', '101571800', '6000000', '105490000', '12', '江苏开元国际集团轻工业品进出口股份有限公司'}",54775,6,"{'竞价', '155221000', '91927000', '101571800', '105490000', '90420000'}",6,"{'邱梅芳', '唐建晓', '万利隆投资管理有限公司', '嘉实基金管理有限公司', '12', '江苏开元国际集团轻工业品进出口股份有限公司'}",12,"{'邱梅芳', '6100000', '6740000', '10300000', '唐建晓', '万利隆投资管理有限公司', '7000000', '嘉实基金管理有限公司', '上海金力方股权投资合伙企业(有限合伙)', '6000000', '12', '江苏开元国际集团轻工业品进出口股份有限公司'}"
21,"{'19836940', '光大金控(上海)投资中心(有限合伙)', '中国建材股份有限公司', '财通基金管理有限公司', '16787313', '竞价', '13090907', '平安大华基金管理有限公司', '5481193', '太平洋资产管理有限责任公司', '36', '13060447', '博时基金管理有限公司', '13068121', '18162935', '国泰基金管理有限公司', '中国民族证券有限责任公司', '安信证券股份有限公司', '19272095', '12', '13080845'}",348937,0,set(),11,"{'平安大华基金管理有限公司', '中国建材股份有限公司', '36', '太平洋资产管理有限责任公司', '中国民族证券有限责任公司', '博时基金管理有限公司', '财通基金管理有限公司', '国泰基金管理有限公司', '竞价', '安信证券股份有限公司', '12'}",21,"{'19836940', '光大金控(上海)投资中心(有限合伙)', '中国建材股份有限公司', '财通基金管理有限公司', '16787313', '竞价', '13090907', '平安大华基金管理有限公司', '5481193', '太平洋资产管理有限责任公司', '36', '13060447', '博时基金管理有限公司', '13068121', '18162935', '国泰基金管理有限公司', '中国民族证券有限责任公司', '安信证券股份有限公司', '19272095', '12', '13080845'}"
21,"{'申万菱信(上海)资产管理有限公司', '15384615', '119999997', '刘美宝', '华融天泽投资有限公司', '现金', '竞价', '10769230', '199999995', '鹏华资产管理(深圳)有限公司', '99999991', '北信瑞丰基金管理有限公司', '7692307', '9230772', '120000036', '金鹰基金管理有限公司', '139999990', '第一创业证券股份有限公司', '9230769', '东鼎国际财富投资管理有限公司', '12'}",14756064,1,{'竞价'},8,"{'金鹰基金管理有限公司', '华融天泽投资有限公司', '现金', '第一创业证券股份有限公司', '北信瑞丰基金管理有限公司', '刘美宝', '东鼎国际财富投资管理有限公司', '12'}",20,"{'刘美宝', '华融天泽投资有限公司', '现金', '第一创业证券股份有限公司', '鹏华资产管理(深圳)有限公司', '7692307', '北信瑞丰基金管理有限公司', '139999990', '金鹰基金管理有限公司', '9230769', '119999997', '申万菱信(上海)资产管理有限公司', '9230772', '10769230', '120000036', '199999995', '东鼎国际财富投资管理有限公司', '99999991', '15384615', '12'}"
8,"{'150000000', '现金', '宁德国', '71428571', '550000000', '福建投资集团', '36', '19480519'}",12051815,4,"{'150000000', '550000000', '71428571', '19480519'}",4,"{'福建投资集团', '现金', '宁德国', '36'}",4,"{'福建投资集团', '现金', '宁德国', '36'}"
1,{'张仁华'},1887863,0,set(),1,{'张仁华'},1,{'张仁华'}
15,"{'13440860', '现金', '2880184', '61000028.04', '天弘基金', '53999981.28', '中植产投', '中信证券', '竞价', '上汽投资', '2342551', '2073732', '12', '349999994.4', '74999991.36'}",14671262,7,"{'2880184', '61000028.04', '53999981.28', '竞价', '2342551', '349999994.4', '74999991.36'}",6,"{'现金', '天弘基金', '中植产投', '中信证券', '上汽投资', '12'}",8,"{'13440860', '现金', '天弘基金', '中植产投', '中信证券', '上汽投资', '2073732', '12'}"
14,"{'雁裕投资', '聚利投资', '现金', '郁金香资本', '丰煜投资', '加值资本', '1000000000', '利得资本', '2000000000', '汇利投资', '1500000000', '500000000', '新世纪公司', '36'}",1784498,4,"{'1000000000', '500000000', '2000000000', '1500000000'}",10,"{'36', '聚利投资', '现金', '郁金香资本', '加值资本', '利得资本', '汇利投资', '雁裕投资', '新世纪公司', '丰煜投资'}",10,"{'聚利投资', '现金', '郁金香资本', '丰煜投资', '加值资本', '利得资本', '汇利投资', '雁裕投资', '新世纪公司', '36'}"
15,"{'6700000', '华基丰收(天津)投资合伙企业(有限合伙)', '现金', '华安基金管理有限公司', '4000000', '邹瀚枢', '4100000', '上海国泰君安证券资产管理有限公司', '广东恒健资本管理有限公司', '北京硕展中富投资中心(有限合伙)', '5200000', '775100', '重庆中新融泽投资中心(有限合伙)', '12', '6800000'}",1277016,6,"{'4000000', '6800000', '4100000', '775100', '5200000', '6700000'}",2,"{'现金', '12'}",9,"{'华基丰收(天津)投资合伙企业(有限合伙)', '现金', '华安基金管理有限公司', '邹瀚枢', '上海国泰君安证券资产管理有限公司', '广东恒健资本管理有限公司', '北京硕展中富投资中心(有限合伙)', '重庆中新融泽投资中心(有限合伙)', '12'}"
4,"{'竞价', '现金', '36', '燃气控股'}",1690756,0,set(),4,"{'竞价', '现金', '36', '燃气控股'}",4,"{'竞价', '现金', '36', '燃气控股'}"
28,"{'南京盛亚科技投资有限公司', '22120069.86', '1692800', '107100000', '南方基金管理有限公司', '8000000', '57120000', '现金', '53550000', '12', '11000000', '竞价', '资产', '鹏华基金管理有限公司', '78540000', '15000000', '三胞集团有限公司', '3098049', '5353160000', '7500000', '银威利实业(深圳)有限公司', '华夏基金管理有限公司', '江苏苏豪国际集团股份有限公司', '2030400', '23147200', '中海基金管理有限公司', '36', '海富通基金管理有限公司'}",329675,10,"{'22120069.86', '78540000', '53550000', '1692800', '107100000', '竞价', '2030400', '23147200', '57120000', '5353160000'}",7,"{'南京盛亚科技投资有限公司', '36', '现金', '资产', '江苏苏豪国际集团股份有限公司', '三胞集团有限公司', '12'}",18,"{'南京盛亚科技投资有限公司', '36', '现金', '华夏基金管理有限公司', '15000000', '11000000', '资产', '三胞集团有限公司', '江苏苏豪国际集团股份有限公司', '南方基金管理有限公司', '7500000', '鹏华基金管理有限公司', '银威利实业(深圳)有限公司', '8000000', '中海基金管理有限公司', '3098049', '12', '海富通基金管理有限公司'}"
20,"{'现金', '651600000', '汇祥宏界(天津)创业投资合伙企业(有限合伙)', '广发证券股份有限公司', '瑞基资产管理有限公司', '农银汇理基金管理有限公司', '2417436000', '金元惠理基金管理有限公司', '778488261.8', '805812000', '华富基金管理有限公司', '14729778', '竞价', '54647476.38', '华融证券股份有限公司', '217200000', '上海钜向投资管理合伙企业(有限合伙)', '12', '209835111', '海富通基金管理有限公司'}",145663,0,set(),10,"{'现金', '广发证券股份有限公司', '瑞基资产管理有限公司', '农银汇理基金管理有限公司', '金元惠理基金管理有限公司', '华富基金管理有限公司', '竞价', '华融证券股份有限公司', '12', '海富通基金管理有限公司'}",20,"{'现金', '651600000', '汇祥宏界(天津)创业投资合伙企业(有限合伙)', '广发证券股份有限公司', '瑞基资产管理有限公司', '农银汇理基金管理有限公司', '2417436000', '金元惠理基金管理有限公司', '778488261.8', '805812000', '华富基金管理有限公司', '14729778', '竞价', '54647476.38', '华融证券股份有限公司', '217200000', '上海钜向投资管理合伙企业(有限合伙)', '12', '209835111', '海富通基金管理有限公司'}"
17,"{'胡惠康', '现金', '5555556', '长航联合', '厦门华鑫丰', '7407407', '当代文化', '13888889', '吕桧瑛', '134259259', '南方资本-当代东方定向增发专项资产管理计划', '50925926', '4629630', '先锋亚太', '9259259', '36', '厦门旭熙'}",351147,4,"{'13888889', '9259259', '134259259', '50925926'}",9,"{'胡惠康', '现金', '长航联合', '厦门华鑫丰', '当代文化', '吕桧瑛', '先锋亚太', '36', '厦门旭熙'}",13,"{'胡惠康', '现金', '5555556', '长航联合', '厦门华鑫丰', '7407407', '当代文化', '吕桧瑛', '南方资本-当代东方定向增发专项资产管理计划', '4629630', '先锋亚太', '36', '厦门旭熙'}"
19,"{'5000000', '3500000', '中邮创业基金管理有限公司', '12', '南天电子信息产业集团公司', '中国人保资产管理股份有限公司', '15000000', '4000000', '上海瑞熹联实业有限公司', '上海德润投资有限公司', '3000000', '海通证券股份有限公司', '南方基金管理有限公司', '云南省国有资产经营有限责任公司', '6000000', '无锡市新宝联投资有限公司', '无锡华光锅炉股份有限公司', '36', '2500000'}",813374,1,{'2500000'},12,"{'36', '中邮创业基金管理有限公司', '中国人保资产管理股份有限公司', '南天电子信息产业集团公司', '上海瑞熹联实业有限公司', '上海德润投资有限公司', '海通证券股份有限公司', '南方基金管理有限公司', '云南省国有资产经营有限责任公司', '无锡市新宝联投资有限公司', '无锡华光锅炉股份有限公司', '12'}",18,"{'5000000', '3500000', '中邮创业基金管理有限公司', '12', '南天电子信息产业集团公司', '中国人保资产管理股份有限公司', '15000000', '4000000', '上海瑞熹联实业有限公司', '上海德润投资有限公司', '3000000', '海通证券股份有限公司', '南方基金管理有限公司', '云南省国有资产经营有限责任公司', '6000000', '无锡市新宝联投资有限公司', '无锡华光锅炉股份有限公司', '36'}"
9,"{'160049005.6', '现金', '赵东日', '潍坊至真至信投资合伙企业(有限合伙)', '11054167', '定价', '26410727', '66988252.02', '36'}",12051950,1,{'66988252.02'},4,"{'定价', '现金', '36', '赵东日'}",8,"{'160049005.6', '现金', '赵东日', '潍坊至真至信投资合伙企业(有限合伙)', '11054167', '定价', '26410727', '36'}"
25,"{'262499987', '14065338', '499999985.5', '30248033', '16333938', '299999994.6', '深圳安鹏汽车后市场产业基金(有限合伙)', '18753781', '31760435', '竞价', '财通资产-金固股份高管定增特定多个客户专项资产管理计划', '36', '18148820', '杭州东方嘉富资产管理有限公司', '269999995.1', '15880217', '华鑫证券有限责任公司', '九泰基金管理有限公司', '309999999.9', '232500037.1', '天弘基金管理有限公司', '金元顺安基金管理有限公司', '524999990.6', '华安未来资产管理(上海)有限公司', '12'}",16017359,3,"{'524999990.6', '竞价', '499999985.5'}",8,"{'36', '九泰基金管理有限公司', '杭州东方嘉富资产管理有限公司', '12', '天弘基金管理有限公司', '金元顺安基金管理有限公司', '财通资产-金固股份高管定增特定多个客户专项资产管理计划', '华鑫证券有限责任公司'}",22,"{'262499987', '14065338', '30248033', '16333938', '299999994.6', '深圳安鹏汽车后市场产业基金(有限合伙)', '18753781', '31760435', '财通资产-金固股份高管定增特定多个客户专项资产管理计划', '36', '18148820', '杭州东方嘉富资产管理有限公司', '15880217', '华鑫证券有限责任公司', '九泰基金管理有限公司', '309999999.9', '232500037.1', '天弘基金管理有限公司', '金元顺安基金管理有限公司', '269999995.1', '华安未来资产管理(上海)有限公司', '12'}"
5,"{'现金', '中国贵州航空工业(集团)有限责任公司', '竞价', '30000000', '36'}",1230821,3,"{'竞价', '30000000', '中国贵州航空工业(集团)有限责任公司'}",2,"{'现金', '36'}",2,"{'现金', '36'}"
22,"{'海通证券股份有限公司', '352500000', '583333334', '312500000', '北京亦庄国际投资发展有限公司', '现金', '400000000', '合肥鑫城国有资产经营有限公司', '竞价', '合肥蓝科投资有限公司', '625000000', '北京智帅投资咨询有限公司', '36', '航天科技财务有限责任公司', '西南证券股份有限公司', '柯希平', '上海诺达圣信息科技有限公司', '410000000', '291666666', '红塔证券股份有限公司', '700000000', '12'}",1203992,1,{'竞价'},13,"{'上海诺达圣信息科技有限公司', '北京亦庄国际投资发展有限公司', '现金', '12', '合肥鑫城国有资产经营有限公司', '西南证券股份有限公司', '红塔证券股份有限公司', '合肥蓝科投资有限公司', '北京智帅投资咨询有限公司', '海通证券股份有限公司', '航天科技财务有限责任公司', '36', '柯希平'}",21,"{'海通证券股份有限公司', '352500000', '583333334', '312500000', '北京亦庄国际投资发展有限公司', '现金', '400000000', '合肥鑫城国有资产经营有限公司', '合肥蓝科投资有限公司', '北京智帅投资咨询有限公司', '625000000', '36', '航天科技财务有限责任公司', '西南证券股份有限公司', '柯希平', '上海诺达圣信息科技有限公司', '410000000', '291666666', '红塔证券股份有限公司', '700000000', '12'}"
15,"{'天津人保远望资产管理中心(有限合伙)', '现金', '99988800', '14070000', '启迪科技服务有限公司', '定价', '嘉实基金管理有限公司', '22520000', '49905600', '2810000', '399955200', '249883200', '36', '衡阳弘湘国有投资(控股)集团有限公司', '5630000'}",1778529,8,"{'99988800', '14070000', '22520000', '49905600', '2810000', '399955200', '249883200', '5630000'}",5,"{'现金', '启迪科技服务有限公司', '定价', '嘉实基金管理有限公司', '36'}",7,"{'天津人保远望资产管理中心(有限合伙)', '现金', '启迪科技服务有限公司', '定价', '嘉实基金管理有限公司', '36', '衡阳弘湘国有投资(控股)集团有限公司'}"
26,"{'51500038', '189999990', '江苏一带一路投资基金(有限合伙)', '深圳天风天成资产管理有限公司', '易方达基金管理有限公司', '210999988', '3029414', '249999994', '199999985', '现金', '10617647', '竞价', '180499999', '11764705', '12411764', '11176470', '宏信证券有限责任公司', '青岛海尔创业投资有限责任公司', '深圳国调招商并购股权投资基金合伙企业(有限合伙)', '14705882', '360999998', '金元顺安基金管理有限公司', '安徽省中安健康养老服务产业投资合伙企业(有限合伙)', '安信基金管理有限责任公司', '21235294', '12'}",16568972,2,"{'249999994', '210999988'}",9,"{'宏信证券有限责任公司', '青岛海尔创业投资有限责任公司', '现金', '深圳天风天成资产管理有限公司', '易方达基金管理有限公司', '金元顺安基金管理有限公司', '竞价', '安信基金管理有限责任公司', '12'}",24,"{'51500038', '189999990', '江苏一带一路投资基金(有限合伙)', '深圳天风天成资产管理有限公司', '易方达基金管理有限公司', '3029414', '199999985', '现金', '10617647', '竞价', '180499999', '11764705', '12411764', '11176470', '宏信证券有限责任公司', '青岛海尔创业投资有限责任公司', '深圳国调招商并购股权投资基金合伙企业(有限合伙)', '14705882', '360999998', '金元顺安基金管理有限公司', '安徽省中安健康养老服务产业投资合伙企业(有限合伙)', '安信基金管理有限责任公司', '21235294', '12'}"
7,"{'孔鑫明', '现金', '19305000', '工银瑞信投资管理有限公司', '154440000', '丁航飞', '36'}",343253,1,{'154440000'},5,"{'孔鑫明', '现金', '工银瑞信投资管理有限公司', '丁航飞', '36'}",6,"{'孔鑫明', '现金', '19305000', '工银瑞信投资管理有限公司', '丁航飞', '36'}"
17,"{'36450000', '40500000', '81000000', '现金', '5000000', '4500000', '上海成丰鼎泰股权投资合伙企业(有限合伙)', '吴熹', '常州市久益股权投资中心(有限合伙)', '42289913.7', '李绍君', '竞价', '5220977', '10000000', '12', '富通银行', '海富通基金管理有限公司'}",1258169,3,"{'竞价', '5220977', '4500000'}",6,"{'现金', '吴熹', '李绍君', '12', '富通银行', '海富通基金管理有限公司'}",14,"{'36450000', '40500000', '81000000', '现金', '5000000', '上海成丰鼎泰股权投资合伙企业(有限合伙)', '吴熹', '常州市久益股权投资中心(有限合伙)', '42289913.7', '李绍君', '10000000', '12', '富通银行', '海富通基金管理有限公司'}"
4,"{'山钢集团', '现金', '竞价', '36'}",305825,0,set(),4,"{'山钢集团', '现金', '竞价', '36'}",4,"{'山钢集团', '现金', '竞价', '36'}"
18,"{'99818000', '65398000', '5000000', '现金', '兴业全球基金管理有限公司', '726438', '1900000', '2900000', '华林证券有限责任公司', '国泰基金管理有限公司', '中银基金管理有限公司', '72282000', '2100000', '西藏山南世纪金源投资管理有限公司', '泰康资产管理有限责任公司', '172100000', '12', '25003995.96'}",1031392,9,"{'65398000', '99818000', '5000000', '726438', '2900000', '西藏山南世纪金源投资管理有限公司', '72282000', '172100000', '25003995.96'}",2,"{'现金', '12'}",9,"{'现金', '兴业全球基金管理有限公司', '1900000', '华林证券有限责任公司', '国泰基金管理有限公司', '中银基金管理有限公司', '2100000', '泰康资产管理有限责任公司', '12'}"
4,"{'东塑集团', '竞价', '现金', '36'}",1171314,1,{'竞价'},3,"{'东塑集团', '现金', '36'}",3,"{'东塑集团', '现金', '36'}"
13,"{'现金', '14554794', '13698630', '定价', '重庆信三威', '范晓东', '11130136', '159999998.4', '新疆广泰', '129999988.5', '杨森', '169999993.9', '36'}",1600895,1,{'129999988.5'},7,"{'36', '现金', '定价', '范晓东', '重庆信三威', '新疆广泰', '杨森'}",12,"{'现金', '14554794', '13698630', '定价', '重庆信三威', '范晓东', '11130136', '159999998.4', '新疆广泰', '杨森', '169999993.9', '36'}"
17,"{'42462845', '116772824', '现金', '95541401', '宁波赛特', '定价', '449999998.7', '华侨城集团', '南京创毅', '297239915', '北京云世纪', '1400000000', '北京云诺', '微鲸科技', '200000000', '550000001', '36'}",2235246,1,{'200000000'},9,"{'现金', '宁波赛特', '定价', '华侨城集团', '南京创毅', '北京云诺', '微鲸科技', '北京云世纪', '36'}",16,"{'42462845', '116772824', '现金', '95541401', '宁波赛特', '定价', '449999998.7', '华侨城集团', '南京创毅', '297239915', '1400000000', '北京云诺', '微鲸科技', '北京云世纪', '550000001', '36'}"
19,"{'上海密列恩投资管理合伙企业(有限合伙)', '4500000', '6600000', '李宁', '兴业全球基金管理有限公司', '4700000', '4400000', '4000000', '天津凯石富利股权投资基金合伙企业(有限合伙)', '中广核财务有限责任公司', '7000000', '5500000', '1211658', '竞价', '天津硅谷天堂鹏瑞股权投资基金合伙企业(有限合伙)', '孙伟琦', '江苏瑞华投资控股集团有限公司', '刘世峰', '华鑫国际信托有限公司'}",213390,3,"{'竞价', '1211658', '6600000'}",0,set(),16,"{'上海密列恩投资管理合伙企业(有限合伙)', '4500000', '兴业全球基金管理有限公司', '李宁', '天津凯石富利股权投资基金合伙企业(有限合伙)', '4700000', '4400000', '4000000', '中广核财务有限责任公司', '7000000', '5500000', '天津硅谷天堂鹏瑞股权投资基金合伙企业(有限合伙)', '孙伟琦', '江苏瑞华投资控股集团有限公司', '刘世峰', '华鑫国际信托有限公司'}"
22,"{'12000000', '吴光蓉', '顾斌', '4268500', '7000000', '6000000', '8000000', '现金', '10000000', '3600000', '高建明', '5500000', '1500000', '郭忠河', '杨学平', '厦门三微投资管理股份有限公司', '何小丽', '孙汉宗', '王丽娟', '陈建煌', '7200000', '36'}",1163329,7,"{'12000000', '4268500', '7000000', '5500000', '7200000', '10000000', '3600000'}",13,"{'吴光蓉', '何小丽', '现金', '顾斌', '孙汉宗', '王丽娟', '高建明', '1500000', '陈建煌', '郭忠河', '杨学平', '厦门三微投资管理股份有限公司', '36'}",15,"{'吴光蓉', '现金', '何小丽', '顾斌', '孙汉宗', '王丽娟', '高建明', '1500000', '陈建煌', '郭忠河', '杨学平', '6000000', '8000000', '厦门三微投资管理股份有限公司', '36'}"
7,"{'173999966', '北部湾港务集团', '防城港务集团', '516026983', '定价', '股权', '36'}",1084020,0,set(),5,"{'北部湾港务集团', '防城港务集团', '定价', '股权', '36'}",7,"{'173999966', '北部湾港务集团', '防城港务集团', '516026983', '定价', '股权', '36'}"
15,"{'12208657', '杨相如', '现金', '北信瑞丰基金管理有限公司', '圆信永丰基金管理有限公司', '大成基金管理有限公司', '11098779', '易方达基金管理有限公司', '6083797', '竞价', '11764705', '16648168', '贵州铁路人保壹期壹号股权投资基金中心(有限合伙)', '12', '西藏泓涵股权投资管理有限公司'}",16345743,1,{'竞价'},8,"{'杨相如', '现金', '北信瑞丰基金管理有限公司', '圆信永丰基金管理有限公司', '大成基金管理有限公司', '易方达基金管理有限公司', '12', '西藏泓涵股权投资管理有限公司'}",14,"{'12208657', '杨相如', '现金', '北信瑞丰基金管理有限公司', '圆信永丰基金管理有限公司', '大成基金管理有限公司', '11098779', '易方达基金管理有限公司', '6083797', '11764705', '16648168', '贵州铁路人保壹期壹号股权投资基金中心(有限合伙)', '12', '西藏泓涵股权投资管理有限公司'}"
17,"{'现金', '单银木', '70000000', '杨强跃', '单际华', '2000000', '许荣根', '1500000', '3000000', '陆拥军', '寿林平', '刘安贵', '郑红梅', '1000000', '刘亮俊', '36', '7500000'}",1053629,6,"{'70000000', '2000000', '1500000', '3000000', '1000000', '7500000'}",11,"{'36', '现金', '单银木', '杨强跃', '许荣根', '寿林平', '刘安贵', '郑红梅', '刘亮俊', '单际华', '陆拥军'}",11,"{'36', '现金', '单银木', '杨强跃', '许荣根', '寿林平', '刘安贵', '郑红梅', '刘亮俊', '单际华', '陆拥军'}"
15,"{'招商财富资产管理有限公司', '101576182', '157618213', '方正富邦基金管理有限公司', '52539404', '博时基金管理有限公司', '东海基金管理有限责任公司', '财通基金管理有限公司', '1138356', '83099824', '57793345', '泰达宏利基金管理有限公司', '申万菱信基金管理有限公', '71628721', '12'}",95895,0,set(),8,"{'招商财富资产管理有限公司', '方正富邦基金管理有限公司', '博时基金管理有限公司', '东海基金管理有限责任公司', '财通基金管理有限公司', '泰达宏利基金管理有限公司', '申万菱信基金管理有限公', '12'}",15,"{'招商财富资产管理有限公司', '101576182', '157618213', '方正富邦基金管理有限公司', '52539404', '博时基金管理有限公司', '东海基金管理有限责任公司', '财通基金管理有限公司', '1138356', '83099824', '57793345', '泰达宏利基金管理有限公司', '申万菱信基金管理有限公', '71628721', '12'}"
4,"{'定价', '北京医药集团有限责任公司', '36', '21000000'}",1109308,1,{'21000000'},3,"{'定价', '北京医药集团有限责任公司', '36'}",3,"{'定价', '北京医药集团有限责任公司', '36'}"
10,"{'兵装集团', '326095500', '148295800', '现金', '股权', '定价', '上海长威', '1125000000', '36', '南方资产'}",15489667,3,"{'326095500', '148295800', '1125000000'}",7,"{'兵装集团', '现金', '定价', '上海长威', '股权', '36', '南方资产'}",7,"{'兵装集团', '现金', '定价', '上海长威', '股权', '36', '南方资产'}"
3,"{'远致投资', '36', '深圳市国资委'}",210768,0,set(),3,"{'远致投资', '36', '深圳市国资委'}",3,"{'远致投资', '36', '深圳市国资委'}"
14,"{'中国建材股份有限公司', '江西省冶电能源配送有限公司', '现金', '6364671', '江西华新实业有限公司', '4000000', '定价', '长江证券有限责任公司', '杭州金贝尔投资有限公司', '华宝信托有限责任公司', '3000000', '6000000', '10000000', '12'}",818996,0,set(),4,"{'定价', '现金', '12', '中国建材股份有限公司'}",14,"{'中国建材股份有限公司', '江西省冶电能源配送有限公司', '6364671', '现金', '江西华新实业有限公司', '4000000', '长江证券有限责任公司', '定价', '杭州金贝尔投资有限公司', '华宝信托有限责任公司', '3000000', '6000000', '10000000', '12'}"
16,"{'现金', '喜临门2015年度第一期员工持股计划', '100000000', '定价', '15711480', '徐荣华', '1040000000', '12140689', '170000000', '王渤', '7141582', '华易投资', '74272451', '刘宇', '220000000', '36'}",1747817,3,"{'1040000000', '170000000', '220000000'}",8,"{'现金', '喜临门2015年度第一期员工持股计划', '定价', '徐荣华', '刘宇', '华易投资', '王渤', '36'}",13,"{'36', '现金', '喜临门2015年度第一期员工持股计划', '100000000', '74272451', '定价', '15711480', '徐荣华', '7141582', '刘宇', '华易投资', '王渤', '12140689'}"
13,"{'4219409', '现金', '李俊英', '罗明远', '定价', '晋商联盟', '63291139', '中铁宇丰', '6329114', '常青藤联创', '李冰侠', '36', '42194093'}",675840,4,"{'4219409', '63291139', '42194093', '6329114'}",9,"{'36', '现金', '李俊英', '罗明远', '定价', '晋商联盟', '中铁宇丰', '李冰侠', '常青藤联创'}",9,"{'现金', '李俊英', '罗明远', '定价', '晋商联盟', '中铁宇丰', '常青藤联创', '李冰侠', '36'}"
5,"{'现金', '70000000', '竞价', '郭留希', '36'}",373431,2,"{'竞价', '70000000'}",3,"{'36', '郭留希', '现金'}",3,"{'36', '郭留希', '现金'}"
23,"{'41088000', '4800000', '8000000', '5000000', '现金', '定价', '4900000', '王宏涛', '41944000', '虞文雅', '40799998.8', '国泰基金管理有限公司', '4766355', '中信证券股份有限公司', '42800000', '68480000', '9500000', '上海哲熙投资管理合伙企业(有限合伙)', '张萍', '81320000', '深圳市中信联合创业投资有限公司', '博弘数君(天津)股权投资基金合伙企业(有限合伙)', '12'}",506438,0,set(),8,"{'现金', '定价', '张萍', '深圳市中信联合创业投资有限公司', '王宏涛', '中信证券股份有限公司', '虞文雅', '12'}",23,"{'41088000', '4800000', '8000000', '5000000', '现金', '定价', '4900000', '王宏涛', '41944000', '虞文雅', '40799998.8', '4766355', '国泰基金管理有限公司', '中信证券股份有限公司', '42800000', '68480000', '9500000', '上海哲熙投资管理合伙企业(有限合伙)', '张萍', '81320000', '深圳市中信联合创业投资有限公司', '博弘数君(天津)股权投资基金合伙企业(有限合伙)', '12'}"
3,"{'36', '现金', '上海紫江(集团)有限公司'}",476458,0,set(),2,"{'现金', '36'}",3,"{'36', '现金', '上海紫江(集团)有限公司'}"
12,"{'176263219', '现金', '117508813', '235017626', '定价', '国开投资发展', '国开金融', '中车集团', '705052878', '兴瀚资管', '上海招银', '36'}",15653750,2,"{'705052878', '117508813'}",8,"{'现金', '国开投资发展', '定价', '国开金融', '兴瀚资管', '中车集团', '上海招银', '36'}",10,"{'176263219', '现金', '235017626', '国开投资发展', '定价', '国开金融', '中车集团', '兴瀚资管', '上海招银', '36'}"
8,"{'现金', '300343725', '466734148.7', '西藏海涵交通发展有限公司', '西藏天圣交通发展投资有限公司', '140160405', '1000144604', '36'}",1233309,1,{'466734148.7'},4,"{'西藏海涵交通发展有限公司', '现金', '西藏天圣交通发展投资有限公司', '36'}",7,"{'现金', '300343725', '西藏海涵交通发展有限公司', '西藏天圣交通发展投资有限公司', '140160405', '1000144604', '36'}"
17,"{'北京苏里曼医药科技有限公司', '5000000', '现金', '上海金鼎房地产有限公司', '12', '13000000', '4000000', '中国人民财产保险股份有限公司', '福州茂隆石制品有限公司', '南京五台化工有限公司', '三峡财务有限责任公司', '北京浩成投资管理有限公司', '2000000', '宜昌泰兴化工有限公司', '3000000', '36', '宜昌兴发集团有限责任公司'}",537365,3,"{'4000000', '13000000', '2000000'}",12,"{'北京苏里曼医药科技有限公司', '现金', '上海金鼎房地产有限公司', '12', '中国人民财产保险股份有限公司', '福州茂隆石制品有限公司', '南京五台化工有限公司', '三峡财务有限责任公司', '北京浩成投资管理有限公司', '宜昌泰兴化工有限公司', '36', '宜昌兴发集团有限责任公司'}",14,"{'北京苏里曼医药科技有限公司', '5000000', '现金', '上海金鼎房地产有限公司', '12', '中国人民财产保险股份有限公司', '福州茂隆石制品有限公司', '南京五台化工有限公司', '三峡财务有限责任公司', '北京浩成投资管理有限公司', '宜昌泰兴化工有限公司', '3000000', '36', '宜昌兴发集团有限责任公司'}"
4,"{'晋西工业集团有限责任公司', '竞价', '现金', '36'}",164539,0,set(),4,"{'晋西工业集团有限责任公司', '竞价', '现金', '36'}",4,"{'晋西工业集团有限责任公司', '竞价', '现金', '36'}"
17,"{'2473498', '上海珀麓投资管理中心(有限合伙)', '王芳', '周希俭', '定价', '陈斌', '21000000', '52000000', '50000000', '17000000', '3533568', '5889281', '2002355', '王兵', '30000000', '36', '6124852'}",1843903,9,"{'2473498', '21000000', '52000000', '50000000', '17000000', '3533568', '5889281', '30000000', '6124852'}",6,"{'王芳', '周希俭', '定价', '陈斌', '王兵', '36'}",8,"{'王芳', '上海珀麓投资管理中心(有限合伙)', '周希俭', '定价', '陈斌', '2002355', '王兵', '36'}"
5,"{'现金', '11918455941', '2462490897', '中国烟草总公司', '36'}",325528,2,"{'11918455941', '2462490897'}",3,"{'现金', '36', '中国烟草总公司'}",3,"{'现金', '36', '中国烟草总公司'}"
25,"{'27856736', '上海通映投资中心(有限合伙)', '68561682', '28425241', '深圳名正信融股权投资企业(有限合伙)', '现金', '1206000000', '宁波智度五云股权投资合伙企业(有限合伙)', '竞价', '300000000', '19897669', '490000000', '北京天晟泰合创业投资中心(有限合伙)', '450000000', '浙江灿翔实业投资有限公司', '上海德符投资中心(有限合伙)', '17055144', '25582717', '上海仰添投资中心(有限合伙)', '350000000', '宁波骏丰股权投资合伙企业(有限合伙)', '上海修敬资产管理中心(有限合伙)', '温州成嘉股权投资合伙企业(有限合伙)', '500000000', '36'}",1787575,6,"{'490000000', '1206000000', '450000000', '350000000', '竞价', '500000000'}",3,"{'现金', '36', '浙江灿翔实业投资有限公司'}",19,"{'27856736', '深圳名正信融股权投资企业(有限合伙)', '现金', '北京天晟泰合创业投资中心(有限合伙)', '宁波智度五云股权投资合伙企业(有限合伙)', '上海仰添投资中心(有限合伙)', '浙江灿翔实业投资有限公司', '宁波骏丰股权投资合伙企业(有限合伙)', '上海通映投资中心(有限合伙)', '68561682', '300000000', '上海修敬资产管理中心(有限合伙)', '28425241', '温州成嘉股权投资合伙企业(有限合伙)', '19897669', '上海德符投资中心(有限合伙)', '17055144', '36', '25582717'}"
18,"{'6176470', '5000000', '85000000', '北信瑞丰基金管理有限公司', '3735295', '创金合信基金管理有限公司', '127000030', '172999990', '华宝信托有限责任公司', '5088235', '竞价', '170000000', '方凯燕', '李琦', '209999980', '戴勇宣', '12', '2500000'}",9880779,1,{'竞价'},7,"{'北信瑞丰基金管理有限公司', '创金合信基金管理有限公司', '华宝信托有限责任公司', '方凯燕', '李琦', '戴勇宣', '12'}",17,"{'6176470', '5000000', '85000000', '北信瑞丰基金管理有限公司', '3735295', '创金合信基金管理有限公司', '127000030', '172999990', '华宝信托有限责任公司', '5088235', '170000000', '方凯燕', '李琦', '209999980', '戴勇宣', '12', '2500000'}"
4,"{'海航商业控股', '竞价', '现金', '36'}",212493,0,set(),4,"{'海航商业控股', '竞价', '现金', '36'}",4,"{'海航商业控股', '竞价', '现金', '36'}"
5,"{'现金', '64000000', '竞价', '滨州市国资经营公司', '36'}",398750,1,{'64000000'},4,"{'滨州市国资经营公司', '竞价', '现金', '36'}",4,"{'滨州市国资经营公司', '竞价', '现金', '36'}"
21,"{'20000000', '申万菱信(上海)资产管理有限公司', '99999997.31', '黑龙江宝泰隆煤化工集团有限公司', '170200000', '208905505.4', '18000000', '鹏华资产管理(深圳)有限公司', '五矿证券有限公司', '36', '169774500', '焦阳洋', '隋熙明', '中信证券股份有限公司', '11750881', '24548238', '长江证券股份有限公司', '中国人寿资产管理有限公司', '19950000', '153180000', '12'}",1561192,1,{'208905505.4'},9,"{'36', '焦阳洋', '隋熙明', '五矿证券有限公司', '长江证券股份有限公司', '中信证券股份有限公司', '中国人寿资产管理有限公司', '12', '黑龙江宝泰隆煤化工集团有限公司'}",20,"{'24548238', '20000000', '170200000', '169774500', '12', '焦阳洋', '18000000', '隋熙明', '五矿证券有限公司', '长江证券股份有限公司', '申万菱信(上海)资产管理有限公司', '中信证券股份有限公司', '11750881', '中国人寿资产管理有限公司', '99999997.31', '19950000', '153180000', '鹏华资产管理(深圳)有限公司', '36', '黑龙江宝泰隆煤化工集团有限公司'}"
7,"{'现金', '23500000', '定价', '1500000', '西安航天科技工业公司', '西北有色金属研究院', '36'}",1270507,0,set(),3,"{'现金', '定价', '36'}",7,"{'现金', '23500000', '定价', '1500000', '西安航天科技工业公司', '西北有色金属研究院', '36'}"
10,"{'22514600', '现金', '118670585', '彭韬', '潘利斌', '23000000', '21000000', '姚芳媛', '36', '朱蓉娟'}",8532,0,set(),6,"{'现金', '彭韬', '潘利斌', '姚芳媛', '36', '朱蓉娟'}",10,"{'22514600', '现金', '118670585', '彭韬', '潘利斌', '23000000', '21000000', '姚芳媛', '36', '朱蓉娟'}"
11,"{'1883499933', '现金', '王薇', '2881500000', '555604700', '新理益集团', '5085000000', '850000000', '1500000000', '36', '刘益谦'}",282879,0,set(),5,"{'现金', '王薇', '新理益集团', '36', '刘益谦'}",11,"{'1883499933', '36', '现金', '2881500000', '555604700', '新理益集团', '5085000000', '850000000', '1500000000', '王薇', '刘益谦'}"
21,"{'32755632', '12287694', '15597920', '石河子城市建设投资经营有限公司', '141799988.8', '12', '定价', '财通基金管理有限公司', '万家共赢资产管理有限公司', '15615251', '石河子国资资本运营有限公司', '金石期货有限公司', '信诚基金管理有限公司', '377999993.3', '179999996.8', '199999993.9', '180199996.5', '359999993.6', '17331022', '31195840', '海富通基金管理有限公司'}",14046736,3,"{'377999993.3', '141799988.8', '199999993.9'}",3,"{'定价', '石河子城市建设投资经营有限公司', '12'}",18,"{'15615251', '31195840', '石河子城市建设投资经营有限公司', '石河子国资资本运营有限公司', '金石期货有限公司', '信诚基金管理有限公司', '179999996.8', '定价', '32755632', '财通基金管理有限公司', '17331022', '12287694', '180199996.5', '15597920', '359999993.6', '万家共赢资产管理有限公司', '12', '海富通基金管理有限公司'}"
9,"{'现金', '67491563', '600000000', '定价', '112485939', '1000000000', '北方工业', '36', '前海人寿'}",1603647,4,"{'1000000000', '112485939', '67491563', '600000000'}",5,"{'现金', '定价', '北方工业', '36', '前海人寿'}",5,"{'现金', '定价', '北方工业', '36', '前海人寿'}"
12,"{'国光电器股份有限公司第一期员工持股计划', '现金', '高歌平', '5402200', '润垚国光定增投资基金1号', '52000000', '5977011', '3448275', '47000000', '周海昌', '30000000', '36'}",2094412,2,"{'52000000', '47000000'}",5,"{'国光电器股份有限公司第一期员工持股计划', '现金', '高歌平', '周海昌', '36'}",10,"{'国光电器股份有限公司第一期员工持股计划', '高歌平', '现金', '润垚国光定增投资基金1号', '5977011', '3448275', '5402200', '周海昌', '30000000', '36'}"
7,"{'现金', '900000000', '401700000', '闽西兴杭', '竞价', '36', '紫金矿业第一期员工持股计划'}",15491611,3,"{'竞价', '900000000', '401700000'}",4,"{'紫金矿业第一期员工持股计划', '现金', '36', '闽西兴杭'}",4,"{'紫金矿业第一期员工持股计划', '现金', '36', '闽西兴杭'}"
5,"{'现金', '竞价', '1500000000', '祥毅投资', '36'}",1647630,1,{'1500000000'},4,"{'祥毅投资', '竞价', '现金', '36'}",4,"{'祥毅投资', '竞价', '现金', '36'}"
19,"{'平安大华永智1号特定客户资产管理计划', '王敏桦', '8821387', '现金', '11593823', '胡红湘', '4536713', '定价', '福州兴合投资管理有限公司', '38924997.54', '17441142', '149644998.4', '22179487', '190299998.5', '75687500.46', '99475001.34', '福建新一代信息技术创业投资有限合伙企业', '36', '福建省电子信息(集团)有限责任公司'}",2362378,5,"{'149644998.4', '38924997.54', '190299998.5', '75687500.46', '99475001.34'}",6,"{'36', '现金', '胡红湘', '定价', '福建新一代信息技术创业投资有限合伙企业', '王敏桦'}",14,"{'平安大华永智1号特定客户资产管理计划', '王敏桦', '8821387', '11593823', '胡红湘', '现金', '4536713', '定价', '福州兴合投资管理有限公司', '22179487', '17441142', '福建新一代信息技术创业投资有限合伙企业', '36', '福建省电子信息(集团)有限责任公司'}"
15,"{'5000000', '14500000', '1375389', '江苏瑞华投资发展有限公司', '华夏基金管理有限公司', '铁岭新鑫铜业有限公司', '上海成丰鼎泰股权投资合伙企业(有限合伙)', '4000000', '7000000', '西藏自治区投资有限公司', '国泰基金管理有限公司', '竞价', '3000000', '浙江宝兴股权投资合伙企业(有限合伙)', '12'}",1459519,0,set(),4,"{'国泰基金管理有限公司', '竞价', '12', '华夏基金管理有限公司'}",15,"{'5000000', '14500000', '1375389', '江苏瑞华投资发展有限公司', '华夏基金管理有限公司', '铁岭新鑫铜业有限公司', '上海成丰鼎泰股权投资合伙企业(有限合伙)', '4000000', '7000000', '西藏自治区投资有限公司', '国泰基金管理有限公司', '竞价', '3000000', '浙江宝兴股权投资合伙企业(有限合伙)', '12'}"
4,"{'四川长虹电器股份有限公司', '竞价', '现金', '36'}",1817132,0,set(),4,"{'四川长虹电器股份有限公司', '竞价', '现金', '36'}",4,"{'四川长虹电器股份有限公司', '竞价', '现金', '36'}"
5,"{'祺禧投资', '现金', '浙报控股', '竞价', '36'}",149251,0,set(),5,"{'祺禧投资', '现金', '浙报控股', '竞价', '36'}",5,"{'祺禧投资', '现金', '浙报控股', '竞价', '36'}"
26,"{'20000000', '3000000', '50000000', '前海开源基金管理有限公司', '5000000', '南京高科股份有限公司', '39960000', '10000000', '陈国鹰', '上海理顺投资管理合伙企业(有限合伙)', '999000000', '金圆资本管理(厦门)有限公司', '399600000', '15000000', '99900000', '皓熙股权投资管理(上海)有限公司', '59940000', '25000000', '福建省稀有稀土(集团)有限公司', '柯希平', '福建省投资开发集团有限责任公司', '499500000', '2000000', '299700000', '199800000', '36'}",298424,8,"{'399600000', '499500000', '99900000', '59940000', '39960000', '299700000', '199800000', '999000000'}",6,"{'福建省投资开发集团有限责任公司', '南京高科股份有限公司', '陈国鹰', '前海开源基金管理有限公司', '36', '柯希平'}",18,"{'20000000', '5000000', '金圆资本管理(厦门)有限公司', '福建省稀有稀土(集团)有限公司', '15000000', '福建省投资开发集团有限责任公司', '皓熙股权投资管理(上海)有限公司', '2000000', '南京高科股份有限公司', '3000000', '50000000', '25000000', '10000000', '陈国鹰', '前海开源基金管理有限公司', '上海理顺投资管理合伙企业(有限合伙)', '36', '柯希平'}"
16,"{'6666666', '金鹰基金管理有限公司', '现金', '36000000', '浙江浙商证券资产管理有限公司', '兴业全球基金管理有限公司', '4000000', '国联安基金管理有限公司', '财通基金管理有限公司', '2666670', '竞价', '59999994', '创金合信基金管理有限公司', '华富基金管理有限公司', '12', '24000030'}",79031,7,"{'6666666', '36000000', '4000000', '2666670', '竞价', '59999994', '24000030'}",9,"{'金鹰基金管理有限公司', '现金', '浙江浙商证券资产管理有限公司', '兴业全球基金管理有限公司', '国联安基金管理有限公司', '财通基金管理有限公司', '创金合信基金管理有限公司', '华富基金管理有限公司', '12'}",9,"{'金鹰基金管理有限公司', '现金', '浙江浙商证券资产管理有限公司', '兴业全球基金管理有限公司', '国联安基金管理有限公司', '财通基金管理有限公司', '创金合信基金管理有限公司', '华富基金管理有限公司', '12'}"
6,"{'97718328', '现金', '定价', '1500000000', '瑞丽金泽', '36'}",10112,2,"{'97718328', '1500000000'}",4,"{'定价', '现金', '36', '瑞丽金泽'}",4,"{'定价', '现金', '36', '瑞丽金泽'}"
10,"{'现金', '10135013', '张轩松', '定价', '112600000', '朗源股份', '上海糖酒', '36', '790452000', '71147794'}",407624,2,"{'112600000', '790452000'}",5,"{'现金', '张轩松', '定价', '朗源股份', '上海糖酒'}",8,"{'现金', '10135013', '张轩松', '定价', '朗源股份', '上海糖酒', '36', '71147794'}"
22,"{'易方达基金管理有限公司', '申万菱信基金管理有限公司', '123999988.1', '12262415', '中国银河投资管理有限公司', '209999992.2', '竞价', '12630288', '博时基金管理有限公司', '539999977.5', '205999997.3', '招商财富资产管理有限公司', '319999998.2', '33108521', '7602697', '199999988.7', '12875536', '19619865', '创金合信基金管理有限公司', '中广核资本控股有限公司', '华安未来资产管理(上海)有限公司', '12'}",1821283,6,"{'319999998.2', '209999992.2', '199999988.7', '竞价', '123999988.1', '205999997.3'}",1,{'12'},16,"{'招商财富资产管理有限公司', '12630288', '33108521', '中广核资本控股有限公司', '博时基金管理有限公司', '中国银河投资管理有限公司', '7602697', '12875536', '易方达基金管理有限公司', '539999977.5', '19619865', '申万菱信基金管理有限公司', '创金合信基金管理有限公司', '12262415', '华安未来资产管理(上海)有限公司', '12'}"
24,"{'47600000', '11600000', '4000000', '3300000', '70422000', '100298000', '现金', '陈长宝', '4700000', '定价', '祝文闻', '85360000', '郭伟', '168586000', '桂国才', '饶陆华', '深圳市国银资本投资管理有限公司-国银资本稳健1号证券投资基金', '1015784000', '7900000', '247544000', '孙俊', '212973200', '9980000', '36'}",4940563,14,"{'47600000', '4700000', '11600000', '3300000', '70422000', '4000000', '1015784000', '85360000', '7900000', '247544000', '212973200', '9980000', '168586000', '100298000'}",9,"{'陈长宝', '饶陆华', '现金', '孙俊', '定价', '祝文闻', '郭伟', '36', '桂国才'}",10,"{'陈长宝', '现金', '饶陆华', '深圳市国银资本投资管理有限公司-国银资本稳健1号证券投资基金', '孙俊', '定价', '祝文闻', '郭伟', '36', '桂国才'}"
5,"{'现金', '华夏基金管理有限公司', '6000000', '华商基金管理有限公司', '12'}",1496798,0,set(),2,"{'现金', '12'}",5,"{'现金', '华夏基金管理有限公司', '6000000', '华商基金管理有限公司', '12'}"
4,"{'竞价', '现金', '36', '张洪起'}",1814122,0,set(),4,"{'竞价', '现金', '36', '张洪起'}",4,"{'竞价', '现金', '36', '张洪起'}"
5,"{'150000000', '675000000', '现金', '兰州亚太工贸集团有限公司', '36'}",11216,1,{'675000000'},3,"{'兰州亚太工贸集团有限公司', '现金', '36'}",4,"{'150000000', '兰州亚太工贸集团有限公司', '现金', '36'}"
3,"{'当代科技', '现金', '36'}",1263297,0,set(),3,"{'当代科技', '现金', '36'}",3,"{'当代科技', '现金', '36'}"
12,"{'现金', '建投传媒', '14540167', '36350418', '鼎鹿中原', '7270083', '朱雀投资', '北京瓦力', '泰康资产', '1817521', '36', '12722646'}",345779,0,set(),7,"{'现金', '建投传媒', '鼎鹿中原', '朱雀投资', '北京瓦力', '泰康资产', '36'}",12,"{'现金', '建投传媒', '14540167', '36350418', '鼎鹿中原', '7270083', '朱雀投资', '北京瓦力', '泰康资产', '1817521', '36', '12722646'}"
30,"{'7442400', '7104100', '106999810', '115489442', '安泰创业投资(深圳)有限公司', '泰达宏利基金管理有限公司', '7239500', '现金', '财通基金管理有限公司', '竞价', '9607500', '5718300', '10148800', '平安大华基金管理有限公司', '北信瑞丰基金管理有限公司', '博时基金管理有限公司', '104998598', '149999264', '109998672', '8592600', '招商财富资产管理有限公司', '84516474', '141998850', '7813900', '7374800', '广西铁路发展投资基金(有限合伙)', '中新建招商股权投资有限公司', '108999544', '12', '126998628'}",14878519,1,{'竞价'},9,"{'招商财富资产管理有限公司', '平安大华基金管理有限公司', '现金', '北信瑞丰基金管理有限公司', '博时基金管理有限公司', '泰达宏利基金管理有限公司', '财通基金管理有限公司', '中新建招商股权投资有限公司', '12'}",29,"{'7442400', '7104100', '106999810', '115489442', '泰达宏利基金管理有限公司', '安泰创业投资(深圳)有限公司', '7239500', '现金', '财通基金管理有限公司', '9607500', '5718300', '10148800', '平安大华基金管理有限公司', '北信瑞丰基金管理有限公司', '博时基金管理有限公司', '104998598', '149999264', '109998672', '8592600', '招商财富资产管理有限公司', '84516474', '141998850', '7813900', '7374800', '广西铁路发展投资基金(有限合伙)', '中新建招商股权投资有限公司', '108999544', '12', '126998628'}"
5,"{'现金', '132422938', '竞价', '河南黄河实业集团股份有限公司', '36'}",1129205,2,"{'竞价', '132422938'}",3,"{'现金', '河南黄河实业集团股份有限公司', '36'}",3,"{'现金', '河南黄河实业集团股份有限公司', '36'}"
10,"{'229400018.6', '14575936', '第一创业证券股份有限公司', '鹏华资产管理有限公司', '213999984.9', '443399973.1', '7034845', '7541092', '财通基金管理有限公司', '12'}",15838206,0,set(),2,"{'12', '财通基金管理有限公司'}",10,"{'229400018.6', '14575936', '第一创业证券股份有限公司', '鹏华资产管理有限公司', '213999984.9', '443399973.1', '7034845', '7541092', '财通基金管理有限公司', '12'}"
12,"{'4800000', '现金', '4882400', '吴光蓉', '2200000', '定价', '2000000', '赵宝', '魏敏钗', '周万沅', '浙江方正房地产开发有限公司', '36'}",1183612,0,set(),8,"{'36', '吴光蓉', '现金', '定价', '魏敏钗', '周万沅', '浙江方正房地产开发有限公司', '赵宝'}",12,"{'4800000', '现金', '4882400', '吴光蓉', '2200000', '定价', '2000000', '赵宝', '魏敏钗', '周万沅', '浙江方正房地产开发有限公司', '36'}"
11,"{'石莉', '19458642', '博创金甬', '定价', '上海静观', '9729321', '南通富海', '10702254', '96806745.42', '193613490.8', '106487420'}",2234292,2,"{'96806745.42', '106487420'}",5,"{'石莉', '定价', '博创金甬', '上海静观', '南通富海'}",9,"{'石莉', '19458642', '博创金甬', '上海静观', '定价', '9729321', '南通富海', '10702254', '193613490.8'}"
19,"{'上海电气集团财务有限责任公司', '5000000', '现金', '东航集团财务有限责任公司', '3500000', '张怀斌', '15332030', '12', '7000000', '3700000', '中国长城资产管理公司', '竞价', '上海丹晟投资管理合伙企业(有限合伙)', '渤海证券股份有限公司', '东吴证券股份有限公司', '3600000', '南京盛宇投资管理有限公司', '36', '安徽丰原集团有限公司'}",719454,1,{'竞价'},11,"{'上海电气集团财务有限责任公司', '36', '现金', '东航集团财务有限责任公司', '中国长城资产管理公司', '渤海证券股份有限公司', '东吴证券股份有限公司', '张怀斌', '南京盛宇投资管理有限公司', '12', '安徽丰原集团有限公司'}",18,"{'上海电气集团财务有限责任公司', '5000000', '现金', '东航集团财务有限责任公司', '3500000', '张怀斌', '15332030', '12', '7000000', '3700000', '中国长城资产管理公司', '渤海证券股份有限公司', '上海丹晟投资管理合伙企业(有限合伙)', '东吴证券股份有限公司', '3600000', '南京盛宇投资管理有限公司', '36', '安徽丰原集团有限公司'}"
13,"{'30000000000', '江苏瑞华投资发展有限公司', '王桂芬', '52000000000', '32000000000', '易方达基金管理有限公司', '16747960000', '广东恒健资本管理有限公司', '济南北安投资有限公司', '33000000000', '53000000000', '12', '江苏开元国际集团轻工业品进出口股份有限公司'}",1239600,4,"{'53000000000', '16747960000', '33000000000', '32000000000'}",7,"{'江苏瑞华投资发展有限公司', '王桂芬', '易方达基金管理有限公司', '广东恒健资本管理有限公司', '济南北安投资有限公司', '12', '江苏开元国际集团轻工业品进出口股份有限公司'}",9,"{'30000000000', '江苏瑞华投资发展有限公司', '王桂芬', '52000000000', '易方达基金管理有限公司', '广东恒健资本管理有限公司', '济南北安投资有限公司', '12', '江苏开元国际集团轻工业品进出口股份有限公司'}"
11,"{'卓创众银', '宁波赛客', '现金', '赛伯乐集团', '宁波赛特', '定价', '债权、现金', '北京兴诚旺', '南京创毅', '北京云诺', '36'}",350310,1,{'债权、现金'},10,"{'卓创众银', '宁波赛客', '现金', '赛伯乐集团', '宁波赛特', '定价', '北京兴诚旺', '南京创毅', '北京云诺', '36'}",10,"{'卓创众银', '宁波赛客', '现金', '赛伯乐集团', '宁波赛特', '定价', '北京兴诚旺', '南京创毅', '北京云诺', '36'}"
9,"{'深圳市架桥富凯七号股权投资企业(有限合伙)', '现金', '135199990.1', '9234972', '270399994.8', '18469945', '沂源县南麻街道集体资产经营管理中心', '36', '淄博鑫联投资股份有限公司'}",15574964,1,{'135199990.1'},2,"{'现金', '36'}",8,"{'深圳市架桥富凯七号股权投资企业(有限合伙)', '现金', '9234972', '270399994.8', '18469945', '沂源县南麻街道集体资产经营管理中心', '36', '淄博鑫联投资股份有限公司'}"
9,"{'现金', '华安基金管理有限公司', '12', '88407078', '新疆中泰(集团)有限责任公司', '147492000', '599399988.8', '36', '999995760'}",1104594,0,set(),4,"{'12', '华安基金管理有限公司', '现金', '36'}",9,"{'现金', '华安基金管理有限公司', '12', '88407078', '新疆中泰(集团)有限责任公司', '147492000', '599399988.8', '36', '999995760'}"
11,"{'800000000', '现金', '23215322', '400000000', '11607661', '彭杏妮', '泰达宏利', '定价', '帅放文', '夏哲', '36'}",306120,0,set(),7,"{'现金', '泰达宏利', '彭杏妮', '定价', '帅放文', '夏哲', '36'}",11,"{'800000000', '现金', '23215322', '400000000', '11607661', '彭杏妮', '泰达宏利', '定价', '帅放文', '夏哲', '36'}"
11,"{'现金', '大连圣亚部分管理层和骨干员工拟设立的有限合伙企业', '探索者创业', '400000', '10684000', '竞价', '精一投资', '267100000', '10000000', '36', '杨睿博拟设立的有限公司'}",1876026,3,"{'竞价', '10000000', '267100000'}",6,"{'36', '现金', '大连圣亚部分管理层和骨干员工拟设立的有限合伙企业', '精一投资', '探索者创业', '杨睿博拟设立的有限公司'}",8,"{'现金', '大连圣亚部分管理层和骨干员工拟设立的有限合伙企业', '探索者创业', '10684000', '精一投资', '400000', '36', '杨睿博拟设立的有限公司'}"
12,"{'现金', '黄祥飞', '田南律', '王少华', '饶琦', '任卫峰', '琚克刚', '吴如舟', '2600000', '3600000', '36', '8200000'}",438219,3,"{'2600000', '3600000', '8200000'}",9,"{'现金', '黄祥飞', '田南律', '王少华', '饶琦', '任卫峰', '琚克刚', '吴如舟', '36'}",9,"{'现金', '黄祥飞', '田南律', '王少华', '饶琦', '任卫峰', '琚克刚', '吴如舟', '36'}"
25,"{'386000000', '重庆市能源投资集团有限公司', '深圳鑫昱投资管理合伙企业(有限合伙)', '50000000', '200000000', '2800000000', '140000000', '现金', '四川省煤炭产业集团有限责任公司', '定价', '193000000', '重庆煜琨珑冶金材料有限公司', '540400000', '重庆渝富资产经营管理集团有限公司', '10000000', '30000000', '38600000', '725388601', '中节能资本控股有限公司', '772000000', '100000000', '115800000', '中冶赛迪工程技术股份有限公司', '重庆伟晋环保科技有限公司', '36'}",1761067,14,"{'386000000', '725388601', '100000000', '115800000', '193000000', '2800000000', '772000000', '50000000', '540400000', '10000000', '200000000', '30000000', '140000000', '38600000'}",10,"{'现金', '四川省煤炭产业集团有限责任公司', '中节能资本控股有限公司', '定价', '重庆市能源投资集团有限公司', '重庆煜琨珑冶金材料有限公司', '重庆渝富资产经营管理集团有限公司', '中冶赛迪工程技术股份有限公司', '重庆伟晋环保科技有限公司', '36'}",11,"{'现金', '四川省煤炭产业集团有限责任公司', '中节能资本控股有限公司', '定价', '重庆市能源投资集团有限公司', '重庆煜琨珑冶金材料有限公司', '深圳鑫昱投资管理合伙企业(有限合伙)', '重庆渝富资产经营管理集团有限公司', '中冶赛迪工程技术股份有限公司', '重庆伟晋环保科技有限公司', '36'}"
20,"{'11156351', '中车金证投资有限公司', '潍坊鲁信康大创业投资中心(有限合伙)', '江苏一带一路投资基金(有限合伙)', '现金', '59999994.04', '3684856', '48999999.84', '45250031.68', '博时基金管理有限公司', '4885993', '3501628', '42999991.84', '竞价', '136999990.3', '3990228', '泰康人寿保险有限责任公司-投连-多策略优选', '张怀斌', '12', '泰康人寿保险有限责任公司-分红-个人分红-019L-FH002深'}",20260228,6,"{'59999994.04', '45250031.68', '48999999.84', '42999991.84', '竞价', '136999990.3'}",5,"{'中车金证投资有限公司', '现金', '博时基金管理有限公司', '张怀斌', '12'}",14,"{'11156351', '中车金证投资有限公司', '潍坊鲁信康大创业投资中心(有限合伙)', '现金', '江苏一带一路投资基金(有限合伙)', '3684856', '博时基金管理有限公司', '4885993', '3501628', '3990228', '泰康人寿保险有限责任公司-投连-多策略优选', '张怀斌', '12', '泰康人寿保险有限责任公司-分红-个人分红-019L-FH002深'}"
18,"{'12', '11012643', '定价', '52200000', '新疆艾比湖农工商联合企业总公司', '95809994.1', '191619996.9', '财通基金管理有限公司', '54519994.2', '123850007.1', '22025287', '6266666', '长信基金管理有限责任公司', '14235633', '长城证券有限责任公司', '6000000', '华富基金管理有限公司', '36'}",293395,0,set(),8,"{'12', '定价', '新疆艾比湖农工商联合企业总公司', '财通基金管理有限公司', '长信基金管理有限责任公司', '长城证券有限责任公司', '华富基金管理有限公司', '36'}",18,"{'12', '11012643', '定价', '52200000', '新疆艾比湖农工商联合企业总公司', '95809994.1', '191619996.9', '财通基金管理有限公司', '54519994.2', '123850007.1', '22025287', '6266666', '长信基金管理有限责任公司', '14235633', '长城证券有限责任公司', '6000000', '华富基金管理有限公司', '36'}"
11,"{'26342624', '平安大华基金管理有限公司', '1549999996', '949999984.4', '定价', '667999987.6', '财通基金管理有限公司', '16145479', '11352821', '鹏华资产管理(深圳)有限公司', '12'}",2268293,1,{'949999984.4'},4,"{'平安大华基金管理有限公司', '定价', '12', '财通基金管理有限公司'}",10,"{'26342624', '平安大华基金管理有限公司', '1549999996', '定价', '667999987.6', '财通基金管理有限公司', '16145479', '11352821', '鹏华资产管理(深圳)有限公司', '12'}"
16,"{'现金', '兴业全球基金管理有限公司', '10300000', '13600000', '竞价', '上海大正投资有限公司', '10000000', '中国电力财务有限公司', '25000000', '江苏艾利克斯投资有限公司', '浙江硅谷天堂鲲诚创业投资有限公司', '江西国际信托投资股份有限公司', '9000000', '7845700', '上海证券有限责任公司', '12'}",1432779,1,{'竞价'},2,"{'现金', '12'}",15,"{'现金', '兴业全球基金管理有限公司', '10300000', '13600000', '上海大正投资有限公司', '10000000', '中国电力财务有限公司', '25000000', '江苏艾利克斯投资有限公司', '浙江硅谷天堂鲲诚创业投资有限公司', '江西国际信托投资股份有限公司', '9000000', '7845700', '上海证券有限责任公司', '12'}"
10,"{'450560000', '现金', '16000000', '定价', '478720000', '姚尧土', '17000000', '创毅无限拟设立的有限合伙企业', '李凯', '36'}",1726295,3,"{'450560000', '16000000', '478720000'}",6,"{'36', '现金', '定价', '姚尧土', '李凯', '创毅无限拟设立的有限合伙企业'}",7,"{'现金', '定价', '姚尧土', '17000000', '创毅无限拟设立的有限合伙企业', '李凯', '36'}"
19,"{'100690011.6', '北京信弘天禾资产管理中心(有限合伙)', '25380710', '现金', '滨州市国有资产经营有限公司', '36', '114999995', '12', '定价', '华信期货股份有限公司', '149999996.1', '19458544', '中诚资本管理(北京)有限公司', '济南国惠兴鲁股权投资基金合伙企业(有限合伙)', '天津盛林投资合伙企业(有限合伙)', '武君麒', '59999998.44', '10152284', '17037227'}",16941571,1,{'100690011.6'},7,"{'滨州市国有资产经营有限公司', '现金', '12', '定价', '华信期货股份有限公司', '武君麒', '36'}",18,"{'25380710', '北京信弘天禾资产管理中心(有限合伙)', '滨州市国有资产经营有限公司', '36', '现金', '114999995', '10152284', '定价', '华信期货股份有限公司', '149999996.1', '19458544', '中诚资本管理(北京)有限公司', '济南国惠兴鲁股权投资基金合伙企业(有限合伙)', '天津盛林投资合伙企业(有限合伙)', '武君麒', '59999998.44', '12', '17037227'}"
15,"{'京东方', '1636582', '3273164', '12', '燕东微电子', '11456076', '9819493', '东光微电子', '和智达', '物资公司', '信息学院', '七星集团', '将台公司', '381979181', '36'}",1448133,0,set(),9,"{'京东方', '燕东微电子', '东光微电子', '和智达', '物资公司', '信息学院', '七星集团', '将台公司', '12'}",15,"{'京东方', '1636582', '3273164', '12', '燕东微电子', '11456076', '9819493', '东光微电子', '和智达', '物资公司', '信息学院', '七星集团', '将台公司', '381979181', '36'}"
4,"{'竞价', '现金', '36', '新疆广汇实业投资(集团)有限责任公司'}",128980,2,"{'竞价', '新疆广汇实业投资(集团)有限责任公司'}",2,"{'现金', '36'}",2,"{'现金', '36'}"
26,"{'35186489', '500000008.7', '1000000003', '841448887.2', '3268300000', '现金', '12', '财通基金管理有限公司', '申能(集团)有限公司', '竞价', '上海海烟投资管理有限公司', '104356087', '70372977', '2965627000', '999999989', '国华人寿保险股份有限公司', '59215263', '70372976', '浙能资本控股有限公司', '230000000', '1482899996', '208700000', '48', '中原股权投资管理有限公司', '山西太钢投资有限公司', '36'}",18855239,3,"{'999999989', '500000008.7', '竞价'}",5,"{'现金', '12', '48', '上海海烟投资管理有限公司', '36'}",23,"{'35186489', '1000000003', '841448887.2', '3268300000', '现金', '12', '财通基金管理有限公司', '申能(集团)有限公司', '上海海烟投资管理有限公司', '104356087', '70372977', '2965627000', '国华人寿保险股份有限公司', '59215263', '70372976', '浙能资本控股有限公司', '230000000', '1482899996', '208700000', '48', '中原股权投资管理有限公司', '山西太钢投资有限公司', '36'}"
10,"{'现金', '100000000', '建投投资有限责任公司', '唐灼林', '24509803', '西藏自治区投资有限公司', '盛稷股权投资基金(上海)有限公司', '12254902', '200000000', '36'}",1911015,0,set(),5,"{'现金', '建投投资有限责任公司', '唐灼林', '西藏自治区投资有限公司', '36'}",10,"{'现金', '100000000', '建投投资有限责任公司', '唐灼林', '24509803', '西藏自治区投资有限公司', '盛稷股权投资基金(上海)有限公司', '12254902', '200000000', '36'}"
7,"{'现金', '华菱集团', '安赛乐—米塔尔', '定价', '263484000', '256516000', '36'}",1380534,0,set(),5,"{'现金', '华菱集团', '安赛乐—米塔尔', '定价', '36'}",7,"{'现金', '安赛乐—米塔尔', '华菱集团', '定价', '263484000', '256516000', '36'}"
10,"{'现金', '4467109', '长城国融投资管理有限公司', '15000000', '广东恒健资本管理有限公司', '民生加银基金管理有想公司', '广东省盐业集团有限公司', '10000000', '12', '李贵山'}",1560239,1,{'李贵山'},2,"{'现金', '12'}",9,"{'现金', '4467109', '长城国融投资管理有限公司', '15000000', '广东恒健资本管理有限公司', '民生加银基金管理有想公司', '广东省盐业集团有限公司', '10000000', '12'}"
7,"{'广发原驰•金发科技1号定向资产管理计划', '101126159', '55658627', '545070000', '300000000', '袁志敏', '36'}",15581319,2,"{'300000000', '545070000'}",3,"{'袁志敏', '广发原驰•金发科技1号定向资产管理计划', '36'}",5,"{'广发原驰•金发科技1号定向资产管理计划', '101126159', '55658627', '袁志敏', '36'}"
16,"{'平安大华基金管理有限公司', '28600000', '16800000', '16000000', '4400000', '15000000', '东海基金管理有限责任公司', '财通基金管理有限公司', '长江证券股份有限公司', '太平资产管理有限公司', '安徽省安庆市曙光化工股份有限公司', '15600000', '江苏瑞华投资控股集团有限公司', '高翔', '12', '38600000'}",406960,7,"{'28600000', '16800000', '16000000', '4400000', '15000000', '15600000', '38600000'}",9,"{'平安大华基金管理有限公司', '东海基金管理有限责任公司', '财通基金管理有限公司', '长江证券股份有限公司', '安徽省安庆市曙光化工股份有限公司', '江苏瑞华投资控股集团有限公司', '高翔', '12', '太平资产管理有限公司'}",9,"{'平安大华基金管理有限公司', '东海基金管理有限责任公司', '财通基金管理有限公司', '长江证券股份有限公司', '安徽省安庆市曙光化工股份有限公司', '江苏瑞华投资控股集团有限公司', '高翔', '12', '太平资产管理有限公司'}"
10,"{'12000000', '5000000', '北信瑞丰基金管理有限公司', '4500000', '华安基金管理有限公司', '平安资产管理有限责任公司', '财通基金管理有限公司', '竞价', '3486118', '12'}",1613257,3,"{'3486118', '竞价', '4500000'}",5,"{'北信瑞丰基金管理有限公司', '华安基金管理有限公司', '平安资产管理有限责任公司', '财通基金管理有限公司', '12'}",7,"{'12000000', '5000000', '北信瑞丰基金管理有限公司', '华安基金管理有限公司', '平安资产管理有限责任公司', '财通基金管理有限公司', '12'}"
7,"{'现金', '练卫飞', '定价', '苏光伟', '21000000', '25000000', '36'}",1061061,2,"{'25000000', '21000000'}",5,"{'现金', '练卫飞', '定价', '苏光伟', '36'}",5,"{'现金', '练卫飞', '定价', '苏光伟', '36'}"
4,"{'404643737', '定价', '36', '杭州市商贸旅游集团有限公司'}",346800,0,set(),3,"{'定价', '36', '杭州市商贸旅游集团有限公司'}",4,"{'404643737', '定价', '36', '杭州市商贸旅游集团有限公司'}"
12,"{'杭州逸博投资管理有限公司', '3620192', '定价', '赣州启源金川投资中心(有限合伙)', '7158654', '153999996.8', '金鹰瑞东穗通定增359号资产管理计划1', '150599987.2', '297800006.4', '12', '王钢', '3701923'}",15919511,0,set(),4,"{'杭州逸博投资管理有限公司', '定价', '12', '王钢'}",12,"{'杭州逸博投资管理有限公司', '3620192', '定价', '赣州启源金川投资中心(有限合伙)', '7158654', '153999996.8', '金鹰瑞东穗通定增359号资产管理计划1', '150599987.2', '297800006.4', '12', '王钢', '3701923'}"
6,"{'现金', '华海药业2015年员工持股计划', '定价', '14931420', '36', '302659900'}",4921533,3,"{'华海药业2015年员工持股计划', '14931420', '302659900'}",3,"{'36', '定价', '现金'}",3,"{'定价', '现金', '36'}"
18,"{'250000012.5', '现金', '412778', '335425976.8', '长安平安富贵东方通资产管理计划', '1788663', '朱曼', '30000705.04', '3439736', '1100716', '130000026.8', '黄永军', '竞价', '80000038.88', '兴全沈惠中特定客户资产管理计划', '4615107', '36', '平安汇通星通资本定向投资4号资产管理计划'}",1576302,5,"{'250000012.5', '335425976.8', '30000705.04', '竞价', '80000038.88'}",7,"{'现金', '长安平安富贵东方通资产管理计划', '朱曼', '黄永军', '兴全沈惠中特定客户资产管理计划', '36', '平安汇通星通资本定向投资4号资产管理计划'}",13,"{'412778', '现金', '长安平安富贵东方通资产管理计划', '1788663', '朱曼', '黄永军', '3439736', '1100716', '130000026.8', '兴全沈惠中特定客户资产管理计划', '4615107', '36', '平安汇通星通资本定向投资4号资产管理计划'}"
17,"{'罗宏健', '现金', '秦传君', '顾永德', '12916182', '405100', '3228647', '6458091', '陈曦', '80623400', '竞价', '810300', '方吉槟', '1620600', '36', '肖明', '642568498'}",1773667,9,"{'12916182', '405100', '3228647', '6458091', '80623400', '810300', '竞价', '1620600', '642568498'}",8,"{'罗宏健', '现金', '秦传君', '顾永德', '陈曦', '方吉槟', '36', '肖明'}",8,"{'罗宏健', '现金', '秦传君', '顾永德', '陈曦', '方吉槟', '36', '肖明'}"
21,"{'20000000', '4000000', '3000000', '797582500', '4484000', '现金', '150008000', '89240000', '66930000', '陈松兴', '竞价', '陈魁', '钟葱', '100038000', '446200000', '陶安祥', '35750000', '6723800', '韵帛文化', '李明华', '36'}",1827497,11,"{'20000000', '4484000', '6723800', '150008000', '89240000', '66930000', '竞价', '35750000', '100038000', '797582500', '446200000'}",8,"{'陶安祥', '现金', '韵帛文化', '陈松兴', '陈魁', '李明华', '钟葱', '36'}",10,"{'陶安祥', '现金', '韵帛文化', '4000000', '陈松兴', '3000000', '陈魁', '李明华', '钟葱', '36'}"
4,"{'679439063', '定价', '36', '山东高速集团有限公司'}",1275196,0,set(),2,"{'定价', '山东高速集团有限公司'}",4,"{'679439063', '定价', '36', '山东高速集团有限公司'}"
4,"{'三安集团', '现金', '竞价', '36'}",231976,0,set(),4,"{'三安集团', '现金', '竞价', '36'}",4,"{'三安集团', '现金', '竞价', '36'}"
4,"{'竞价', '现金', '36', '新疆天富电力(集团)有限责任公司'}",180781,0,set(),4,"{'竞价', '现金', '36', '新疆天富电力(集团)有限责任公司'}",4,"{'竞价', '现金', '36', '新疆天富电力(集团)有限责任公司'}"
6,"{'中农发集团', '现金', '定价', '470000000', '36', '63087248'}",1441190,2,"{'470000000', '63087248'}",4,"{'现金', '定价', '36', '中农发集团'}",4,"{'定价', '现金', '中农发集团', '36'}"
21,"{'600000000', '恒大人寿保险有限公司', '56470588', '古少明', '69516578', '4278075', '现金', '40000000', '古少扬', '30000000', '10695187', '李素玉', '36', '古少波', '64171123', '649980000', '3208556', '528000000', '100000000', '西藏东方富通投资有限公司', '古朴'}",12036529,0,set(),9,"{'36', '现金', '恒大人寿保险有限公司', '古少波', '西藏东方富通投资有限公司', '古少明', '古少扬', '古朴', '李素玉'}",21,"{'600000000', '恒大人寿保险有限公司', '56470588', '古少明', '69516578', '4278075', '现金', '40000000', '古少扬', '30000000', '10695187', '李素玉', '36', '古少波', '64171123', '649980000', '3208556', '528000000', '100000000', '西藏东方富通投资有限公司', '古朴'}"
19,"{'陈潮钿', '1920000', '广州尚银投资有限公司', '32000000', '林吉雄', '上海证大投资管理有限公司', '2000000', '2800000', '竞价', '常州投资集团有限公司', '3000000', '48000000', '43200000', '上海合邦投资有限公司', '东莞市嘉华房地产开发有限公司', '2700000', '44800000', '韶关市利合生企业策划管理有限公司', '30720000'}",1159940,7,"{'1920000', '32000000', '竞价', '48000000', '44800000', '43200000', '30720000'}",8,"{'陈潮钿', '广州尚银投资有限公司', '林吉雄', '上海证大投资管理有限公司', '常州投资集团有限公司', '韶关市利合生企业策划管理有限公司', '东莞市嘉华房地产开发有限公司', '上海合邦投资有限公司'}",12,"{'陈潮钿', '广州尚银投资有限公司', '林吉雄', '上海证大投资管理有限公司', '2000000', '2800000', '常州投资集团有限公司', '3000000', '韶关市利合生企业策划管理有限公司', '东莞市嘉华房地产开发有限公司', '2700000', '上海合邦投资有限公司'}"
10,"{'170239773.6', '上海中植鑫荞投资管理有限公司', '定价', '5126160', '中财通基金管理有限公司', '4208899', '139777535.8', '周万沅', '509999959', '15356819'}",1930876,2,"{'139777535.8', '509999959'}",3,"{'上海中植鑫荞投资管理有限公司', '周万沅', '定价'}",8,"{'170239773.6', '上海中植鑫荞投资管理有限公司', '定价', '5126160', '中财通基金管理有限公司', '4208899', '周万沅', '15356819'}"
9,"{'5000000', '任武贤', '2000000', '中山达华智能科技股份有限公司', '山西亚宝投资有限公司', '10000000', '42048000', '陕西金钧源实业有限公司', '36'}",156408,0,set(),5,"{'任武贤', '中山达华智能科技股份有限公司', '山西亚宝投资有限公司', '陕西金钧源实业有限公司', '36'}",9,"{'5000000', '任武贤', '2000000', '中山达华智能科技股份有限公司', '山西亚宝投资有限公司', '10000000', '42048000', '陕西金钧源实业有限公司', '36'}"
16,"{'现金', '九泰基金管理有限公司', '中融基金管理有限公司', '大成基金管理有限公司', '3635419', '定价', '东海基金管理有限责任公司', '2337055', '易方达基金管理有限公司', '4544274', '4414437', '建信基金管理有限公司', '长城(天津)股权投资资金管理有限责任公司', '1010649', '深圳远致富海七号投资企业(有限合伙)', '12'}",16521320,0,set(),3,"{'定价', '现金', '12'}",16,"{'现金', '九泰基金管理有限公司', '中融基金管理有限公司', '大成基金管理有限公司', '3635419', '定价', '东海基金管理有限责任公司', '2337055', '易方达基金管理有限公司', '4544274', '4414437', '建信基金管理有限公司', '长城(天津)股权投资资金管理有限责任公司', '1010649', '深圳远致富海七号投资企业(有限合伙)', '12'}"
14,"{'20000000', '现金', '39572621', '厦门大洲宏弧投资管理有限公司', '厦门润中投资管理有限公司', '237040000', '60000000', '厦门滨江资产管理有限公司', '143760000', '119800000', '359400000', '36', '24000000', '大洲控股集团有限公司'}",400764,8,"{'20000000', '39572621', '60000000', '237040000', '143760000', '119800000', '359400000', '24000000'}",6,"{'现金', '厦门大洲宏弧投资管理有限公司', '厦门润中投资管理有限公司', '厦门滨江资产管理有限公司', '36', '大洲控股集团有限公司'}",6,"{'现金', '厦门大洲宏弧投资管理有限公司', '厦门润中投资管理有限公司', '厦门滨江资产管理有限公司', '36', '大洲控股集团有限公司'}"
4,"{'36', '定价', '140000000', '中国交通建设股份有限公司'}",1407461,1,{'140000000'},2,"{'定价', '中国交通建设股份有限公司'}",3,"{'定价', '36', '中国交通建设股份有限公司'}"
24,"{'申万宏源证券有限公司', '15336000', '149600000', '15539295', '现金', '171999999', '303299992', '财通基金管理有限公司', '竞价', '129999994.5', '132084007.5', '30000000', '浦银安盛基金管理有限公司', '博时基金管理有限公司', '255000000', '中信证券股份有限公司', '20235294', '江苏国泰华鼎投资有限公司', '15294117', '金鹰基金管理有限公司', '17600000', '130356000', '35682352', '12'}",1565596,0,set(),10,"{'金鹰基金管理有限公司', '现金', '浦银安盛基金管理有限公司', '博时基金管理有限公司', '财通基金管理有限公司', '申万宏源证券有限公司', '竞价', '中信证券股份有限公司', '江苏国泰华鼎投资有限公司', '12'}",24,"{'申万宏源证券有限公司', '15336000', '149600000', '15539295', '现金', '171999999', '303299992', '财通基金管理有限公司', '竞价', '129999994.5', '132084007.5', '30000000', '浦银安盛基金管理有限公司', '博时基金管理有限公司', '255000000', '中信证券股份有限公司', '20235294', '江苏国泰华鼎投资有限公司', '15294117', '金鹰基金管理有限公司', '17600000', '130356000', '35682352', '12'}"
8,"{'赛德万方', '建新集团', '360339241', '智尚劢合', '资产', '73538620', '301508345', '36'}",1218367,1,{'360339241'},5,"{'赛德万方', '建新集团', '智尚劢合', '资产', '36'}",7,"{'赛德万方', '建新集团', '智尚劢合', '资产', '73538620', '301508345', '36'}"
19,"{'53467000', '现金', '北京国开汉富中金投资中心(有限合伙)', '长城国瑞证券有限公司', '481200000', '40000000', '478800000', '960000000', '定价', '320000000', '26733500', '深圳盈合汇德投资中心(有限合伙)', '上海褚富投资管理中心(有限合伙)', '40200500', '640000000', '北京国开汉富银泰投资中心(有限合伙)', '80200500', '深圳盈合汇智投资中心(有限合伙)', '36'}",1838109,10,"{'53467000', '481200000', '40000000', '478800000', '960000000', '320000000', '26733500', '40200500', '640000000', '80200500'}",4,"{'定价', '现金', '长城国瑞证券有限公司', '36'}",9,"{'现金', '北京国开汉富中金投资中心(有限合伙)', '长城国瑞证券有限公司', '定价', '上海褚富投资管理中心(有限合伙)', '深圳盈合汇德投资中心(有限合伙)', '北京国开汉富银泰投资中心(有限合伙)', '深圳盈合汇智投资中心(有限合伙)', '36'}"
6,"{'5000000', '现金', '物产集团', '竞价', '物产金属', '36'}",1027206,1,{'5000000'},5,"{'现金', '物产集团', '竞价', '物产金属', '36'}",5,"{'现金', '物产集团', '竞价', '物产金属', '36'}"
20,"{'现金', '20125786', '499999986', '兴全基金管理有限公司', '工银资管(全球)有限公司', '12578616', '10062893', '799999993.5', '嘉实基金管理有限公司', '15372672', '国寿资产-PIPE价值精选1701集合保险资产管理产品', '竞价', '704129989.5', '中国人寿保险股份有限公司-分红-个人分红', '17713962', '平安资产鑫享3号资产管理产品', '399999996.8', '诺德基金管理有限公司', '12', '611063712'}",20337881,2,"{'399999996.8', '竞价'}",5,"{'现金', '兴全基金管理有限公司', '嘉实基金管理有限公司', '诺德基金管理有限公司', '12'}",18,"{'现金', '20125786', '499999986', '兴全基金管理有限公司', '工银资管(全球)有限公司', '12578616', '10062893', '799999993.5', '嘉实基金管理有限公司', '15372672', '国寿资产-PIPE价值精选1701集合保险资产管理产品', '704129989.5', '中国人寿保险股份有限公司-分红-个人分红', '17713962', '平安资产鑫享3号资产管理产品', '诺德基金管理有限公司', '12', '611063712'}"
13,"{'北京金证汇通投资中心(有限合伙)', '现金', '红宝丽集团股份有限公司—第一期员工持股计划', '上海兴全睿众资产管理有限公司-兴全睿众定增9号特定多客户资产管理计划', '49999997.57', '竞价', '10535000', '60154850', '214400724.5', '江苏宝源投资管理有限公司', '8756567', '36', '37548288'}",4954464,2,"{'竞价', '214400724.5'}",4,"{'红宝丽集团股份有限公司—第一期员工持股计划', '江苏宝源投资管理有限公司', '现金', '36'}",11,"{'北京金证汇通投资中心(有限合伙)', '红宝丽集团股份有限公司—第一期员工持股计划', '现金', '上海兴全睿众资产管理有限公司-兴全睿众定增9号特定多客户资产管理计划', '49999997.57', '10535000', '60154850', '江苏宝源投资管理有限公司', '8756567', '36', '37548288'}"
12,"{'嘉兴凯联艾瑞投资合伙企业(有限合伙)', '18638864', '现金', '华安基金管理有限公司', '8877218', '8816969', '国泰君安员工持股1号-宜宾五粮液第1期员工持股计划定向资产管理计划', '22780834', '泰康资产管理有限责任公司', '23138553', '国泰君安君享五粮液1号集合资产管理计划', '36'}",15509917,5,"{'18638864', '8816969', '22780834', '8877218', '23138553'}",5,"{'现金', '华安基金管理有限公司', '泰康资产管理有限责任公司', '国泰君安君享五粮液1号集合资产管理计划', '36'}",7,"{'嘉兴凯联艾瑞投资合伙企业(有限合伙)', '现金', '华安基金管理有限公司', '国泰君安员工持股1号-宜宾五粮液第1期员工持股计划定向资产管理计划', '泰康资产管理有限责任公司', '国泰君安君享五粮液1号集合资产管理计划', '36'}"
16,"{'现金', '55848280', '1119758014', '许锦光', '95204537.8', '定价', '周镇科', '76163634.25', '陈少达', '4748356', '8547041', '黄永建', '3798685', '171368172.1', '陈乐强', '36'}",1863767,2,"{'171368172.1', '76163634.25'}",7,"{'现金', '许锦光', '周镇科', '陈少达', '黄永建', '陈乐强', '36'}",14,"{'现金', '55848280', '1119758014', '许锦光', '95204537.8', '定价', '周镇科', '陈少达', '4748356', '8547041', '黄永建', '3798685', '陈乐强', '36'}"
31,"{'20000000', '宁波信达风盛投资合伙企业', '中汇同创(北京)投资有限公司', '32000000', '277200000', '3000000', '北京合聚天建投资中心', '上海大丰资产管理有限公司', '40194000', '5000000', '443520000', '现金', '69300000', '会稽山绍兴酒股份有限公司第一期员工持股计划', '竞价', '北京世欣钲兴投资中心', '精功集团有限公司', '30000000', '103950000', '上海达顺股权投资基金管理合伙企业', '36', '钜洲资产管理(上海)有限公司', '15000000', '2900000', '98406000', '7500000', '金鹰基金管理有限公司', '207900000', '415800000', '7100000', '41580000'}",1668467,16,"{'443520000', '中汇同创(北京)投资有限公司', '钜洲资产管理(上海)有限公司', '69300000', '98406000', '277200000', '15000000', '2900000', '竞价', '103950000', '207900000', '415800000', '7100000', '40194000', '41580000', '7500000'}",10,"{'金鹰基金管理有限公司', '现金', '宁波信达风盛投资合伙企业', '会稽山绍兴酒股份有限公司第一期员工持股计划', '北京世欣钲兴投资中心', '精功集团有限公司', '北京合聚天建投资中心', '上海大丰资产管理有限公司', '36', '上海达顺股权投资基金管理合伙企业'}",15,"{'20000000', '5000000', '现金', '宁波信达风盛投资合伙企业', '金鹰基金管理有限公司', '32000000', '会稽山绍兴酒股份有限公司第一期员工持股计划', '3000000', '北京世欣钲兴投资中心', '精功集团有限公司', '北京合聚天建投资中心', '上海大丰资产管理有限公司', '30000000', '36', '上海达顺股权投资基金管理合伙企业'}"
3,"{'新余钢铁有限责任公司', '1000209135', '36'}",547836,0,set(),2,"{'新余钢铁有限责任公司', '36'}",3,"{'新余钢铁有限责任公司', '1000209135', '36'}"
19,"{'63585168', '35951796', '长城公司', '1043674', '陕西产投', '14127275', '101196554', '定价', '昆仑天创', '新远景', '1085401', '华融公司', '110499048', '华融渝富红杉', '陕西省国资委', '10119655', '东方公司', '28503696', '邦信公司'}",357895,0,set(),10,"{'长城公司', '陕西产投', '昆仑天创', '新远景', '定价', '华融公司', '华融渝富红杉', '陕西省国资委', '东方公司', '邦信公司'}",19,"{'63585168', '35951796', '长城公司', '1043674', '陕西产投', '14127275', '101196554', '昆仑天创', '新远景', '定价', '1085401', '华融公司', '110499048', '华融渝富红杉', '陕西省国资委', '10119655', '东方公司', '28503696', '邦信公司'}"
5,"{'现金', '定价', '13440000', '南京医药集团有限责任公司', '36'}",1432113,1,{'13440000'},4,"{'36', '定价', '南京医药集团有限责任公司', '现金'}",4,"{'现金', '定价', '南京医药集团有限责任公司', '36'}"
5,"{'150000000', '现金', '竞价', '新和成控股', '36'}",1211280,1,{'150000000'},4,"{'新和成控股', '现金', '竞价', '36'}",4,"{'新和成控股', '现金', '竞价', '36'}"
17,"{'杭州市财开投资集团公司', '5000000', '现金', '上海嘉安投资发展有限责任公司', '上海高恒投资管理有限公司', '3630000', '安徽安粮兴业有限公司', '2000000', '北京环球银证投资顾问有限公司', '3000000', '北京爱康医疗投资管理有限责任公司', '海南兴易投资有限公司', '9300000', '上海景贤投资有限公司', '28000000', '12', '上海长滩投资有限公司'}",1353684,3,"{'3630000', '3000000', '2000000'}",10,"{'杭州市财开投资集团公司', '现金', '上海高恒投资管理有限公司', '安徽安粮兴业有限公司', '北京环球银证投资顾问有限公司', '北京爱康医疗投资管理有限责任公司', '海南兴易投资有限公司', '上海景贤投资有限公司', '12', '上海长滩投资有限公司'}",14,"{'杭州市财开投资集团公司', '5000000', '现金', '上海嘉安投资发展有限责任公司', '上海高恒投资管理有限公司', '安徽安粮兴业有限公司', '北京环球银证投资顾问有限公司', '北京爱康医疗投资管理有限责任公司', '海南兴易投资有限公司', '9300000', '上海景贤投资有限公司', '28000000', '12', '上海长滩投资有限公司'}"
15,"{'7610350', '149999985.4', '5707762', '现金', '199999998', '1902587', '海尔创投', '11415525', '陆永', '299999997', '复星瑞哲拟设立的有限公司', '49999986.36', '中植金控拟设立的有限公司', '东方创投', '36'}",2043471,2,"{'49999986.36', '149999985.4'}",7,"{'现金', '海尔创投', '陆永', '复星瑞哲拟设立的有限公司', '中植金控拟设立的有限公司', '东方创投', '36'}",13,"{'7610350', '5707762', '现金', '199999998', '1902587', '海尔创投', '11415525', '陆永', '299999997', '复星瑞哲拟设立的有限公司', '中植金控拟设立的有限公司', '东方创投', '36'}"
12,"{'徐玉', '深圳市和方投资有限公司', '李晓红', '定价', '王庆华', '黄卫枝', '厉农帆', '黄建', '陈劲松', '许文智', '36', '上海三湘投资控股有限公司'}",1161092,0,set(),12,"{'徐玉', '深圳市和方投资有限公司', '李晓红', '定价', '王庆华', '黄卫枝', '厉农帆', '黄建', '陈劲松', '许文智', '36', '上海三湘投资控股有限公司'}",12,"{'徐玉', '深圳市和方投资有限公司', '李晓红', '王庆华', '定价', '黄卫枝', '厉农帆', '黄建', '陈劲松', '许文智', '36', '上海三湘投资控股有限公司'}"
27,"{'7828824', '国联安基金管理有限公司', '华泰资产管理有限公司', '广发乾和投资有限公司', '7812564', '212005980.8', '211441996.3', '10265853', '现金', '7834663', '7839541', '277793982.2', '财通基金管理有限公司', '安徽省投资集团控股有限公司', '212137979.5', '210671976.9', '竞价', '7785365', '申银万国证券股份有限公司', '银河基金管理有限公司', '7813821', '19057358', '天弘基金管理有限公司', '211847977.4', '211407981.8', '515692107.5', '12'}",312565,6,"{'277793982.2', '212137979.5', '竞价', '515692107.5', '212005980.8', '211441996.3'}",2,"{'现金', '12'}",21,"{'7828824', '国联安基金管理有限公司', '华泰资产管理有限公司', '广发乾和投资有限公司', '7812564', '10265853', '现金', '7834663', '7839541', '财通基金管理有限公司', '安徽省投资集团控股有限公司', '210671976.9', '7785365', '申银万国证券股份有限公司', '银河基金管理有限公司', '7813821', '19057358', '天弘基金管理有限公司', '211847977.4', '211407981.8', '12'}"
11,"{'东证分级股票6号资管计划', '旭明投资', '现金', '15873015', '兴全定增68号', '平安资管', '竞价', '7936507', '兴全定增69号', '36', '东证分级股票5号资管计划'}",562451,3,"{'竞价', '15873015', '7936507'}",4,"{'旭明投资', '现金', '36', '平安资管'}",8,"{'东证分级股票6号资管计划', '旭明投资', '现金', '兴全定增68号', '平安资管', '兴全定增69号', '36', '东证分级股票5号资管计划'}"
6,"{'现金', '定价', '625000000', '2000000000', '安徽蓝鼎控股集团有限公司', '36'}",911354,1,{'625000000'},4,"{'定价', '现金', '安徽蓝鼎控股集团有限公司', '36'}",5,"{'现金', '定价', '2000000000', '安徽蓝鼎控股集团有限公司', '36'}"
17,"{'8108108', '现金', '长城国瑞证券有限公司', '15878378', '234999994.4', '国联安基金管理有限公司', '16216216', '德邦证券股份有限公司', '219976011.2', '239999996.8', '竞价', '119999998.4', '中欧盛世资产管理(上海)有限公司', '国投瑞银基金管理有限公司', '14863244', '华富基金管理有限公司', '12'}",1620063,1,{'竞价'},7,"{'现金', '长城国瑞证券有限公司', '国联安基金管理有限公司', '德邦证券股份有限公司', '国投瑞银基金管理有限公司', '华富基金管理有限公司', '12'}",16,"{'8108108', '现金', '长城国瑞证券有限公司', '15878378', '234999994.4', '国联安基金管理有限公司', '16216216', '德邦证券股份有限公司', '219976011.2', '239999996.8', '119999998.4', '中欧盛世资产管理(上海)有限公司', '国投瑞银基金管理有限公司', '14863244', '华富基金管理有限公司', '12'}"
4,"{'竞价', '现金', '36', '连云港港口集团有限公司'}",1135909,0,set(),4,"{'竞价', '现金', '36', '连云港港口集团有限公司'}",4,"{'竞价', '现金', '36', '连云港港口集团有限公司'}"
5,"{'现金', '定价', '768882352', '36', 'GE Smallworld(Singapore) Pte Ltd.'}",1107878,1,{'GE Smallworld(Singapore) Pte Ltd.'},2,"{'定价', '现金'}",4,"{'定价', '现金', '36', '768882352'}"
15,"{'150000000', '何东翰', '现金', '600000000', '48275862', '350000000', '27586206', '新华联控股', '海慧科技', '延万华', '20689655', '200000000', '36', '杜玉岱', '82758620'}",1865099,3,"{'350000000', '200000000', '600000000'}",7,"{'何东翰', '现金', '海慧科技', '新华联控股', '延万华', '36', '杜玉岱'}",12,"{'150000000', '何东翰', '现金', '27586206', '48275862', '新华联控股', '海慧科技', '延万华', '20689655', '36', '杜玉岱', '82758620'}"
14,"{'现金', '长城资本管理有限公司', '正海集团有限公司', '240000000', '定价', '279999990', '中国长城资产管理公司', '199999995', '240000015', '13386881', '上海汽车集团股权投资有限公司(上汽投资-颀瑞1号)', '山东省国有资产投资控股有限公司', '36', '16064257'}",4958144,1,{'山东省国有资产投资控股有限公司'},6,"{'36', '长城资本管理有限公司', '现金', '定价', '中国长城资产管理公司', '正海集团有限公司'}",13,"{'现金', '长城资本管理有限公司', '正海集团有限公司', '240000000', '定价', '279999990', '中国长城资产管理公司', '199999995', '240000015', '13386881', '上海汽车集团股权投资有限公司(上汽投资-颀瑞1号)', '36', '16064257'}"
19,"{'双星集团有限责任公司', '80000002.23', '现金', '99999998.04', '天津源和商务咨询合伙企业(有限合伙)', '12', '310391005.6', '定价', '12638231', '华能贵诚信托有限公司', '25214691', '249999995.1', '杭州江化投资管理合伙企业(有限合伙)', '159608994', '济南国惠兴鲁股权投资基金合伙企业(有限合伙)', '15797788', '39494470', '49034914', '36'}",19283783,0,set(),6,"{'36', '双星集团有限责任公司', '现金', '定价', '华能贵诚信托有限公司', '12'}",19,"{'双星集团有限责任公司', '80000002.23', '现金', '99999998.04', '天津源和商务咨询合伙企业(有限合伙)', '12', '310391005.6', '定价', '12638231', '华能贵诚信托有限公司', '25214691', '249999995.1', '杭州江化投资管理合伙企业(有限合伙)', '159608994', '济南国惠兴鲁股权投资基金合伙企业(有限合伙)', '15797788', '39494470', '49034914', '36'}"
6,"{'现金', '东莞市新世纪科教拓展有限公司', '定价', '135376952', '1665136510', '36'}",1156524,1,{'1665136510'},4,"{'36', '定价', '现金', '东莞市新世纪科教拓展有限公司'}",5,"{'现金', '东莞市新世纪科教拓展有限公司', '定价', '135376952', '36'}"
11,"{'现金', '9975062', '22443890', '许锦光', '周镇科', '12468828', '陈少达', '67830424', '黄永建', '陈乐强', '36'}",279975,0,set(),7,"{'现金', '许锦光', '周镇科', '陈少达', '黄永建', '陈乐强', '36'}",11,"{'现金', '9975062', '22443890', '许锦光', '周镇科', '12468828', '陈少达', '67830424', '黄永建', '陈乐强', '36'}"
5,"{'现金', '156103049', '深圳市华融泰资产管理有限公司', '竞价', '36'}",354485,1,{'竞价'},3,"{'现金', '36', '深圳市华融泰资产管理有限公司'}",4,"{'36', '现金', '156103049', '深圳市华融泰资产管理有限公司'}"
13,"{'16000000', '上海连衡投资发展中心', '中邮创业基金管理有限公司', '2600000', '定价', '5500000', '东吴证券有限责任公司', '中国人寿资产管理有限公司', '鹏华基金管理有限公司', '2700000', '华商基金管理有限公司', '12', '7500000'}",1342345,2,"{'2700000', '2600000'}",8,"{'中邮创业基金管理有限公司', '定价', '东吴证券有限责任公司', '中国人寿资产管理有限公司', '鹏华基金管理有限公司', '上海连衡投资发展中心', '华商基金管理有限公司', '12'}",11,"{'16000000', '中邮创业基金管理有限公司', '定价', '5500000', '东吴证券有限责任公司', '中国人寿资产管理有限公司', '鹏华基金管理有限公司', '上海连衡投资发展中心', '华商基金管理有限公司', '12', '7500000'}"
5,"{'中盛集团', '现金', '100000000', '竞价', '36'}",1868644,1,{'100000000'},4,"{'中盛集团', '现金', '竞价', '36'}",4,"{'中盛集团', '现金', '竞价', '36'}"
17,"{'招商财富资产管理有限公司', '33250000', '39250000', '324852500', '486057500', '100211495.7', '定价', '申万菱信(上海)资产管理有限公司', '国联安基金管理有限公司', '财通基金管理有限公司', '东方证券股份有限公司', '10257062', '49750000', '760106000', '77800000', '383472500', '12'}",88875,0,set(),6,"{'招商财富资产管理有限公司', '定价', '东方证券股份有限公司', '国联安基金管理有限公司', '财通基金管理有限公司', '12'}",17,"{'招商财富资产管理有限公司', '33250000', '39250000', '324852500', '486057500', '100211495.7', '定价', '申万菱信(上海)资产管理有限公司', '国联安基金管理有限公司', '财通基金管理有限公司', '东方证券股份有限公司', '10257062', '49750000', '760106000', '77800000', '383472500', '12'}"
14,"{'杭州滨创股权投资有限公司', '695999998.3', '31268439', '定价', '泰达宏利基金管理有限公司', '349999994', '212000016.4', '102654867', '铜陵发展投资集团有限公司', '广州金融控股集团有限公司', '广州市玄元投资管理有限公司', '建信基金管理有限责任公司', '12', '51622418'}",12001027,1,{'695999998.3'},8,"{'杭州滨创股权投资有限公司', '定价', '铜陵发展投资集团有限公司', '广州金融控股集团有限公司', '泰达宏利基金管理有限公司', '建信基金管理有限责任公司', '12', '广州市玄元投资管理有限公司'}",13,"{'杭州滨创股权投资有限公司', '31268439', '定价', '泰达宏利基金管理有限公司', '349999994', '212000016.4', '102654867', '铜陵发展投资集团有限公司', '广州金融控股集团有限公司', '广州市玄元投资管理有限公司', '建信基金管理有限责任公司', '12', '51622418'}"
5,"{'现金', '竞价', '王维勇', '80000000', '12'}",361548,1,{'80000000'},4,"{'王维勇', '竞价', '现金', '12'}",4,"{'王维勇', '竞价', '现金', '12'}"
17,"{'林夏满', '中国水务投资有限公司', '西安海联房屋建设开发有限公司', '现金', '金纬资本(山南)一期合伙企业(有限合伙)', '1505906', '王壮利', '13097008', '王洪仁', '梁小恩', '5019685', '17025767', '1003937', '王相荣', '501969', '12770078', '36'}",1045206,1,{'金纬资本(山南)一期合伙企业(有限合伙)'},9,"{'林夏满', '中国水务投资有限公司', '西安海联房屋建设开发有限公司', '现金', '王壮利', '王洪仁', '梁小恩', '王相荣', '36'}",16,"{'林夏满', '中国水务投资有限公司', '西安海联房屋建设开发有限公司', '现金', '1505906', '王壮利', '13097008', '王洪仁', '梁小恩', '5019685', '17025767', '1003937', '王相荣', '501969', '12770078', '36'}"
5,"{'现金', '第五季国际投资控股有限公司', '65000000', '定价', '36'}",1026682,1,{'65000000'},4,"{'36', '定价', '第五季国际投资控股有限公司', '现金'}",4,"{'现金', '定价', '第五季国际投资控股有限公司', '36'}"
19,"{'黄华', '现金', '1200000000', '44000000', '劲嘉创投', '21881838', '定价', '200000000', '3501094', '32000000', '130000000', '4814004', '复星安泰', '14223194', '张明义', '李德华', '侯旭东', '131291028', '36'}",4958778,10,"{'131291028', '1200000000', '3501094', '21881838', '44000000', '32000000', '130000000', '4814004', '14223194', '200000000'}",9,"{'黄华', '现金', '劲嘉创投', '定价', '复星安泰', '张明义', '李德华', '侯旭东', '36'}",9,"{'黄华', '现金', '劲嘉创投', '定价', '复星安泰', '张明义', '李德华', '侯旭东', '36'}"
19,"{'36', '现金', '8000000', '华安基金管理有限公司', '9600000', '4000000', '博时基金管理有限公司', '融通基金管理有限公司', '7000000', '易方达基金管理有限公司', '11000000', '竞价', '太原重型机械集团有限公司', '鹏华基金管理有限公司', '中国人寿资产管理有限公司', '泰康资产管理有限责任公司', '10000000', '太原重型机械(集团)制造有限公司', '12'}",1346185,5,"{'9600000', '11000000', '竞价', '10000000', '8000000'}",12,"{'36', '现金', '华安基金管理有限公司', '12', '博时基金管理有限公司', '融通基金管理有限公司', '易方达基金管理有限公司', '鹏华基金管理有限公司', '中国人寿资产管理有限公司', '泰康资产管理有限责任公司', '太原重型机械(集团)制造有限公司', '太原重型机械集团有限公司'}",14,"{'36', '现金', '华安基金管理有限公司', '4000000', '博时基金管理有限公司', '融通基金管理有限公司', '7000000', '易方达基金管理有限公司', '太原重型机械集团有限公司', '鹏华基金管理有限公司', '中国人寿资产管理有限公司', '泰康资产管理有限责任公司', '太原重型机械(集团)制造有限公司', '12'}"
4,"{'现金', '竞价', '黄伟兴', '36'}",575951,1,{'竞价'},3,"{'现金', '黄伟兴', '36'}",3,"{'现金', '黄伟兴', '36'}"
3,"{'现金', '36', '北京中环投资管理有限公司'}",16194717,0,set(),3,"{'现金', '36', '北京中环投资管理有限公司'}",3,"{'现金', '36', '北京中环投资管理有限公司'}"
20,"{'上海东方明珠(集团)股份有限公司', '5000000', '陕西省广播电视信息网络有限责任公司', '现金', '9600000', '无锡华光锅炉股份有限公司', '4500000', '新华人寿保险股份有限公司', '12', '4000000', '定价', '深圳市晓杨科技投资有限公司', '华夏基金管理有限公司', '5500000', '义格投资有限公司', '华泰信用担保有限公司', '富国基金管理有限公司', '中国人寿资产管理有限公司', '16600000', '36'}",1371649,1,{'16600000'},7,"{'现金', '陕西省广播电视信息网络有限责任公司', '华夏基金管理有限公司', '12', '定价', '富国基金管理有限公司', '36'}",19,"{'5000000', '现金', '陕西省广播电视信息网络有限责任公司', '9600000', '无锡华光锅炉股份有限公司', '4500000', '新华人寿保险股份有限公司', '12', '4000000', '深圳市晓杨科技投资有限公司', '华夏基金管理有限公司', '定价', '5500000', '义格投资有限公司', '华泰信用担保有限公司', '富国基金管理有限公司', '中国人寿资产管理有限公司', '上海东方明珠(集团)股份有限公司', '36'}"
21,"{'20000000', '孟繁诰', '6000000', '281960000', '19000000', '现金', '38000000', '371000000', '89040000', '郑利彬', '竞价', '泓融投资', '马玲芝', '563920000', '29680000', '蒋元生', '25000000', '东吴汇增2号集合资产管理计划', '296800000', '2000000', '36'}",1582768,13,"{'20000000', '38000000', '371000000', '29680000', '563920000', '296800000', '89040000', '281960000', '2000000', '竞价', '25000000', '6000000', '19000000'}",7,"{'现金', '泓融投资', '马玲芝', '蒋元生', '郑利彬', '孟繁诰', '36'}",8,"{'现金', '泓融投资', '马玲芝', '郑利彬', '蒋元生', '孟繁诰', '东吴汇增2号集合资产管理计划', '36'}"
13,"{'现金', '269100000', '2315300000', '立厦投资', '竞价', '北京中天瑞恒', '50000000', '299000000', '北京博维时代', '睿康投资', '387173913', '36', '45000000'}",1816364,1,{'竞价'},6,"{'现金', '立厦投资', '北京中天瑞恒', '北京博维时代', '睿康投资', '36'}",12,"{'现金', '269100000', '2315300000', '立厦投资', '北京中天瑞恒', '50000000', '299000000', '北京博维时代', '睿康投资', '387173913', '36', '45000000'}"
21,"{'81900000', '北京瑞丰投资管理有限公司', '天平汽车保险股份有限公司', '韩运镇', '6500000', '兴业全球基金管理有限公司', '63806400', '6200000', '85680000', '7300000', '民生加银基金管理有限公司', '国华人寿保险股份有限公司', '79380000', '山南智佳投资咨询有限公司', '6300000', '广东温氏投资有限公司', '5064000', '78120000', '91980000', '12', '6800000'}",718340,8,"{'81900000', '63806400', '79380000', '78120000', '6300000', '7300000', '85680000', '91980000'}",2,"{'北京瑞丰投资管理有限公司', '12'}",13,"{'北京瑞丰投资管理有限公司', '5064000', '民生加银基金管理有限公司', '兴业全球基金管理有限公司', '天平汽车保险股份有限公司', '韩运镇', '国华人寿保险股份有限公司', '山南智佳投资咨询有限公司', '6200000', '广东温氏投资有限公司', '6500000', '12', '6800000'}"
6,"{'现金', '定价', '东北制药集团有限责任公司', '350100000', '30000000', '36'}",1396272,1,{'350100000'},4,"{'东北制药集团有限责任公司', '定价', '现金', '36'}",5,"{'现金', '定价', '东北制药集团有限责任公司', '30000000', '36'}"
27,"{'800000000', '中兵投资驰宏锌锗计划', '202907700', '165680473', '118343195', '24012745', '23668639', '徐晓雒', '200000000', '现金', '定价', '94674556', '金润中泽', '300000000', '35502958', '150000000', '三峡金石基金', '三峡资本', '员工持股计划', '郑积华', '1400000000', '17751479', '苏庭宝', '冶金集团', '1000000000', '国华人寿', '36'}",10625416,7,"{'800000000', '150000000', '202907700', '1000000000', '300000000', '1400000000', '200000000'}",13,"{'中兵投资驰宏锌锗计划', '现金', '三峡金石基金', '冶金集团', '定价', '三峡资本', '员工持股计划', '金润中泽', '郑积华', '徐晓雒', '国华人寿', '苏庭宝', '36'}",20,"{'中兵投资驰宏锌锗计划', '现金', '三峡金石基金', '165680473', '冶金集团', '118343195', '24012745', '94674556', '三峡资本', '员工持股计划', '定价', '金润中泽', '郑积华', '23668639', '17751479', '国华人寿', '徐晓雒', '苏庭宝', '36', '35502958'}"
4,"{'光明食品集团', '竞价', '现金', '36'}",1113211,1,{'竞价'},3,"{'光明食品集团', '现金', '36'}",3,"{'光明食品集团', '现金', '36'}"
18,"{'现金', '北信瑞丰基金管理有限公司', '深圳天风天成资产管理有限公司', '40497400', '12', '国寿安保基金管理有限公司', '信诚基金管理有限公司', '43925200', '上海金元百利资产管理有限公司', '竞价', '39771500', '申万菱信基金管理有限公司', '61787400', '江苏爱康实业集团有限公司', '建信基金管理有限责任公司', '天治基金管理有限公司', '36', '52647900'}",2029915,1,{'竞价'},12,"{'36', '现金', '北信瑞丰基金管理有限公司', '深圳天风天成资产管理有限公司', '国寿安保基金管理有限公司', '信诚基金管理有限公司', '上海金元百利资产管理有限公司', '申万菱信基金管理有限公司', '江苏爱康实业集团有限公司', '建信基金管理有限责任公司', '天治基金管理有限公司', '12'}",17,"{'现金', '北信瑞丰基金管理有限公司', '深圳天风天成资产管理有限公司', '40497400', '12', '国寿安保基金管理有限公司', '信诚基金管理有限公司', '43925200', '上海金元百利资产管理有限公司', '39771500', '申万菱信基金管理有限公司', '61787400', '江苏爱康实业集团有限公司', '建信基金管理有限责任公司', '天治基金管理有限公司', '36', '52647900'}"
18,"{'13071895', '博时资本管理有限公司', '华安基金管理有限公司', '16339869', '工银瑞信基金管理有限公司', '定价', '283000045.5', '财通基金管理有限公司', '易方达基金管理有限公司', '天弘基金管理有限公司', '426999988.8', '18496735', '249999995.7', '创金合信基金管理有限公司', '199999993.5', '12', '27908496', '中民华恒投资有限公司'}",1677415,0,set(),3,"{'定价', '12', '中民华恒投资有限公司'}",18,"{'13071895', '博时资本管理有限公司', '华安基金管理有限公司', '16339869', '工银瑞信基金管理有限公司', '定价', '283000045.5', '财通基金管理有限公司', '易方达基金管理有限公司', '天弘基金管理有限公司', '426999988.8', '18496735', '249999995.7', '创金合信基金管理有限公司', '199999993.5', '12', '27908496', '中民华恒投资有限公司'}"
6,"{'现金', '陈志江', '竞价', '53009200', '36', '401279644'}",4944833,2,"{'竞价', '401279644'}",3,"{'陈志江', '现金', '36'}",4,"{'36', '陈志江', '现金', '53009200'}"
18,"{'7149161', '现金', '兴证证券资产管理有限公司', '11473962', '诺安基金管理有限公司', '申万菱信(上海)资产管理有限公司', '财通基金管理有限公司', '74999988.69', '杭州城投投资有限公司', '竞价', '浙江财通资本投资有限公司', '杭州金投建设发展有限公司', '6619593', '129999989.5', '19898505', '80999994.13', '225450061.7', '12'}",1830578,4,"{'129999989.5', '74999988.69', '80999994.13', '225450061.7'}",9,"{'现金', '兴证证券资产管理有限公司', '诺安基金管理有限公司', '财通基金管理有限公司', '杭州金投建设发展有限公司', '浙江财通资本投资有限公司', '竞价', '杭州城投投资有限公司', '12'}",14,"{'7149161', '现金', '兴证证券资产管理有限公司', '11473962', '诺安基金管理有限公司', '申万菱信(上海)资产管理有限公司', '财通基金管理有限公司', '杭州城投投资有限公司', '杭州金投建设发展有限公司', '浙江财通资本投资有限公司', '竞价', '6619593', '19898505', '12'}"
5,"{'现金', '932761400', '冶金集团', '竞价', '36'}",1773671,1,{'932761400'},4,"{'冶金集团', '竞价', '现金', '36'}",4,"{'冶金集团', '竞价', '现金', '36'}"
28,"{'26687116', '常州产业投资集团有限公司', '33500020.8', '江苏旷达创业投资有限公司', '现金', '上海纺织投资管理有限公司', '财通基金管理有限公司', '竞价', '119999993.6', '26917178', '175500000.6', '149999993.7', '平安大华基金管理有限公司', '36', '北信瑞丰基金管理有限公司', '东证融汇证券资产管理有限公司', '275999997.8', '首誉光控资产管理有限公司', '5138040', '17024539', '18404907', '23006134', '42331288', '110999994.3', '129999998', '173999996.3', '19938650', '12'}",15363080,4,"{'275999997.8', '110999994.3', '175500000.6', '149999993.7'}",12,"{'平安大华基金管理有限公司', '36', '现金', '北信瑞丰基金管理有限公司', '上海纺织投资管理有限公司', '东证融汇证券资产管理有限公司', '财通基金管理有限公司', '竞价', '首誉光控资产管理有限公司', '常州产业投资集团有限公司', '12', '江苏旷达创业投资有限公司'}",24,"{'26687116', '常州产业投资集团有限公司', '33500020.8', '江苏旷达创业投资有限公司', '现金', '上海纺织投资管理有限公司', '财通基金管理有限公司', '119999993.6', '竞价', '26917178', '平安大华基金管理有限公司', '36', '北信瑞丰基金管理有限公司', '东证融汇证券资产管理有限公司', '首誉光控资产管理有限公司', '5138040', '17024539', '18404907', '23006134', '42331288', '129999998', '173999996.3', '19938650', '12'}"
25,"{'邓栋', '马剑', '3000000', '5000000', '现金', '阮海明', '定价', '周新华', '82080000', '5400000', '118560000', '45600000', '9000000', '饶陆华', '246240000', '林训先', '聂志勇', '黄幼平', '49248000', '13000000', '27360000', '深圳市创东方慈爱投资企业(有限合伙)', '27000000', '上海景贤投资有限公司', '36'}",313509,0,set(),12,"{'现金', '饶陆华', '邓栋', '马剑', '阮海明', '定价', '周新华', '林训先', '聂志勇', '黄幼平', '上海景贤投资有限公司', '36'}",25,"{'邓栋', '马剑', '3000000', '5000000', '现金', '阮海明', '定价', '周新华', '82080000', '5400000', '118560000', '45600000', '9000000', '饶陆华', '246240000', '林训先', '聂志勇', '黄幼平', '49248000', '13000000', '27360000', '深圳市创东方慈爱投资企业(有限合伙)', '27000000', '上海景贤投资有限公司', '36'}"
28,"{'3833866', '59999987.25', '10000350', '5600000', '19875500', '现金', '上海远洋渔业有限公司', '定价', '60000002.9', '王梅', '财通基金管理有限公司', '联储证券有限责任公司', '12999985.5', '14663526', '87640000', '36', '上海市北高新股份有限公司', '830670', '229484181.9', '华福证券有限责任公司', '大连隆泰创业投资有限责任公司', '1270000', '7667731', '隋启海', '119999990.2', '639000', '12', '3833865'}",18273897,1,{'119999990.2'},12,"{'36', '现金', '上海远洋渔业有限公司', '上海市北高新股份有限公司', '定价', '隋启海', '王梅', '财通基金管理有限公司', '联储证券有限责任公司', '华福证券有限责任公司', '大连隆泰创业投资有限责任公司', '12'}",27,"{'3833866', '59999987.25', '10000350', '5600000', '19875500', '现金', '上海远洋渔业有限公司', '定价', '60000002.9', '王梅', '财通基金管理有限公司', '联储证券有限责任公司', '12999985.5', '14663526', '87640000', '36', '上海市北高新股份有限公司', '830670', '229484181.9', '华福证券有限责任公司', '大连隆泰创业投资有限责任公司', '1270000', '7667731', '隋启海', '639000', '12', '3833865'}"
27,"{'258463975.4', '国联安基金管理有限公司', '420023983.5', '易方达基金管理有限公司', '169765', '417007970.9', '223344000', '9145067', '现金', '兴业全球基金管理有限公司', '工银瑞信基金管理有限公司', '安徽省投资集团控股有限公司', '竞价', '212029982.3', '211183973.9', '8332172', '6835267', '283679978.3', '13540425', '6807994', '5266110.3', '招商财富资产管理有限公司', '英大基金管理有限公司', '嘉实基金管理有限公司', '13443197', '7200000', '12'}",342506,2,"{'211183973.9', '竞价'}",10,"{'招商财富资产管理有限公司', '现金', '兴业全球基金管理有限公司', '工银瑞信基金管理有限公司', '英大基金管理有限公司', '国联安基金管理有限公司', '嘉实基金管理有限公司', '安徽省投资集团控股有限公司', '易方达基金管理有限公司', '12'}",25,"{'258463975.4', '国联安基金管理有限公司', '420023983.5', '易方达基金管理有限公司', '169765', '417007970.9', '223344000', '9145067', '现金', '兴业全球基金管理有限公司', '工银瑞信基金管理有限公司', '安徽省投资集团控股有限公司', '212029982.3', '8332172', '6835267', '283679978.3', '13540425', '6807994', '5266110.3', '招商财富资产管理有限公司', '英大基金管理有限公司', '嘉实基金管理有限公司', '13443197', '7200000', '12'}"
17,"{'四川星光宾馆', '现金', '富通银行', '8000000', '武汉华虹科技投资管理有限公司', '华夏基金管理有限公司', '四川省乾盛投资有限公司', '定价', '长江证券有限责任公司', '7000000', '西安华明投资有限公司', '丹东海联投资有限公司', '3000000', '6000000', '10000000', '12', '湖南嘉宇实业有限公司'}",536037,2,"{'定价', '7000000'}",2,"{'现金', '12'}",15,"{'四川星光宾馆', '现金', '富通银行', '8000000', '武汉华虹科技投资管理有限公司', '华夏基金管理有限公司', '四川省乾盛投资有限公司', '长江证券有限责任公司', '西安华明投资有限公司', '丹东海联投资有限公司', '3000000', '6000000', '10000000', '12', '湖南嘉宇实业有限公司'}"
11,"{'499999994.5', '67385444', '兴业全球基金管理有限公司', '国华人寿保险股份有限公司', '299999993.7', '41000000', '304220000', '竞价', '中信建投基金管理有限公司', '安信基金管理有限责任公司', '40431266'}",4937222,2,"{'499999994.5', '67385444'}",5,"{'兴业全球基金管理有限公司', '国华人寿保险股份有限公司', '中信建投基金管理有限公司', '竞价', '安信基金管理有限责任公司'}",9,"{'兴业全球基金管理有限公司', '国华人寿保险股份有限公司', '299999993.7', '41000000', '304220000', '中信建投基金管理有限公司', '竞价', '安信基金管理有限责任公司', '40431266'}"
30,"{'义乌上达股权投资基金合伙企业(有限合伙)', '299999409.8', '长城定增一号集合资产管理计划', '59760000', '广州市鸿众投资合伙企业(有限合伙)', '西域和谐3号定增证券投资基金', '200000040.3', '200000007.1', '90361268', '定价', '60240976', '18000000', '17180728', '江门市弘晟投资合伙企业(有限合伙)', '苏州上达股权投资基金合伙企业(有限合伙)', '拉萨经济技术开发区泰通投资合伙企业(有限合伙)', '10000000', '259036148', '张宇', '999999995.8', '拉萨亚祥兴泰投资有限公司', '860000011.4', '33200000', '金鹰穗通5号资产管理计划', '60240966', '96385548', '301204818', '57040016.96', '36', '320000019.4'}",1888294,5,"{'定价', '299999409.8', '999999995.8', '860000011.4', '320000019.4'}",4,"{'拉萨亚祥兴泰投资有限公司', '长城定增一号集合资产管理计划', '张宇', '36'}",25,"{'义乌上达股权投资基金合伙企业(有限合伙)', '59760000', '广州市鸿众投资合伙企业(有限合伙)', '西域和谐3号定增证券投资基金', '200000040.3', '200000007.1', '90361268', '18000000', '60240976', '17180728', '江门市弘晟投资合伙企业(有限合伙)', '苏州上达股权投资基金合伙企业(有限合伙)', '拉萨经济技术开发区泰通投资合伙企业(有限合伙)', '10000000', '36', '259036148', '张宇', '拉萨亚祥兴泰投资有限公司', '33200000', '金鹰穗通5号资产管理计划', '60240966', '96385548', '301204818', '57040016.96', '长城定增一号集合资产管理计划'}"
18,"{'224400000', '吉林丰成顺农业有限公司', '40000000', '李利伟', '38000000', '定价', '财通基金管理有限公司', '北京顶尖私行资本管理有限公司', '29903622', '374000000', '50000000', '高仕军', '223679092.6', '284240000', '中建明茂(北京)投资发展有限公司', '299200000', '30000000', '12'}",14468660,2,"{'定价', '223679092.6'}",6,"{'吉林丰成顺农业有限公司', '李利伟', '12', '财通基金管理有限公司', '高仕军', '北京顶尖私行资本管理有限公司'}",16,"{'224400000', '吉林丰成顺农业有限公司', '40000000', '李利伟', '38000000', '12', '财通基金管理有限公司', '284240000', '29903622', '374000000', '50000000', '高仕军', '中建明茂(北京)投资发展有限公司', '299200000', '30000000', '北京顶尖私行资本管理有限公司'}"
3,"{'定价', '36', '高金科技'}",941634,0,set(),3,"{'定价', '36', '高金科技'}",3,"{'定价', '36', '高金科技'}"
5,"{'现金', '155505107', '华侨城投资管理公司', '竞价', '36'}",9023225,1,{'155505107'},4,"{'华侨城投资管理公司', '现金', '竞价', '36'}",4,"{'华侨城投资管理公司', '现金', '竞价', '36'}"
17,"{'现金', '7256894', '金石期货(设立“金石新招3号”)', '100000000', '843000000', '现代农业投资', '定价', '14513788', '天富智盛', '43541364', '信时投资', '300000000', '50000000', '天信投资', '石河子城投', '36', '122351233'}",16878640,4,"{'100000000', '843000000', '300000000', '50000000'}",8,"{'现金', '现代农业投资', '定价', '天富智盛', '信时投资', '天信投资', '36', '石河子城投'}",13,"{'7256894', '现金', '金石期货(设立“金石新招3号”)', '现代农业投资', '定价', '14513788', '天富智盛', '43541364', '信时投资', '天信投资', '石河子城投', '36', '122351233'}"
6,"{'现金', '步步高集团', '250000000', '竞价', '16983695', '36'}",15519757,1,{'16983695'},4,"{'竞价', '现金', '36', '步步高集团'}",5,"{'现金', '步步高集团', '250000000', '竞价', '36'}"
6,"{'现金', '37476577', '定价', '300000000', '中国南方工业集团公司', '36'}",309485,0,set(),4,"{'现金', '中国南方工业集团公司', '定价', '36'}",6,"{'现金', '37476577', '定价', '300000000', '中国南方工业集团公司', '36'}"
4,"{'通飞公司', '现金', '竞价', '36'}",203610,0,set(),4,"{'通飞公司', '现金', '竞价', '36'}",4,"{'通飞公司', '现金', '竞价', '36'}"
4,"{'竞价', '现金', '36', '中国恒天'}",1079596,0,set(),4,"{'竞价', '现金', '36', '中国恒天'}",4,"{'竞价', '现金', '36', '中国恒天'}"
20,"{'54488000', '现金', '北信瑞丰基金管理有限公司', '第一创业证券股份有限公司', '27800000', '定价', '4000000', '东海基金管理有限责任公司', '财通基金管理有限公司', '2000000', '55600000', '诺安基金管理有限公司', '32665000', '18246530', '3920000', '华泰柏瑞基金管理有限公司', '1312700', '12', '长江投资(芜湖)有限公司', '2350000'}",15726289,0,set(),9,"{'现金', '北信瑞丰基金管理有限公司', '第一创业证券股份有限公司', '诺安基金管理有限公司', '定价', '东海基金管理有限责任公司', '财通基金管理有限公司', '12', '华泰柏瑞基金管理有限公司'}",20,"{'54488000', '现金', '北信瑞丰基金管理有限公司', '第一创业证券股份有限公司', '27800000', '4000000', '诺安基金管理有限公司', '东海基金管理有限责任公司', '财通基金管理有限公司', '2000000', '55600000', '32665000', '定价', '18246530', '3920000', '华泰柏瑞基金管理有限公司', '1312700', '12', '长江投资(芜湖)有限公司', '2350000'}"
12,"{'现金', '29108639', '991440267', '定价', '87325918', '495720133', '北京京国瑞国企改革发展基金(有限合伙)', '三胞集团南京投资管理有限公司', '上海懿兆实业投资有限公司', '36', '1487160400', '58217279'}",14705542,3,"{'991440267', '495720133', '1487160400'}",3,"{'定价', '现金', '36'}",9,"{'现金', '87325918', '定价', '北京京国瑞国企改革发展基金(有限合伙)', '三胞集团南京投资管理有限公司', '上海懿兆实业投资有限公司', '36', '29108639', '58217279'}"
20,"{'50556117', '现金', '华夏寿险', '237999991.8', '泰康资管', '19211324', '天安财险', '24064711', '隆达创展', '499999997.1', '189999994.4', '15166835', '299999996.3', '华泰柏瑞', '149999998.2', '12335694', '申万菱信', '122000013.7', '12', '30333670'}",1853492,4,"{'122000013.7', '189999994.4', '237999991.8', '149999998.2'}",8,"{'泰康资管', '华夏寿险', '现金', '天安财险', '隆达创展', '华泰柏瑞', '申万菱信', '12'}",16,"{'50556117', '泰康资管', '华夏寿险', '现金', '19211324', '天安财险', '24064711', '隆达创展', '499999997.1', '15166835', '299999996.3', '华泰柏瑞', '12335694', '申万菱信', '12', '30333670'}"
19,"{'云南省工业投资控股集团有限责任公司', '72376980', '中国信达资产管理股份有限公司', '18014724', '817950959', '20174116', '云天化集团有限责任公司', '12', '云南金星化工有限公司', '定价', '1176257', '38280985', '云南铜业(集团)有限公司', '云南冶金集团股份有限公司', '2353332', '4706665', '36', '云南江磷集团股份有限公司', '云南省投资控股集团有限公司'}",231331,0,set(),10,"{'36', '云南省工业投资控股集团有限责任公司', '中国信达资产管理股份有限公司', '云天化集团有限责任公司', '云南金星化工有限公司', '定价', '云南冶金集团股份有限公司', '12', '云南江磷集团股份有限公司', '云南省投资控股集团有限公司'}",19,"{'云南省工业投资控股集团有限责任公司', '72376980', '中国信达资产管理股份有限公司', '18014724', '817950959', '20174116', '云天化集团有限责任公司', '12', '云南金星化工有限公司', '1176257', '定价', '38280985', '云南铜业(集团)有限公司', '云南冶金集团股份有限公司', '2353332', '4706665', '36', '云南江磷集团股份有限公司', '云南省投资控股集团有限公司'}"
16,"{'现金', '东方证券-东方红2号集合资产管理计划', '兴业证券股份有限公司', '东海证券-东风一号集合资产管理计划', '上海博润投资有限公司', '7000000', '华宝信托投资有限责任公司', '云南国际信托投资有限公司', '兴业基金-兴业全球视野证券投资基金', '红塔证券股份有限公司', '武汉万业投资发展有限公司', '3000000', '6000000', '8000000', '12', '东海证券有限责任公司'}",931721,1,{'8000000'},1,{'12'},15,"{'现金', '东方证券-东方红2号集合资产管理计划', '兴业证券股份有限公司', '东海证券-东风一号集合资产管理计划', '上海博润投资有限公司', '7000000', '华宝信托投资有限责任公司', '云南国际信托投资有限公司', '兴业基金-兴业全球视野证券投资基金', '红塔证券股份有限公司', '武汉万业投资发展有限公司', '3000000', '6000000', '12', '东海证券有限责任公司'}"
17,"{'20000000', '现金', '梁昭平', '5308560', '80000000', '道杰投资', '员工持股计划', '3317850', '50000000', '7405441', '梁武', '7500000', '李守军', '111600000', '1327140', '36', '497677'}",1808839,8,"{'5308560', '3317850', '50000000', '7405441', '497677', '111600000', '1327140', '7500000'}",7,"{'梁昭平', '现金', '道杰投资', '员工持股计划', '梁武', '李守军', '36'}",9,"{'20000000', '现金', '梁昭平', '道杰投资', '员工持股计划', '梁武', '李守军', '80000000', '36'}"
15,"{'吴光明', '现金', '西藏瑞华', '3970505', '盛宇投资', '1701644', '定价', '5104935', '朱雀投资', '2836075', '华润万东医疗装备股份有限公司2015年度员工持股计划', '宋文雷', '5672150', '云锋新创', '36'}",1661105,0,set(),9,"{'吴光明', '现金', '西藏瑞华', '盛宇投资', '定价', '朱雀投资', '宋文雷', '云锋新创', '36'}",15,"{'吴光明', '现金', '西藏瑞华', '3970505', '盛宇投资', '1701644', '定价', '5104935', '朱雀投资', '2836075', '华润万东医疗装备股份有限公司2015年度员工持股计划', '宋文雷', '5672150', '云锋新创', '36'}"
5,"{'现金', '143376952', '东莞市新世纪科教拓展有限公司', '定价', '36'}",576828,0,set(),4,"{'36', '定价', '现金', '东莞市新世纪科教拓展有限公司'}",5,"{'现金', '东莞市新世纪科教拓展有限公司', '143376952', '定价', '36'}"
9,"{'35584632', '广东省广晟资产经营有限公司', '现金', '91300000', '竞价', '319550000', '广发恒定15号国星光电定向增发集合资产管理计划', '10167037', '36'}",1683696,3,"{'竞价', '319550000', '91300000'}",4,"{'广发恒定15号国星光电定向增发集合资产管理计划', '广东省广晟资产经营有限公司', '现金', '36'}",6,"{'35584632', '广东省广晟资产经营有限公司', '现金', '广发恒定15号国星光电定向增发集合资产管理计划', '10167037', '36'}"
16,"{'现金', '上海万峰房地产有限公司', '江苏瑞华投资发展有限公司', '浙商证券有限责任公司', '诺安基金管理有限公司', '厦门象屿集团有限公司', '7000000', '上海汉晟信投资有限公司', '兴业基金管理有限公司', '竞价', '10000000', '中国人寿资产管理有限公司', '8000000', '中海基金管理有限公司', '12', '5190000'}",1342739,1,{'竞价'},3,"{'现金', '12', '中国人寿资产管理有限公司'}",15,"{'现金', '上海万峰房地产有限公司', '江苏瑞华投资发展有限公司', '浙商证券有限责任公司', '诺安基金管理有限公司', '厦门象屿集团有限公司', '7000000', '上海汉晟信投资有限公司', '兴业基金管理有限公司', '10000000', '中国人寿资产管理有限公司', '8000000', '中海基金管理有限公司', '12', '5190000'}"
6,"{'现金', '65000000', '506350000', '定价', '上海电气(集团)总公司', '36'}",1329332,2,"{'65000000', '506350000'}",3,"{'定价', '现金', '36'}",4,"{'定价', '现金', '上海电气(集团)总公司', '36'}"
24,"{'20000000', '325500000', '50000000', '620000000', '310000000', '新余顺全隆', '现金', '新余宏兴成', '40000000', '55000000', '82500000', '竞价', '中金达合', '新余顺兴隆', '341000000', '波巴贸易', '52500000', '100000000', '248000000', '124000000', '天晟鼎合', '511500000', '36', '中金宇合'}",359274,15,"{'20000000', '40000000', '100000000', '55000000', '248000000', '124000000', '82500000', '325500000', '341000000', '竞价', '50000000', '620000000', '511500000', '310000000', '52500000'}",9,"{'波巴贸易', '现金', '新余宏兴成', '新余顺兴隆', '中金达合', '天晟鼎合', '36', '中金宇合', '新余顺全隆'}",9,"{'36', '现金', '新余宏兴成', '新余顺兴隆', '中金达合', '天晟鼎合', '波巴贸易', '中金宇合', '新余顺全隆'}"
4,"{'浪潮软件集团有限公司', '现金', '竞价', '36'}",1784724,0,set(),4,"{'浪潮软件集团有限公司', '现金', '竞价', '36'}",4,"{'浪潮软件集团有限公司', '现金', '竞价', '36'}"
3,"{'36', '现金', '武钢集团'}",1272452,0,set(),3,"{'现金', '36', '武钢集团'}",3,"{'36', '现金', '武钢集团'}"
12,"{'5483700', '现金', '4500000', '12', '定价', '宝山钢铁股份有限公司', '财通基金管理有限公司', '国泰基金管理有限公司', '12883928', '海通证券股份有限公司', '36', '346657'}",909748,3,"{'5483700', '宝山钢铁股份有限公司', '4500000'}",7,"{'36', '现金', '定价', '财通基金管理有限公司', '国泰基金管理有限公司', '海通证券股份有限公司', '12'}",9,"{'36', '现金', '定价', '财通基金管理有限公司', '国泰基金管理有限公司', '12883928', '海通证券股份有限公司', '12', '346657'}"
6,"{'现金', '352310000', '42243500', '竞价', '36', '东北制药首期员工持股计划'}",1855403,3,"{'42243500', '竞价', '352310000'}",3,"{'现金', '36', '东北制药首期员工持股计划'}",3,"{'现金', '36', '东北制药首期员工持股计划'}"
20,"{'上银瑞金资产管理(上海)有限公司', '招商财富资产管理有限公司', '18251362', '青岛荣瑞品实业有限公司', '12', '天通高新集团有限公司', '国华人寿保险股份有限公司', '36330608', '东海基金管理有限责任公司', '竞价', '周蓉', '31676021', '10500000', '19981834', '1334653', '27247956', '华富基金管理有限公司', '杭州羽南实业有限公司', '36', '18165304'}",134023,0,set(),11,"{'招商财富资产管理有限公司', '36', '青岛荣瑞品实业有限公司', '天通高新集团有限公司', '国华人寿保险股份有限公司', '东海基金管理有限责任公司', '竞价', '周蓉', '华富基金管理有限公司', '杭州羽南实业有限公司', '12'}",20,"{'上银瑞金资产管理(上海)有限公司', '招商财富资产管理有限公司', '18251362', '青岛荣瑞品实业有限公司', '12', '天通高新集团有限公司', '国华人寿保险股份有限公司', '36330608', '东海基金管理有限责任公司', '竞价', '周蓉', '31676021', '10500000', '19981834', '1334653', '27247956', '华富基金管理有限公司', '杭州羽南实业有限公司', '36', '18165304'}"
11,"{'东方星空', '57072698', '浙江发展', '595674536', '定价', '千禧龙', '二轻集团', '99085821', '华数集团', '169184247', '36'}",912387,0,set(),7,"{'东方星空', '浙江发展', '千禧龙', '定价', '二轻集团', '华数集团', '36'}",11,"{'东方星空', '57072698', '浙江发展', '595674536', '千禧龙', '定价', '二轻集团', '99085821', '华数集团', '169184247', '36'}"
9,"{'现金', '北信瑞丰基金管理有限公司', '辽宁交通投资有限责任公司', '国寿安保基金管理有限公司', '竞价', '999999997', '184842883', '建信基金管理有限责任公司', '12'}",19330582,0,set(),7,"{'现金', '北信瑞丰基金管理有限公司', '辽宁交通投资有限责任公司', '国寿安保基金管理有限公司', '竞价', '建信基金管理有限责任公司', '12'}",9,"{'现金', '北信瑞丰基金管理有限公司', '辽宁交通投资有限责任公司', '国寿安保基金管理有限公司', '竞价', '999999997', '184842883', '建信基金管理有限责任公司', '12'}"
18,"{'江苏凤凰出版传媒集团有限公司', '现金', '博时资本管理有限公司', '25839793', '兴业全球基金管理有限公司', '20671834', '12', '诺安基金管理有限公司', '定价', '招商基金管理有限公司', '建信基金管理有限责任公司', '财通基金管理有限公司', '33439276', '32299740', '41478048', '22222222', '36', '19509043'}",1874077,0,set(),5,"{'江苏凤凰出版传媒集团有限公司', '现金', '12', '定价', '36'}",18,"{'江苏凤凰出版传媒集团有限公司', '现金', '博时资本管理有限公司', '25839793', '兴业全球基金管理有限公司', '20671834', '12', '诺安基金管理有限公司', '建信基金管理有限责任公司', '招商基金管理有限公司', '定价', '财通基金管理有限公司', '33439276', '32299740', '41478048', '22222222', '36', '19509043'}"
23,"{'4000000', '朱崐', '周雪钦', '3000000', '合众人寿保险股份有限公司', '68940000', '22980000', '19022997', '工银瑞信基金管理有限公司', '定价', '30640000', '牛国珠', '9000000', '2500000', '34470000', '19150000', '22214000', '2900000', '上海证大投资管理有限公司', '2483420', '浙江浙商证券资产管理有限公司', '4500000', '12'}",223530,11,"{'22980000', '34470000', '19022997', '19150000', '22214000', '2900000', '2483420', '30640000', '9000000', '68940000', '2500000'}",8,"{'浙江浙商证券资产管理有限公司', '工银瑞信基金管理有限公司', '定价', '朱崐', '周雪钦', '合众人寿保险股份有限公司', '牛国珠', '12'}",12,"{'浙江浙商证券资产管理有限公司', '工银瑞信基金管理有限公司', '4500000', '4000000', '定价', '朱崐', '上海证大投资管理有限公司', '周雪钦', '3000000', '合众人寿保险股份有限公司', '牛国珠', '12'}"
18,"{'620000', '山东皇冠控股集团有限公司', '中航鑫港担保有限公司', '上海申能资产管理有限公司', '中邮创业基金管理有限公司', '定价', '建信基金管理有限责任公司', '1860000', '红塔证券股份有限公司', '信邦投资有限公司', '中金创业国际投资管理有限公司', '800000', '国泰基金管理有限公司', '3100000', '330000', '930000', '12', '经纬国债咨询有限责任公司'}",1531488,4,"{'620000', '330000', '山东皇冠控股集团有限公司', '930000'}",2,"{'定价', '12'}",14,"{'中航鑫港担保有限公司', '上海申能资产管理有限公司', '中邮创业基金管理有限公司', '定价', '1860000', '红塔证券股份有限公司', '信邦投资有限公司', '中金创业国际投资管理有限公司', '800000', '国泰基金管理有限公司', '3100000', '建信基金管理有限责任公司', '12', '经纬国债咨询有限责任公司'}"
9,"{'36', '中住地产', '中国高新投资集团公司', '湖南华夏科技投资发展有限公司', '929317500', '西安紫薇地产开发有限公司', '湖南长沙一心实业有限公司', '湖南瀚海贸易有限公司', '12'}",808112,1,{'929317500'},8,"{'36', '中住地产', '湖南华夏科技投资发展有限公司', '中国高新投资集团公司', '西安紫薇地产开发有限公司', '湖南长沙一心实业有限公司', '湖南瀚海贸易有限公司', '12'}",8,"{'36', '中住地产', '湖南华夏科技投资发展有限公司', '中国高新投资集团公司', '西安紫薇地产开发有限公司', '湖南长沙一心实业有限公司', '湖南瀚海贸易有限公司', '12'}"
22,"{'博时资本管理有限公司', '822294640', '申万菱信(上海)资产管理有限公司', '赵素菲', '49554000', '定价', '财通基金管理有限公司', '39643000', '679985280', '33696000', '国华人寿保险股份有限公司', '29732000', '799995740', '44487000', '招商财富资产管理有限公司', '897747660', '40748000', '中国银河证券股份有限公司', '599991760', '999999720', '创金合信基金管理有限公司', '12'}",1682341,6,"{'897747660', '679985280', '822294640', '799995740', '599991760', '999999720'}",9,"{'招商财富资产管理有限公司', '博时资本管理有限公司', '国华人寿保险股份有限公司', '定价', '财通基金管理有限公司', '赵素菲', '中国银河证券股份有限公司', '创金合信基金管理有限公司', '12'}",16,"{'招商财富资产管理有限公司', '39643000', '博时资本管理有限公司', '定价', '33696000', '申万菱信(上海)资产管理有限公司', '财通基金管理有限公司', '29732000', '赵素菲', '40748000', '中国银河证券股份有限公司', '国华人寿保险股份有限公司', '44487000', '创金合信基金管理有限公司', '49554000', '12'}"
17,"{'平安大华基金管理有限公司', '12600000', '现金', '16000000', '12', '12800000', '国联证券股份有限公司', '财通基金管理有限公司', '天弘基金管理有限公司', '无锡威孚高科技集团股份有限公司', '黄伟兴', '10500000', '9300000', '10000000', '万家共赢资产管理有限公司', '36', '汇添富基金管理有限公司'}",1153835,0,set(),4,"{'12', '黄伟兴', '现金', '36'}",17,"{'平安大华基金管理有限公司', '12600000', '现金', '16000000', '12', '12800000', '国联证券股份有限公司', '财通基金管理有限公司', '天弘基金管理有限公司', '无锡威孚高科技集团股份有限公司', '黄伟兴', '10500000', '9300000', '10000000', '万家共赢资产管理有限公司', '36', '汇添富基金管理有限公司'}"
20,"{'7499999370', '广东烟草', '现金', '1499999270', '132450300', '阳光控股', '定价', '60', '1999999530', '66225100', '6499998850', '中国烟草总公司', '99337700', '福建投资集团', '999999010', '496688700', '福建省财政厅', '430463500', '福建烟草', '36'}",10795257,5,"{'132450300', '66225100', '99337700', '496688700', '430463500'}",10,"{'广东烟草', '现金', '阳光控股', '定价', '60', '中国烟草总公司', '福建投资集团', '福建烟草', '福建省财政厅', '36'}",15,"{'7499999370', '广东烟草', '现金', '1499999270', '阳光控股', '60', '定价', '1999999530', '999999010', '6499998850', '中国烟草总公司', '福建投资集团', '福建烟草', '福建省财政厅', '36'}"
14,"{'平安大华基金管理有限公司', '新华基金管理有限公司', '152718387', '61087354', '54978619', '安徽省铁路建设投资基金有限公司', '18821017', '诺安基金管理有限公司', '定价', '财通基金管理有限公司', '嘉实资本管理有限公司', '中国长城资产管理公司', '91136224', '12'}",1757586,0,set(),9,"{'平安大华基金管理有限公司', '新华基金管理有限公司', '安徽省铁路建设投资基金有限公司', '诺安基金管理有限公司', '定价', '财通基金管理有限公司', '嘉实资本管理有限公司', '中国长城资产管理公司', '12'}",14,"{'平安大华基金管理有限公司', '新华基金管理有限公司', '152718387', '61087354', '54978619', '安徽省铁路建设投资基金有限公司', '18821017', '诺安基金管理有限公司', '定价', '财通基金管理有限公司', '嘉实资本管理有限公司', '中国长城资产管理公司', '91136224', '12'}"
24,"{'吕旭幸', '钟婉珍', '上海华富利得资产管理有限公司', '任军', '现金', '曹蕾', '65266944', '陈尧根', '竞价', '9000000', '10000000', '5448530', '269230000', '186390000', '112839056', '沈依伊', '265854374', '217455000', '3151470', '13000000', '207100000', '10500000', '36', '12837005'}",1889104,7,"{'5448530', '3151470', '13000000', '9000000', '10500000', '10000000', '12837005'}",10,"{'吕旭幸', '现金', '曹蕾', '钟婉珍', '陈尧根', '竞价', '沈依伊', '上海华富利得资产管理有限公司', '任军', '36'}",17,"{'吕旭幸', '现金', '269230000', '217455000', '186390000', '曹蕾', '265854374', '钟婉珍', '207100000', '65266944', '陈尧根', '112839056', '竞价', '沈依伊', '上海华富利得资产管理有限公司', '任军', '36'}"
14,"{'8437035', '现金', '华夏基金管理有限公司', '199999979', '12', '6896551', '武汉当代科技产业集团股份有限公司', '财通基金管理有限公司', '嘉实基金管理有限公司', '244674015', '竞价', '290000000', '10000000', '36'}",407920,0,set(),8,"{'36', '现金', '华夏基金管理有限公司', '武汉当代科技产业集团股份有限公司', '财通基金管理有限公司', '嘉实基金管理有限公司', '竞价', '12'}",14,"{'8437035', '现金', '华夏基金管理有限公司', '199999979', '12', '6896551', '武汉当代科技产业集团股份有限公司', '财通基金管理有限公司', '嘉实基金管理有限公司', '244674015', '竞价', '290000000', '10000000', '36'}"
14,"{'36', '陈华娟', '钱旭峰', '3500000', '1000000', '陈光辉', '郑坚江', '定价', '52300000', '李健', '1200000', '蒋盈', '10000000', '郑江'}",501295,4,"{'1200000', '1000000', '10000000', '52300000'}",9,"{'36', '陈华娟', '钱旭峰', '陈光辉', '郑坚江', '定价', '李健', '蒋盈', '郑江'}",10,"{'36', '陈华娟', '钱旭峰', '3500000', '陈光辉', '郑坚江', '定价', '李健', '蒋盈', '郑江'}"
4,"{'36', '竞价', '现金', '武汉凯迪控股投资有限公司'}",1123234,1,{'竞价'},3,"{'36', '现金', '武汉凯迪控股投资有限公司'}",3,"{'36', '现金', '武汉凯迪控股投资有限公司'}"
9,"{'现金', '上海综艺控股有限公司', '定价', '84524934', '新东吴优胜-南京银行-新东吴优胜诚鼎1号专项资产管理计划', '966119995.6', '349199987.4', '36', '30551180'}",14765093,0,set(),4,"{'定价', '现金', '上海综艺控股有限公司', '36'}",9,"{'现金', '上海综艺控股有限公司', '84524934', '定价', '新东吴优胜-南京银行-新东吴优胜诚鼎1号专项资产管理计划', '966119995.6', '349199987.4', '36', '30551180'}"
5,"{'209110000', '现金', '化医集团', '竞价', '36'}",1305031,1,{'209110000'},4,"{'36', '竞价', '现金', '化医集团'}",4,"{'36', '竞价', '现金', '化医集团'}"
5,"{'现金', '振兴集团', '定价', '100832967', '36'}",1843611,1,{'100832967'},4,"{'定价', '36', '现金', '振兴集团'}",4,"{'定价', '36', '现金', '振兴集团'}"
14,"{'252434000', '景顺长城基金管理有限公司', '现金', '13300000', '北信瑞丰基金管理有限公司', '15673981', '306071840.6', '16126019', '21400000', '竞价', '297492159.4', '宝盈基金管理有限公司', '406172000', '浙江浙银资本管理有限公司'}",15346136,2,"{'竞价', '297492159.4'}",1,{'现金'},12,"{'252434000', '景顺长城基金管理有限公司', '13300000', '北信瑞丰基金管理有限公司', '现金', '15673981', '306071840.6', '16126019', '21400000', '宝盈基金管理有限公司', '406172000', '浙江浙银资本管理有限公司'}"
15,"{'陈华娟', '蒋盈', '现金', '钱旭峰', '3500000', '1000000', '陈光辉', '郑坚江', '定价', '52300000', '李健', '1200000', '郑江', '10000000', '36'}",308693,5,"{'3500000', '52300000', '1200000', '10000000', '1000000'}",10,"{'陈华娟', '钱旭峰', '郑江', '现金', '陈光辉', '郑坚江', '定价', '李健', '蒋盈', '36'}",10,"{'陈华娟', '36', '钱旭峰', '现金', '陈光辉', '郑坚江', '定价', '李健', '蒋盈', '郑江'}"
19,"{'36049026', '现金', '深圳市富威特投资合伙企业(有限合伙)', '3604902', '25234318', '深圳市华弘润泽投资发展有限公司', '招证资管-同赢之新纶科技1号员工持股计划', '深圳市国能金汇资产管理有限公司', '28839221', '竞价', '深圳市前海鼎泰宏源投资合伙企业(有限合伙)', '8651766', '深圳市国能金海投资管理企业(有限合伙)', '广西万赛投资管理中心(有限合伙)', '5767844', '7209805', '36', '14419610', '侯毅'}",15568213,1,{'竞价'},5,"{'现金', '深圳市华弘润泽投资发展有限公司', '深圳市国能金汇资产管理有限公司', '36', '侯毅'}",18,"{'36049026', '现金', '深圳市富威特投资合伙企业(有限合伙)', '3604902', '25234318', '深圳市华弘润泽投资发展有限公司', '招证资管-同赢之新纶科技1号员工持股计划', '深圳市国能金汇资产管理有限公司', '28839221', '深圳市前海鼎泰宏源投资合伙企业(有限合伙)', '8651766', '深圳市国能金海投资管理企业(有限合伙)', '广西万赛投资管理中心(有限合伙)', '5767844', '7209805', '36', '14419610', '侯毅'}"
3,"{'36', '现金', '杭州云溪投资合伙企业(有限合伙)'}",780431,1,{'杭州云溪投资合伙企业(有限合伙)'},2,"{'现金', '36'}",2,"{'现金', '36'}"
15,"{'580000000', '12695725', '846381', '现金', '24545069', '20000000', '周文', '定价', '国禹资管', '2115954', '池驰', '300000000', '50000000', '丁劲松', '36'}",4947675,4,"{'580000000', '20000000', '300000000', '50000000'}",7,"{'现金', '周文', '定价', '国禹资管', '池驰', '丁劲松', '36'}",11,"{'12695725', '846381', '现金', '24545069', '周文', '定价', '国禹资管', '2115954', '池驰', '丁劲松', '36'}"
16,"{'平安大华基金管理有限公司', '8510000', '北京中电新能投资中心(有限合伙)', '7790000', '13680000', '21290000', '1050000', '北京点石汇鑫投资管理有限公司', '上海证大投资管理有限公司', '财通基金管理有限公司', '长江证券股份有限公司', '竞价', '开源证券有限责任公司', '10000000', '12', '东海证券有限责任公司'}",1148812,2,"{'21290000', '1050000'}",9,"{'平安大华基金管理有限公司', '北京点石汇鑫投资管理有限公司', '上海证大投资管理有限公司', '财通基金管理有限公司', '长江证券股份有限公司', '竞价', '开源证券有限责任公司', '12', '东海证券有限责任公司'}",14,"{'平安大华基金管理有限公司', '8510000', '北京中电新能投资中心(有限合伙)', '7790000', '13680000', '北京点石汇鑫投资管理有限公司', '上海证大投资管理有限公司', '财通基金管理有限公司', '长江证券股份有限公司', '竞价', '开源证券有限责任公司', '10000000', '12', '东海证券有限责任公司'}"
8,"{'苏州城投', '现金', '178875000', '苏州文旅', '22500000', '316725000', '36', '39839622'}",9026322,4,"{'22500000', '316725000', '178875000', '39839622'}",4,"{'苏州城投', '现金', '36', '苏州文旅'}",4,"{'苏州城投', '现金', '36', '苏州文旅'}"
14,"{'中信信诚资产管理有限公司', '12', '诺安基金管理有限公司', '南京中电熊猫信息产业集团有限公司', '东海基金管理有限责任公司', '上海海通证券资产管理有限公司', '190562613', '85299456', '555172414', '南京新工投资集团有限责任公司', '205081669', '深圳市融通资本财富管理有限公司', '244283122', '36'}",1569921,0,set(),9,"{'12', '诺安基金管理有限公司', '南京中电熊猫信息产业集团有限公司', '东海基金管理有限责任公司', '上海海通证券资产管理有限公司', '南京新工投资集团有限责任公司', '深圳市融通资本财富管理有限公司', '中信信诚资产管理有限公司', '36'}",14,"{'中信信诚资产管理有限公司', '12', '诺安基金管理有限公司', '南京中电熊猫信息产业集团有限公司', '东海基金管理有限责任公司', '上海海通证券资产管理有限公司', '190562613', '85299456', '555172414', '南京新工投资集团有限责任公司', '205081669', '深圳市融通资本财富管理有限公司', '244283122', '36'}"
10,"{'现金', '1600000000', '定价', '天津通万、广州城投投资、西藏瑞华、上海贝御', '261651676', '海航资本、深圳兴航', '130825838', '中加基金、中信建投基金', '36', '3200000000'}",1623264,3,"{'3200000000', '261651676', '1600000000'}",6,"{'现金', '定价', '中加基金、中信建投基金', '海航资本、深圳兴航', '天津通万、广州城投投资、西藏瑞华、上海贝御', '36'}",7,"{'现金', '定价', '中加基金、中信建投基金', '海航资本、深圳兴航', '130825838', '天津通万、广州城投投资、西藏瑞华、上海贝御', '36'}"
14,"{'1666111', '太平洋资产管理有限责任公司', '华安基金管理有限公司', '浙江浙商证券资产管理有限公司', '创金合信基金管理有限公司', '西部证券股份有限公司', '定价', '博时基金管理有限公司', '财通基金管理有限公司', '1332889', '899701', '2665778', '3765411', '12'}",1768857,1,{'定价'},8,"{'太平洋资产管理有限责任公司', '华安基金管理有限公司', '浙江浙商证券资产管理有限公司', '西部证券股份有限公司', '博时基金管理有限公司', '财通基金管理有限公司', '创金合信基金管理有限公司', '12'}",13,"{'1666111', '太平洋资产管理有限责任公司', '华安基金管理有限公司', '浙江浙商证券资产管理有限公司', '创金合信基金管理有限公司', '西部证券股份有限公司', '博时基金管理有限公司', '财通基金管理有限公司', '1332889', '899701', '2665778', '3765411', '12'}"
7,"{'5000000', '现金', '12', '其他特定对象', '竞价', '金塔县供销合作联社', '36'}",1270592,1,{'5000000'},6,"{'现金', '12', '其他特定对象', '竞价', '金塔县供销合作联社', '36'}",6,"{'36', '现金', '其他特定对象', '竞价', '金塔县供销合作联社', '12'}"
9,"{'现金', '长城科技', '35714285', '160000000', '187500001', '1000000000', '竞价', '长城开发', '36'}",1125972,2,"{'竞价', '160000000'}",4,"{'现金', '长城开发', '36', '长城科技'}",7,"{'现金', '长城科技', '35714285', '187500001', '1000000000', '长城开发', '36'}"
4,"{'竞价', '现金', '大生农业金融', '36'}",18850145,1,{'竞价'},3,"{'现金', '大生农业金融', '36'}",3,"{'现金', '大生农业金融', '36'}"
21,"{'深圳同方知网科技有限公司', '35800000', '34800000', '现金', '兴业证券股份有限公司', '招商基金管理有限公司', '宝盈基金管理有限公司', '309970000', '南京瑞森投资管理合伙企业(有限合伙)', '272060000', '69500000', '34900000', '61000000', '204268000', '155654000', '159668000', '45800000', '155208000', '永赢基金管理有限公司', '12', '招商证券股份有限公司'}",62241,8,"{'272060000', '155654000', '69500000', '159668000', '45800000', '155208000', '204268000', '309970000'}",2,"{'现金', '12'}",13,"{'南京瑞森投资管理合伙企业(有限合伙)', '深圳同方知网科技有限公司', '现金', '兴业证券股份有限公司', '35800000', '招商基金管理有限公司', '34900000', '34800000', '61000000', '宝盈基金管理有限公司', '永赢基金管理有限公司', '12', '招商证券股份有限公司'}"
21,"{'11655012', '13986013', '深圳天风天成资产管理有限公司', '浙报传媒控股集团有限公司', '199999988.8', '泰达宏利基金管理有限公司', '11655011', '鹏华资产管理有限公司', '17540792', '23834502', '239999983.1', '竞价', '409000054.3', '广东省铁路发展基金有限责任公司', '36', '北信瑞丰基金管理有限公司', '200000005.9', '金元顺安基金管理有限公司', '300999990.7', '安信基金管理有限责任公司', '12'}",15561874,3,"{'239999983.1', '竞价', '199999988.8'}",10,"{'北信瑞丰基金管理有限公司', '鹏华资产管理有限公司', '深圳天风天成资产管理有限公司', '12', '浙报传媒控股集团有限公司', '金元顺安基金管理有限公司', '安信基金管理有限责任公司', '泰达宏利基金管理有限公司', '广东省铁路发展基金有限责任公司', '36'}",18,"{'11655012', '11655011', '北信瑞丰基金管理有限公司', '鹏华资产管理有限公司', '13986013', '深圳天风天成资产管理有限公司', '17540792', '12', '23834502', '浙报传媒控股集团有限公司', '金元顺安基金管理有限公司', '300999990.7', '安信基金管理有限责任公司', '409000054.3', '泰达宏利基金管理有限公司', '广东省铁路发展基金有限责任公司', '36', '200000005.9'}"
6,"{'大连大显集团有限公司', '现金', '400000000', '1376000000', '竞价', '36'}",1224635,2,"{'竞价', '1376000000'}",3,"{'大连大显集团有限公司', '现金', '36'}",4,"{'大连大显集团有限公司', '现金', '36', '400000000'}"
16,"{'12000000', '5000000', '现金', 'Bill& Melinda Gates Foundation', '华安基金管理有限公司', '新华人寿保险股份有限公司', '北京首创轮胎有限责任公司', '1650000', '定价', '长江证券有限责任公司', '海富通基金管理公司', '成都天祥房地产集团有限公司', '6000000', '10000000', '宁波保税区恒业国际贸易有限公司', '12'}",1360023,3,"{'12000000', '1650000', 'Bill& Melinda Gates Foundation'}",10,"{'现金', '华安基金管理有限公司', '新华人寿保险股份有限公司', '北京首创轮胎有限责任公司', '长江证券有限责任公司', '定价', '海富通基金管理公司', '成都天祥房地产集团有限公司', '宁波保税区恒业国际贸易有限公司', '12'}",13,"{'5000000', '现金', '华安基金管理有限公司', '新华人寿保险股份有限公司', '北京首创轮胎有限责任公司', '定价', '长江证券有限责任公司', '海富通基金管理公司', '成都天祥房地产集团有限公司', '6000000', '10000000', '宁波保税区恒业国际贸易有限公司', '12'}"
16,"{'617119113', '现金', '609418282', '上海六禾', '包钢集团', '财通基金', '775623268', '招商财富', '华安资产', '理家盈', '国华人寿', '427811634', '415512465', '36', '4822105266', '587257617'}",1067619,1,{'4822105266'},9,"{'现金', '华安资产', '包钢集团', '招商财富', '理家盈', '国华人寿', '36', '财通基金', '上海六禾'}",15,"{'617119113', '现金', '609418282', '上海六禾', '包钢集团', '775623268', '华安资产', '招商财富', '理家盈', '国华人寿', '427811634', '415512465', '36', '财通基金', '587257617'}"
20,"{'390999999', '390000000', '宏源证券股份有限公司', '100000000', '浦银安盛基金管理有限公司', '国华人寿保险股份有限公司', '780000000', '50128205', '财通基金管理有限公司', '北京城建集团有限责任公司', '建信基金管理有限公司', '74641026', '50000000', '申万菱信基金管理有限公司', '291100001.4', '582200002.8', '37320513', '100589743', '易方达资产管理有限公司', '784599995.4'}",376219,0,set(),6,"{'宏源证券股份有限公司', '浦银安盛基金管理有限公司', '财通基金管理有限公司', '北京城建集团有限责任公司', '建信基金管理有限公司', '申万菱信基金管理有限公司'}",20,"{'390999999', '390000000', '宏源证券股份有限公司', '100000000', '浦银安盛基金管理有限公司', '国华人寿保险股份有限公司', '780000000', '50128205', '财通基金管理有限公司', '北京城建集团有限责任公司', '建信基金管理有限公司', '74641026', '50000000', '申万菱信基金管理有限公司', '291100001.4', '582200002.8', '37320513', '100589743', '易方达资产管理有限公司', '784599995.4'}"
3,"{'现金', '36', '鲁楚平'}",675990,0,set(),3,"{'现金', '36', '鲁楚平'}",3,"{'现金', '36', '鲁楚平'}"
4,"{'桐昆控股', '300000000', '竞价', '现金'}",1815533,2,"{'竞价', '300000000'}",2,"{'桐昆控股', '现金'}",2,"{'桐昆控股', '现金'}"
25,"{'20000000000', '西藏紫光西岳通信', '369822485', '554733727', '4700000000', '现金', '7000000000', '定价', '西藏紫光东岳通信', '同方国芯2015员工持股计划', '西藏紫光博翊教育', '2600000000', '258875739', '173816568', '西藏健坤中芯', '15000000000', '739644970', '36982248', '96153846', '西藏紫光国芯', '1000000000', '西藏紫光树人教育', '10000000000', '36', '国研宝业'}",2355088,2,"{'4700000000', '15000000000'}",10,"{'现金', '定价', '西藏紫光国芯', '西藏紫光东岳通信', '西藏健坤中芯', '西藏紫光树人教育', '西藏紫光西岳通信', '西藏紫光博翊教育', '36', '国研宝业'}",23,"{'20000000000', '西藏紫光西岳通信', '369822485', '554733727', '现金', '7000000000', '定价', '西藏紫光东岳通信', '同方国芯2015员工持股计划', '西藏紫光博翊教育', '2600000000', '258875739', '173816568', '西藏健坤中芯', '739644970', '36982248', '96153846', '西藏紫光国芯', '1000000000', '西藏紫光树人教育', '10000000000', '36', '国研宝业'}"
13,"{'金鹰基金管理有限公司', '现金', '39865244', '华安基金管理有限公司', '709999995.6', '20550253', '易方达基金管理有限公司', '359999995', '竞价', '366000005.9', '20213363', '12', '深圳前海金鹰资产管理有限公司'}",9025762,1,{'竞价'},6,"{'金鹰基金管理有限公司', '现金', '华安基金管理有限公司', '易方达基金管理有限公司', '12', '深圳前海金鹰资产管理有限公司'}",12,"{'金鹰基金管理有限公司', '现金', '39865244', '华安基金管理有限公司', '709999995.6', '20550253', '易方达基金管理有限公司', '359999995', '366000005.9', '20213363', '12', '深圳前海金鹰资产管理有限公司'}"
4,"{'竞价', '现金', '36', '陕西延长石油(集团)有限责任公司'}",1358949,1,{'陕西延长石油(集团)有限责任公司'},3,"{'竞价', '现金', '36'}",3,"{'竞价', '现金', '36'}"
3,"{'中新世纪公司', '竞价', '36'}",320496,0,set(),3,"{'中新世纪公司', '竞价', '36'}",3,"{'中新世纪公司', '竞价', '36'}"
5,"{'现金', '凯撒集团', '108800000', '竞价', '36'}",1143161,2,"{'108800000', '36'}",3,"{'凯撒集团', '竞价', '现金'}",3,"{'凯撒集团', '竞价', '现金'}"
18,"{'3800000', '5000000', '江苏瑞华投资发展有限公司', '4700000', '12', '125000000', '李萍', '竞价', '金塔县供销合作联社', '江西国际信托股份有限公司', '117500000', '3000000', '75000000', '27000000', '1080000', '95000000', '36', '海富通基金管理有限公司'}",501407,9,"{'3800000', '125000000', '竞价', '3000000', '117500000', '27000000', '75000000', '1080000', '95000000'}",3,"{'36', '金塔县供销合作联社', '12'}",9,"{'5000000', '江苏瑞华投资发展有限公司', '4700000', '12', '李萍', '江西国际信托股份有限公司', '金塔县供销合作联社', '36', '海富通基金管理有限公司'}"
15,"{'广证鲲鹏1号', '现金', '1419347', '广州国发', '14349598.17', '定价', '4765508', '48179285.88', '262675677', '英特布鲁国际', '1593760013', '2655651094', '157641940', '36', '广证鲲鹏2号'}",9890200,0,set(),5,"{'现金', '广州国发', '定价', '英特布鲁国际', '36'}",15,"{'广证鲲鹏1号', '现金', '1419347', '广州国发', '14349598.17', '4765508', '48179285.88', '定价', '262675677', '英特布鲁国际', '1593760013', '2655651094', '157641940', '36', '广证鲲鹏2号'}"
5,"{'现金', '竞价', '国美控股', '46674445', '36'}",1843579,1,{'46674445'},4,"{'36', '竞价', '现金', '国美控股'}",4,"{'36', '竞价', '现金', '国美控股'}"
14,"{'上海华沅投资管理合伙企业(有限合伙)', '3800000', '4800000', '现金', '18200000', '林林', '5000000', '马晓', '陈峰', '7600000', '廖俊德', '湖南华实资本创业投资中心(有限合伙)', '马孝武', '36'}",338233,5,"{'上海华沅投资管理合伙企业(有限合伙)', '3800000', '7600000', '湖南华实资本创业投资中心(有限合伙)', '4800000'}",7,"{'现金', '林林', '马晓', '陈峰', '廖俊德', '马孝武', '36'}",9,"{'5000000', '现金', '18200000', '林林', '马晓', '陈峰', '廖俊德', '马孝武', '36'}"
9,"{'36', '现金', '汇添富-光电制导1号', '汇添富-光电制导2号', '4500000', '中兵投资', '22500000', '9000000', '兵工财务'}",295283,2,"{'22500000', '9000000'}",6,"{'现金', '汇添富-光电制导1号', '汇添富-光电制导2号', '中兵投资', '兵工财务', '36'}",7,"{'36', '现金', '汇添富-光电制导1号', '汇添富-光电制导2号', '4500000', '中兵投资', '兵工财务'}"
22,"{'华安基金管理有限公司', '14615384', '广发基金管理有限公司', '南方基金管理有限公司', '15384615', '富通银行', '现金', '18076923', '新华人寿保险股份有限公司', '13348445', '定价', '兴业基金管理有限公司', '鹏华基金管理有限公司', '17692307', '19230769', '20995421', '25000000', '华夏基金管理有限公司', '中国太平洋人寿保险股份有限公司', '13348444', '泰康资产管理有限责任公司', '12'}",544918,0,set(),13,"{'现金', '华安基金管理有限公司', '新华人寿保险股份有限公司', '华夏基金管理有限公司', '中国太平洋人寿保险股份有限公司', '定价', '广发基金管理有限公司', '兴业基金管理有限公司', '鹏华基金管理有限公司', '南方基金管理有限公司', '泰康资产管理有限责任公司', '12', '富通银行'}",22,"{'华安基金管理有限公司', '14615384', '广发基金管理有限公司', '南方基金管理有限公司', '15384615', '富通银行', '现金', '18076923', '新华人寿保险股份有限公司', '13348445', '定价', '兴业基金管理有限公司', '鹏华基金管理有限公司', '17692307', '19230769', '20995421', '25000000', '华夏基金管理有限公司', '中国太平洋人寿保险股份有限公司', '13348444', '泰康资产管理有限责任公司', '12'}"
5,"{'北大国际医院集团有限公司', '定价', '资产', '13202570', '36'}",888286,0,set(),4,"{'资产', '定价', '北大国际医院集团有限公司', '36'}",5,"{'北大国际医院集团有限公司', '定价', '资产', '13202570', '36'}"
15,"{'14307931', '12908244', '定价', '185999992.7', '平安资产管理有限责任公司', '183999992.7', '中信建投基金管理有限公司', '深圳市融通资本管理股份有限公司', '15552099', '申万菱信基金管理有限公司', '166000017.8', '199999993.1', '易方达资产管理有限公司', '12', '14463452'}",14925945,3,"{'12908244', '183999992.7', '14307931'}",7,"{'定价', '平安资产管理有限责任公司', '中信建投基金管理有限公司', '深圳市融通资本管理股份有限公司', '申万菱信基金管理有限公司', '易方达资产管理有限公司', '12'}",12,"{'185999992.7', '平安资产管理有限责任公司', '定价', '中信建投基金管理有限公司', '深圳市融通资本管理股份有限公司', '15552099', '申万菱信基金管理有限公司', '166000017.8', '199999993.1', '易方达资产管理有限公司', '12', '14463452'}"
4,"{'竞价', '现金', '36', '东旭集团'}",1230660,0,set(),4,"{'竞价', '现金', '36', '东旭集团'}",4,"{'竞价', '现金', '36', '东旭集团'}"
5,"{'现金', '259076081', '青岛企发投', '竞价', '36'}",9904562,2,"{'竞价', '259076081'}",3,"{'青岛企发投', '现金', '36'}",3,"{'36', '现金', '青岛企发投'}"
15,"{'383974496.7', '现金', '21320072', '4500000', '兴证证券资产管理有限公司', '3650000', '65736500', '4400000', '东海基金管理有限责任公司', '三峡财务有限责任公司', '81045000', '竞价', '鹏华基金管理有限公司', '79244000', '12'}",318390,0,set(),6,"{'现金', '兴证证券资产管理有限公司', '东海基金管理有限责任公司', '三峡财务有限责任公司', '鹏华基金管理有限公司', '12'}",15,"{'383974496.7', '现金', '21320072', '4500000', '兴证证券资产管理有限公司', '3650000', '65736500', '4400000', '东海基金管理有限责任公司', '三峡财务有限责任公司', '81045000', '竞价', '鹏华基金管理有限公司', '79244000', '12'}"
6,"{'中农发集团', '现金', '定价', '469999997.6', '36', '63087248'}",1287445,0,set(),4,"{'36', '定价', '中农发集团', '现金'}",6,"{'中农发集团', '现金', '定价', '469999997.6', '36', '63087248'}"
34,"{'34154900', '1182371256', '141106000', '39094600', '77608200', '郝文彦', '98530344', '上海丰煜投资有限公司-丰煜-稳盈证券投资基金1号私募证券投资基金', '北京文资控股有限公司', '常州京润资本管理有限公司', '127697472', '现金', '27369700', '15205300', '253333008', '定价', '北京君联嘉睿股权投资合伙企业(有限合伙)', '28282100', '60', '914366880', '珠海安赐文创壹号股权投资基金企业(有限合伙)', '耀莱文化产业股份有限公司', '502901136', '182464700', '228851568', '221323752', '35316600', '上海立茂投资咨询合伙企业(有限合伙)', '冯军', '19706400', '177355656', '183268008', '姚戈', '36'}",1735247,0,set(),10,"{'现金', '冯军', '定价', '60', '耀莱文化产业股份有限公司', '郝文彦', '常州京润资本管理有限公司', '姚戈', '北京文资控股有限公司', '36'}",34,"{'34154900', '1182371256', '141106000', '39094600', '77608200', '郝文彦', '98530344', '上海丰煜投资有限公司-丰煜-稳盈证券投资基金1号私募证券投资基金', '北京文资控股有限公司', '常州京润资本管理有限公司', '127697472', '现金', '27369700', '15205300', '253333008', '定价', '北京君联嘉睿股权投资合伙企业(有限合伙)', '28282100', '60', '914366880', '珠海安赐文创壹号股权投资基金企业(有限合伙)', '耀莱文化产业股份有限公司', '502901136', '182464700', '228851568', '221323752', '35316600', '上海立茂投资咨询合伙企业(有限合伙)', '冯军', '19706400', '177355656', '183268008', '姚戈', '36'}"
14,"{'现金', '7750000', '280124600', '150104000', '179800000', '6460000', '6470000', '南通丰盈投资合伙企业(有限合伙)', '九江志元胜泰投资管理中心(有限合伙)', '12074300', '李新生', '36', '宁波亿华合众投资管理合伙企业(有限合伙)', '149872000'}",1789784,11,"{'7750000', '280124600', '150104000', '179800000', '6460000', '6470000', '南通丰盈投资合伙企业(有限合伙)', '九江志元胜泰投资管理中心(有限合伙)', '12074300', '宁波亿华合众投资管理合伙企业(有限合伙)', '149872000'}",3,"{'李新生', '现金', '36'}",3,"{'李新生', '现金', '36'}"
15,"{'5000000', '2300000', '4500000', '兴业全球基金管理有限公司', '广东盈峰投资控股集团有限公司', '江苏瑞华投资发展有限公司', '4000000', '定价', '五矿集团财务有限责任公司', '5500000', '叶祥尧', '上海天迪科技投资发展有限公司', '6000000', '12', '富通银行'}",413534,1,{'2300000'},2,"{'定价', '12'}",14,"{'5000000', '4500000', '兴业全球基金管理有限公司', '广东盈峰投资控股集团有限公司', '江苏瑞华投资发展有限公司', '4000000', '定价', '五矿集团财务有限责任公司', '5500000', '叶祥尧', '上海天迪科技投资发展有限公司', '6000000', '12', '富通银行'}"
4,"{'湘电集团', '竞价', '现金', '36'}",1902478,0,set(),4,"{'湘电集团', '竞价', '现金', '36'}",4,"{'湘电集团', '竞价', '现金', '36'}"
25,"{'299025000', '9850000', '14950000', '511665000', '西安投资控股有限公司', '新华人寿保险股份有限公司', '兴业全球基金管理有限公司', '9650000', '财通基金管理有限公司', '256497000', '301683000', '信达澳银基金管理有限公司', '上海复星产业投资有限公司', '261813000', '银华基金管理有限公司', '博时基金管理有限公司', '264471000', '11250000', '11350000', '9950000', '265474979.8', '19250000', '9987772', '12', '397371000'}",406389,16,"{'299025000', '9850000', '14950000', '261813000', '511665000', '9650000', '265474979.8', '256497000', '301683000', '19250000', '264471000', '9987772', '11250000', '11350000', '397371000', '9950000'}",9,"{'银华基金管理有限公司', '兴业全球基金管理有限公司', '新华人寿保险股份有限公司', '博时基金管理有限公司', '西安投资控股有限公司', '财通基金管理有限公司', '信达澳银基金管理有限公司', '上海复星产业投资有限公司', '12'}",9,"{'银华基金管理有限公司', '新华人寿保险股份有限公司', '兴业全球基金管理有限公司', '博时基金管理有限公司', '西安投资控股有限公司', '财通基金管理有限公司', '信达澳银基金管理有限公司', '上海复星产业投资有限公司', '12'}"
6,"{'现金', '331564986', '4999999989', '竞价', '万宏源证券有限公司', '12'}",2239177,1,{'4999999989'},4,"{'万宏源证券有限公司', '竞价', '现金', '12'}",5,"{'现金', '12', '331564986', '竞价', '万宏源证券有限公司'}"
12,"{'杭州蓝海投资有限公司', '现金', '天津富禾矿业投资中心', '8000000', '盱眙金泰产业服务有限公司', '5000000', '江苏中韩国际经贸有限公司', '15000000', '北京路源世纪投资管理有限公司', '10000000', '36', '盱眙银信投资服务有限公司'}",1076858,0,set(),8,"{'杭州蓝海投资有限公司', '现金', '天津富禾矿业投资中心', '盱眙金泰产业服务有限公司', '江苏中韩国际经贸有限公司', '北京路源世纪投资管理有限公司', '36', '盱眙银信投资服务有限公司'}",12,"{'5000000', '现金', '天津富禾矿业投资中心', '8000000', '盱眙金泰产业服务有限公司', '杭州蓝海投资有限公司', '江苏中韩国际经贸有限公司', '15000000', '北京路源世纪投资管理有限公司', '10000000', '36', '盱眙银信投资服务有限公司'}"
4,"{'荣盛控股', '竞价', '现金', '36'}",677057,0,set(),4,"{'荣盛控股', '竞价', '现金', '36'}",4,"{'荣盛控股', '竞价', '现金', '36'}"
6,"{'现金', '冀中能源', '定价', '258899676', '1599999998', '36'}",159440,1,{'1599999998'},4,"{'定价', '现金', '36', '冀中能源'}",5,"{'现金', '定价', '258899676', '冀中能源', '36'}"
8,"{'82135523', '章建平', '41067761', '工银瑞信基金管理有限公司', '安徽省铁路建设投资基金有限公司', '定价', '天安财产保险股份有限公司', '12'}",2374517,0,set(),6,"{'章建平', '工银瑞信基金管理有限公司', '安徽省铁路建设投资基金有限公司', '定价', '天安财产保险股份有限公司', '12'}",8,"{'82135523', '章建平', '41067761', '工银瑞信基金管理有限公司', '安徽省铁路建设投资基金有限公司', '定价', '天安财产保险股份有限公司', '12'}"
16,"{'1921191', '靳晓堂', '第一创业证券股份有限公司', '2855511', '中融基金管理有限公司', '深圳市创新投资集团有限公司', '2141633', '12', '定价', '申万菱信(上海)资产管理有限公司', '财通基金管理有限公司', '5254140', '2284408', '汇添富基金管理股份有限公司', '36', '华泰柏瑞基金管理有限公司'}",6416980,0,set(),10,"{'靳晓堂', '第一创业证券股份有限公司', '中融基金管理有限公司', '深圳市创新投资集团有限公司', '12', '定价', '财通基金管理有限公司', '汇添富基金管理股份有限公司', '36', '华泰柏瑞基金管理有限公司'}",16,"{'1921191', '靳晓堂', '第一创业证券股份有限公司', '2855511', '中融基金管理有限公司', '深圳市创新投资集团有限公司', '2141633', '12', '定价', '申万菱信(上海)资产管理有限公司', '财通基金管理有限公司', '5254140', '2284408', '汇添富基金管理股份有限公司', '36', '华泰柏瑞基金管理有限公司'}"
15,"{'和丰投资', '现金', '华盛世纪', '正丰鼎盛', '智合信智信', '汉华同盟', '90000000', '铁木真资本', '50000000', '长洲投资', '140000000', '80000000', '星星之火', '36', '财通基金'}",1802872,4,"{'50000000', '80000000', '90000000', '140000000'}",11,"{'和丰投资', '36', '现金', '正丰鼎盛', '智合信智信', '铁木真资本', '长洲投资', '华盛世纪', '星星之火', '汉华同盟', '财通基金'}",11,"{'和丰投资', '现金', '正丰鼎盛', '智合信智信', '汉华同盟', '铁木真资本', '长洲投资', '华盛世纪', '星星之火', '36', '财通基金'}"
12,"{'469999997.7', '现金', '581952117', '大船投资', '86556169', '49723756', '定价', '武船投资', '269999995.1', '3159999995', '中国船舶重工集团公司', '36'}",16222823,2,"{'269999995.1', '469999997.7'}",6,"{'大船投资', '现金', '定价', '武船投资', '中国船舶重工集团公司', '36'}",10,"{'大船投资', '581952117', '现金', '86556169', '49723756', '定价', '武船投资', '3159999995', '中国船舶重工集团公司', '36'}"
18,"{'3559066', '92999991.18', '现金', '李蔚', '43299989.52', '6997742', '苏清香', '定价', '22899999', '199999987.3', '47299987.14', '3258088', '15048908', '狄爱玲', '陈慧', '1723100', '张微', '36'}",15598456,0,set(),8,"{'李蔚', '现金', '苏清香', '定价', '狄爱玲', '陈慧', '张微', '36'}",18,"{'3559066', '92999991.18', '现金', '李蔚', '43299989.52', '6997742', '苏清香', '定价', '22899999', '199999987.3', '47299987.14', '3258088', '15048908', '狄爱玲', '陈慧', '1723100', '张微', '36'}"
21,"{'刘宏冰', '32580000', '6500000', '5000000', '现金', '12', '8650000', '凌俊', '北京奥仕华冠口腔技术研究所', '闻斌', '47060000', '山东安德利集团有限公司', '29539200', '4500000', '36200000', '4080000', '江西出版集团蓝海国际投资有限公司', '62626000', '内蒙古第一机械制造(集团)有限公司', '36', '上海远东证券有限公司'}",1128317,6,"{'36200000', '32580000', '29539200', '47060000', '山东安德利集团有限公司', '62626000'}",3,"{'36', '现金', '12'}",15,"{'36', '5000000', '现金', '4500000', '刘宏冰', '8650000', '凌俊', '4080000', '江西出版集团蓝海国际投资有限公司', '内蒙古第一机械制造(集团)有限公司', '北京奥仕华冠口腔技术研究所', '6500000', '闻斌', '12', '上海远东证券有限公司'}"
8,"{'136610000', '芜湖基石股权投资基金(有限合伙)', '现金', '999985200', '27320000', '199982400', '新华联控股有限公司', '36'}",14759693,4,"{'136610000', '199982400', '999985200', '27320000'}",3,"{'现金', '新华联控股有限公司', '36'}",4,"{'芜湖基石股权投资基金(有限合伙)', '现金', '新华联控股有限公司', '36'}"
5,"{'现金', '64000000', '竞价', '国有独资公司滨州市国有资产经营有限公司', '36'}",160687,1,{'64000000'},4,"{'国有独资公司滨州市国有资产经营有限公司', '竞价', '现金', '36'}",4,"{'国有独资公司滨州市国有资产经营有限公司', '竞价', '现金', '36'}"
13,"{'2224123', '现金', '12', '6863704', '47999981.68', '竞价', '2053036', '51999995.74', '赵丹', '上海歌金企业管理有限公司', '160473399.5', '36', '张恒'}",18760373,0,set(),7,"{'现金', '12', '上海歌金企业管理有限公司', '竞价', '赵丹', '36', '张恒'}",13,"{'2224123', '现金', '12', '6863704', '47999981.68', '2053036', '51999995.74', '上海歌金企业管理有限公司', '赵丹', '160473399.5', '竞价', '36', '张恒'}"
22,"{'3800000', '104312000', '梁定志', '朱宁', '现金', '4700000', '144196000', '邹瀚枢', '财通基金管理有限公司', '竞价', '21380707.92', '36', '1629800', '3400000', '易红石', '61360000', '116584000', '50002264', '2000000', '杨晓涛', '12', '696894'}",1622434,7,"{'3800000', '144196000', '50002264', '104312000', '21380707.92', '61360000', '116584000'}",9,"{'现金', '12', '邹瀚枢', '竞价', '梁定志', '杨晓涛', '易红石', '朱宁', '36'}",15,"{'36', '现金', '4700000', '1629800', '邹瀚枢', '财通基金管理有限公司', '2000000', '竞价', '3400000', '杨晓涛', '易红石', '梁定志', '朱宁', '12', '696894'}"
17,"{'5000000', '现金', '嘉峪关市长城发展有限责任公司', '江苏瑞华投资发展有限公司', '华泰财产保险股份有限公司', '无锡市宝联投资有限公司', '佛山市安高投资有限公司', '4000000', '定价', '三一集团有限公司', '华宝信托投资有限责任公司', '3000000', '江西国际信托投资股份有限公司', '9000000', '常州江成投资发展有限公司', '12', '5000002'}",539069,0,set(),12,"{'嘉峪关市长城发展有限责任公司', '现金', '江苏瑞华投资发展有限公司', '华泰财产保险股份有限公司', '佛山市安高投资有限公司', '定价', '三一集团有限公司', '华宝信托投资有限责任公司', '江西国际信托投资股份有限公司', '常州江成投资发展有限公司', '12', '无锡市宝联投资有限公司'}",17,"{'5000000', '现金', '嘉峪关市长城发展有限责任公司', '江苏瑞华投资发展有限公司', '华泰财产保险股份有限公司', '无锡市宝联投资有限公司', '佛山市安高投资有限公司', '4000000', '定价', '三一集团有限公司', '华宝信托投资有限责任公司', '3000000', '江西国际信托投资股份有限公司', '9000000', '常州江成投资发展有限公司', '12', '5000002'}"
16,"{'招商财富资产管理有限公司', '199999986.2', '9480587', '现金', '188000040.2', '10186585', '石家庄鑫汇金投资有限公司', '定价', '10085728', '博时基金管理有限公司', '嘉实基金管理有限公司', '209999997.5', '10590015', '安徽高新毅达皖江产业发展创业投资基金(有限合伙)', '201999980.6', '12'}",12046579,2,"{'209999997.5', '201999980.6'}",7,"{'招商财富资产管理有限公司', '现金', '石家庄鑫汇金投资有限公司', '定价', '博时基金管理有限公司', '嘉实基金管理有限公司', '12'}",14,"{'招商财富资产管理有限公司', '199999986.2', '9480587', '现金', '188000040.2', '10186585', '石家庄鑫汇金投资有限公司', '10085728', '博时基金管理有限公司', '定价', '嘉实基金管理有限公司', '10590015', '安徽高新毅达皖江产业发展创业投资基金(有限合伙)', '12'}"
4,"{'现金', '竞价', '华数集团', '36'}",719642,0,set(),4,"{'竞价', '现金', '36', '华数集团'}",4,"{'现金', '竞价', '华数集团', '36'}"
19,"{'30917874', '800000000', '香港金益', '信达投资', '现金', '410000000', '230000000', '东方汇智管理的东方汇智1号/2号/3号', '财通基金管理的财通-玉泉101号/102号', '定价', '320000000', '浙江方通', '海南建信', '77294685', '智度德诚', '股权', '36', '22222222', '39613526'}",330711,8,"{'800000000', '230000000', '东方汇智管理的东方汇智1号/2号/3号', '410000000', '财通基金管理的财通-玉泉101号/102号', '320000000', '22222222', '39613526'}",9,"{'香港金益', '信达投资', '现金', '浙江方通', '定价', '海南建信', '智度德诚', '股权', '36'}",11,"{'30917874', '香港金益', '现金', '信达投资', '浙江方通', '定价', '海南建信', '77294685', '智度德诚', '股权', '36'}"
5,"{'现金', '165000000', '竞价', '36', '中国电子信息产业集团有限公司'}",352357,1,{'165000000'},4,"{'竞价', '现金', '36', '中国电子信息产业集团有限公司'}",4,"{'竞价', '现金', '36', '中国电子信息产业集团有限公司'}"
26,"{'899885600', '启迪桑德第一期员工持股计划', '32440000', '33010000', '3134620000', '珠海启迪绿源资本管理有限公司', '现金', '西藏桑德投资控股有限公司', '邦信资产管理有限公司', '珠海启迪投资管理有限公司', '启迪金控投资有限公司', '汇添富基金管理股份有限公司', '113000000', '西藏清控资产管理有限公司', '299869400', '南通金信灏海投资中心(有限合伙)', '2000054000', '21630000', '32450000', '72100000', '900163000', '嘉实基金管理有限公司', '915697400', '600016200', '10810000', '36'}",2375869,14,"{'899885600', '21630000', '299869400', '32450000', '72100000', '900163000', '32440000', '33010000', '3134620000', '915697400', '600016200', '10810000', '2000054000', '113000000'}",11,"{'西藏清控资产管理有限公司', '现金', '西藏桑德投资控股有限公司', '邦信资产管理有限公司', '启迪桑德第一期员工持股计划', '嘉实基金管理有限公司', '珠海启迪投资管理有限公司', '启迪金控投资有限公司', '珠海启迪绿源资本管理有限公司', '汇添富基金管理股份有限公司', '36'}",12,"{'西藏清控资产管理有限公司', '现金', '西藏桑德投资控股有限公司', '邦信资产管理有限公司', '启迪桑德第一期员工持股计划', '嘉实基金管理有限公司', '南通金信灏海投资中心(有限合伙)', '珠海启迪投资管理有限公司', '启迪金控投资有限公司', '珠海启迪绿源资本管理有限公司', '汇添富基金管理股份有限公司', '36'}"
17,"{'深圳平安大华汇通财富管理有限公司', '现金', '江信基金管理有限公司', '13902220', '39123766', '厦门国际信托有限公司', '13452915', '12', '定价', '厦门象屿集团有限公司', '15246637', '12444865', '26905829', '鹏华基金管理有限公司', '泰康资产管理有限责任公司', '36', '华泰柏瑞基金管理有限公司'}",1860472,0,set(),11,"{'深圳平安大华汇通财富管理有限公司', '现金', '江信基金管理有限公司', '厦门国际信托有限公司', '12', '定价', '厦门象屿集团有限公司', '鹏华基金管理有限公司', '泰康资产管理有限责任公司', '36', '华泰柏瑞基金管理有限公司'}",17,"{'深圳平安大华汇通财富管理有限公司', '厦门国际信托有限公司', '江信基金管理有限公司', '13902220', '39123766', '现金', '13452915', '12', '定价', '厦门象屿集团有限公司', '15246637', '12444865', '26905829', '鹏华基金管理有限公司', '泰康资产管理有限责任公司', '36', '华泰柏瑞基金管理有限公司'}"
21,"{'2563918', '蒋亨福', '深圳市方德智联投资管理有限公司', '8546392', '1989601.92', '现金', '定价', '3774656', '170928', '长安财富资产管理有限公司', '吴美莉', '43936995.84', '上海善达投资管理有限公司', '吴国仕', '49018186', '4273196', '99480002.88', '570571694', '29844005.52', '49740001.44', '36'}",1781249,7,"{'2563918', '99480002.88', '570571694', '29844005.52', '49740001.44', '43936995.84', '1989601.92'}",9,"{'现金', '定价', '蒋亨福', '深圳市方德智联投资管理有限公司', '吴美莉', '上海善达投资管理有限公司', '吴国仕', '36', '长安财富资产管理有限公司'}",14,"{'49018186', '现金', '4273196', '定价', '3774656', '蒋亨福', '深圳市方德智联投资管理有限公司', '上海善达投资管理有限公司', '吴美莉', '8546392', '170928', '吴国仕', '36', '长安财富资产管理有限公司'}"
6,"{'14853505', '罗特克斯', '定价', '479440819', '双汇集团', '36'}",573850,1,{'定价'},3,"{'罗特克斯', '双汇集团', '36'}",5,"{'14853505', '罗特克斯', '479440819', '双汇集团', '36'}"
17,"{'合肥兴泰信托有限责任公司', '青岛金王集团有限公司', '吕顺发', '3500000', '康恩贝集团有限公司', '佛山市顺德区濠钢商贸有限公司', '广东鑫鼎投资有限公司', '2000000', '竞价', '3000000', '10000000', '吴荣荃', '6000000', '无锡市新宝联投资有限公司', '张怀斌', '上海证券有限责任公司', '12'}",1402566,3,"{'竞价', '2000000', '佛山市顺德区濠钢商贸有限公司'}",10,"{'青岛金王集团有限公司', '吕顺发', '康恩贝集团有限公司', '广东鑫鼎投资有限公司', '吴荣荃', '合肥兴泰信托有限责任公司', '无锡市新宝联投资有限公司', '张怀斌', '上海证券有限责任公司', '12'}",14,"{'合肥兴泰信托有限责任公司', '青岛金王集团有限公司', '吕顺发', '3500000', '康恩贝集团有限公司', '广东鑫鼎投资有限公司', '吴荣荃', '3000000', '10000000', '6000000', '无锡市新宝联投资有限公司', '张怀斌', '上海证券有限责任公司', '12'}"
4,"{'中国青旅集团公司', '竞价', '现金', '36'}",1095124,0,set(),4,"{'中国青旅集团公司', '竞价', '现金', '36'}",4,"{'中国青旅集团公司', '竞价', '现金', '36'}"
4,"{'现金', '竞价', '海航物流有限公司', '36'}",409882,0,set(),4,"{'海航物流有限公司', '竞价', '现金', '36'}",4,"{'现金', '竞价', '海航物流有限公司', '36'}"
16,"{'40425530', '1063916', '现金', '48510640', '16170210', '博锐奇投资', '嘉华成美', '西藏锦鸿', '定价', '上海原龙', '民加奥瑞金专项资管计划', '8724264', '周原', '建投投资', '36', '71062660'}",14809070,6,"{'40425530', '1063916', '48510640', '16170210', '8724264', '71062660'}",10,"{'现金', '嘉华成美', '博锐奇投资', '西藏锦鸿', '定价', '上海原龙', '民加奥瑞金专项资管计划', '周原', '建投投资', '36'}",10,"{'现金', '嘉华成美', '博锐奇投资', '西藏锦鸿', '定价', '上海原龙', '民加奥瑞金专项资管计划', '周原', '建投投资', '36'}"
4,"{'西藏金杖', '竞价', '现金', '36'}",4951563,0,set(),4,"{'西藏金杖', '竞价', '现金', '36'}",4,"{'西藏金杖', '竞价', '现金', '36'}"
31,"{'26800000', '3000000', '张邦辉', '张雷', '1795332', '538599', '王韦', '359066', '200000000', '现金', '1200000', '田萍', '竞价', '4811490', '215439', '10000000', '程国浩', '36', '4488330', '傅衍', '60000000', '120000000', '25000000', '35906642', '陆裕肖', '吴天星', '21543985', '2000000', '胡来根', '陈能兴', '10771992'}",1817884,2,"{'竞价', '26800000'}",12,"{'陆裕肖', '现金', '吴天星', '傅衍', '胡来根', '田萍', '程国浩', '张邦辉', '张雷', '王韦', '陈能兴', '36'}",29,"{'3000000', '张邦辉', '张雷', '1795332', '538599', '王韦', '359066', '200000000', '现金', '1200000', '田萍', '4811490', '215439', '程国浩', '10000000', '36', '4488330', '傅衍', '60000000', '120000000', '25000000', '35906642', '陆裕肖', '吴天星', '21543985', '2000000', '胡来根', '陈能兴', '10771992'}"
5,"{'现金', '81456270', '竞价', '创元投资集团', '36'}",1210560,2,"{'81456270', '竞价'}",3,"{'现金', '创元投资集团', '36'}",3,"{'现金', '创元投资集团', '36'}"
10,"{'上海念承投资中心(有限合伙)', '现金', '广州市番禺信息技术投资发展有限公司', '上海诺中投资管理中心(有限合伙)', '4000000', '上海华玳投资管理中心(有限合伙)', '竞价', '广东恒健资本管理有限公司', '10000000', '12'}",165671,1,{'竞价'},3,"{'现金', '12', '广州市番禺信息技术投资发展有限公司'}",9,"{'上海念承投资中心(有限合伙)', '现金', '广州市番禺信息技术投资发展有限公司', '上海诺中投资管理中心(有限合伙)', '4000000', '上海华玳投资管理中心(有限合伙)', '广东恒健资本管理有限公司', '10000000', '12'}"
19,"{'黄华', '现金', '1200000000', '44000000', '劲嘉创投', '21881838', '定价', '200000000', '3501094', '32000000', '130000000', '4814004', '复星安泰', '14223194', '张明义', '李德华', '侯旭东', '131291028', '36'}",4945557,10,"{'131291028', '1200000000', '3501094', '21881838', '44000000', '32000000', '130000000', '4814004', '14223194', '200000000'}",9,"{'黄华', '现金', '劲嘉创投', '定价', '复星安泰', '张明义', '李德华', '侯旭东', '36'}",9,"{'黄华', '现金', '劲嘉创投', '定价', '复星安泰', '张明义', '李德华', '侯旭东', '36'}"
6,"{'现金', '408100000', '70000000', '竞价', '郭留希', '36'}",81199,3,"{'竞价', '70000000', '408100000'}",3,"{'36', '郭留希', '现金'}",3,"{'36', '郭留希', '现金'}"
7,"{'现金', '方振淳', '易方达工商银行中瑞思创定增1号资产管理计划', '4000000', '定价', '西藏瑞华投资发展有限公司', '36'}",1656997,1,{'4000000'},5,"{'现金', '方振淳', '定价', '西藏瑞华投资发展有限公司', '36'}",6,"{'现金', '方振淳', '易方达工商银行中瑞思创定增1号资产管理计划', '定价', '西藏瑞华投资发展有限公司', '36'}"
17,"{'现金', '玉泉400号资管计划', '100000000', '15082956', '中国再生资源开发有限公司', '45248869', '200000000', '四川省物流产业股权投资基金管理有限公司', '竞价', '银晟资本(天津)股权投资基金管理有限公司', '300000000', '玉泉399号资管计划', '500000000', '供销集团北京鑫诚投资基金管理有限公司', '30165912', '36', '75414782'}",4935655,5,"{'竞价', '300000000', '500000000', '200000000', '75414782'}",5,"{'现金', '中国再生资源开发有限公司', '供销集团北京鑫诚投资基金管理有限公司', '36', '四川省物流产业股权投资基金管理有限公司'}",12,"{'现金', '玉泉400号资管计划', '100000000', '15082956', '中国再生资源开发有限公司', '45248869', '四川省物流产业股权投资基金管理有限公司', '银晟资本(天津)股权投资基金管理有限公司', '供销集团北京鑫诚投资基金管理有限公司', '30165912', '36', '玉泉399号资管计划'}"
4,"{'现金', '竞价', '程宗玉', '36'}",15650075,0,set(),4,"{'36', '竞价', '程宗玉', '现金'}",4,"{'现金', '竞价', '程宗玉', '36'}"
12,"{'王水', '李红磊', '定价', '侯仁峰', '197987769', '50000000', '中国银泰', '96', '198018132', '股权', '36', '16638143'}",919816,0,set(),8,"{'王水', '李红磊', '定价', '侯仁峰', '中国银泰', '96', '股权', '36'}",12,"{'王水', '李红磊', '定价', '侯仁峰', '197987769', '50000000', '中国银泰', '96', '198018132', '股权', '36', '16638143'}"
6,"{'现金', '竞价', '1572873200', '睿康投资', '331829789', '36'}",15261845,1,{'竞价'},3,"{'睿康投资', '现金', '36'}",5,"{'现金', '1572873200', '睿康投资', '331829789', '36'}"
22,"{'上海汽车集团财务有限责任公司', '15400000', '16000000', '东方证券股份有限公司', '100277000', '现金', '兴业全球基金管理有限公司', '12', '22200000', '竞价', '74703000', '汇添富基金管理股份有限公司', '上海国际集团资产管理有限公司', '南京瑞森投资管理合伙企业(有限合伙)', '103642000', '107680000', '中国长城资产管理公司', '11100000', '60588998.79', '14900000', '9002823', '149406000'}",784782,1,{'竞价'},8,"{'上海汽车集团财务有限责任公司', '现金', '兴业全球基金管理有限公司', '上海国际集团资产管理有限公司', '东方证券股份有限公司', '中国长城资产管理公司', '汇添富基金管理股份有限公司', '12'}",21,"{'上海汽车集团财务有限责任公司', '15400000', '16000000', '东方证券股份有限公司', '100277000', '现金', '兴业全球基金管理有限公司', '12', '22200000', '74703000', '汇添富基金管理股份有限公司', '上海国际集团资产管理有限公司', '南京瑞森投资管理合伙企业(有限合伙)', '103642000', '107680000', '中国长城资产管理公司', '11100000', '60588998.79', '14900000', '9002823', '149406000'}"
8,"{'北信瑞丰基金管理有限公司', '平安资产管理有限责任公司', '光大保德信基金管理有限公司', '8292644', '9300000', '泰达宏利基金管理有限公司', '8000000', '12'}",100264,1,{'9300000'},5,"{'北信瑞丰基金管理有限公司', '平安资产管理有限责任公司', '光大保德信基金管理有限公司', '泰达宏利基金管理有限公司', '12'}",7,"{'北信瑞丰基金管理有限公司', '平安资产管理有限责任公司', '光大保德信基金管理有限公司', '8292644', '泰达宏利基金管理有限公司', '8000000', '12'}"
14,"{'20000000', '兴业全球基金管理有限公司', '宏源证券股份有限公司', '13000000', '定价', '18000000', '15000000', '8149120', '易方达基金管理有限公司', '方正证券股份有限公司', '常州投资集团有限公司', '中信证券股份有限公司', '12', '19000000'}",1109651,2,"{'18000000', '19000000'}",7,"{'兴业全球基金管理有限公司', '宏源证券股份有限公司', '定价', '易方达基金管理有限公司', '常州投资集团有限公司', '中信证券股份有限公司', '12'}",12,"{'20000000', '兴业全球基金管理有限公司', '宏源证券股份有限公司', '13000000', '定价', '15000000', '8149120', '易方达基金管理有限公司', '方正证券股份有限公司', '常州投资集团有限公司', '中信证券股份有限公司', '12'}"
23,"{'13400000', '600000000', '博时基金', '现金', '招商财富资产管理认购', '竞价', '自强振兴叁号', '中国人寿资产管理', '10600000', '900000000', '阳光资产管理', '自强振兴肆号', '2400000000', '北京物源股权投资管理', '自强振兴贰号', '848000000', '11500000', '16500000', '700000000', '中国长安', '500000000', '自强振兴壹号', '36'}",1603037,9,"{'13400000', '10600000', '11500000', '600000000', '16500000', '竞价', '700000000', '500000000', '848000000'}",12,"{'中国人寿资产管理', '阳光资产管理', '现金', '招商财富资产管理认购', '自强振兴肆号', '中国长安', '北京物源股权投资管理', '自强振兴叁号', '自强振兴贰号', '自强振兴壹号', '36', '博时基金'}",14,"{'中国人寿资产管理', '现金', '900000000', '阳光资产管理', '招商财富资产管理认购', '自强振兴肆号', '2400000000', '中国长安', '北京物源股权投资管理', '自强振兴叁号', '自强振兴贰号', '自强振兴壹号', '36', '博时基金'}"
6,"{'现金', '其他特定投资者', '12', '中国平安', '竞价', '36'}",444565,0,set(),6,"{'36', '现金', '其他特定投资者', '中国平安', '竞价', '12'}",6,"{'36', '现金', '其他特定投资者', '中国平安', '竞价', '12'}"
12,"{'河南瑞贝卡控股有限责任公司', '现金', '华安基金管理有限公司', '上海重阳资产管理有限公司', '4000000', '2000000', '中国建银投资有限责任公司', '3000000', '中信证券股份有限公司', '1500000', '泰康资产管理有限责任公司', '12'}",823809,0,set(),2,"{'现金', '12'}",12,"{'河南瑞贝卡控股有限责任公司', '现金', '华安基金管理有限公司', '上海重阳资产管理有限公司', '4000000', '2000000', '中国建银投资有限责任公司', '3000000', '中信证券股份有限公司', '1500000', '泰康资产管理有限责任公司', '12'}"
22,"{'257999983.6', '易方达基金管理有限公司', '8420365', '13087470', '泰达宏利基金管理有限公司', '239999994.7', '587999984', '现金', '19190600', '财通基金管理有限公司', '9758485', '竞价', '江苏鱼跃医疗设备股份有限公司2015年度员工持股计划', '298999980.4', '36', '博时基金管理有限公司', '401000080.8', '上海金元百利资产管理有限公司', '7832898', '安信基金管理有限责任公司', '创金合信基金管理有限公司', '12'}",4956117,0,set(),11,"{'现金', '创金合信基金管理有限公司', '12', '博时基金管理有限公司', '财通基金管理有限公司', '易方达基金管理有限公司', '上海金元百利资产管理有限公司', '竞价', '安信基金管理有限责任公司', '泰达宏利基金管理有限公司', '36'}",22,"{'257999983.6', '易方达基金管理有限公司', '8420365', '13087470', '泰达宏利基金管理有限公司', '239999994.7', '587999984', '现金', '12', '19190600', '财通基金管理有限公司', '9758485', '竞价', '江苏鱼跃医疗设备股份有限公司2015年度员工持股计划', '298999980.4', '博时基金管理有限公司', '401000080.8', '上海金元百利资产管理有限公司', '7832898', '安信基金管理有限责任公司', '创金合信基金管理有限公司', '36'}"
27,"{'83644444', '213266668', '14057889', '深圳前海世嘉方盛基金管理合伙企业(有限合伙)', '深圳蒙商基金管理有限公司', '现金', '31630252', '188200000', '定价', '深圳市前海佳浩投资合伙企业(有限合伙)', '298000000', '陈庚发', '625800000', '135294117', '50084033', '深圳市华昊股权投资合伙企业(有限合伙)', '105176470', '许锡忠', '805000000', '深圳市前海富荣资产管理有限公司', '深圳海之门休闲体育发展有限公司', '178800000', '35843137', '167288888', '30050420', '36', '28115779'}",14629391,10,"{'178800000', '188200000', '83644444', '167288888', '625800000', '213266668', '805000000', '14057889', '298000000', '135294117'}",8,"{'现金', '定价', '许锡忠', '陈庚发', '深圳市前海富荣资产管理有限公司', '36', '深圳海之门休闲体育发展有限公司', '深圳蒙商基金管理有限公司'}",17,"{'105176470', '现金', '31630252', '深圳蒙商基金管理有限公司', '35843137', '定价', '许锡忠', '深圳市华昊股权投资合伙企业(有限合伙)', '30050420', '深圳市前海佳浩投资合伙企业(有限合伙)', '深圳前海世嘉方盛基金管理合伙企业(有限合伙)', '陈庚发', '深圳市前海富荣资产管理有限公司', '50084033', '36', '深圳海之门休闲体育发展有限公司', '28115779'}"
17,"{'15003507', '11570827', '现金', '北信瑞丰基金管理有限公司', '广西中恒实业有限公司', '6030855', '5820476', '12', '广东宝新能源投资有限公司', '7012622', '8134642', '安徽省投资集团控股有限公司', '华宝信托有限责任公司', '13048592', '泰达宏利基金管理有限公司', '广东中科招商创业投资管理有限责任公司', '36'}",312617,0,set(),4,"{'12', '现金', '36', '广西中恒实业有限公司'}",17,"{'15003507', '11570827', '现金', '北信瑞丰基金管理有限公司', '广西中恒实业有限公司', '6030855', '5820476', '12', '广东宝新能源投资有限公司', '7012622', '8134642', '安徽省投资集团控股有限公司', '华宝信托有限责任公司', '13048592', '泰达宏利基金管理有限公司', '广东中科招商创业投资管理有限责任公司', '36'}"
16,"{'西藏鼎晟投资管理有限公司', '黄威', '现金', '440900', '九泰基金管理有限公司', '2683300', '2716600', '博时基金管理有限公司', '4400000', '7749300', '天安财产保险股份有限公司', '富国基金管理有限公司', '深圳新华富时资产管理有限公司', '2666600', '12', '5266600'}",2375371,0,set(),9,"{'西藏鼎晟投资管理有限公司', '黄威', '现金', '九泰基金管理有限公司', '博时基金管理有限公司', '天安财产保险股份有限公司', '富国基金管理有限公司', '深圳新华富时资产管理有限公司', '12'}",16,"{'西藏鼎晟投资管理有限公司', '黄威', '440900', '现金', '九泰基金管理有限公司', '2683300', '2716600', '博时基金管理有限公司', '4400000', '7749300', '天安财产保险股份有限公司', '富国基金管理有限公司', '深圳新华富时资产管理有限公司', '2666600', '12', '5266600'}"
19,"{'天津硅谷天堂阳光股权投资基金合伙企业(有限合伙)', '现金', '天迪创新(天津)资产管理合伙企业(有限合伙)', '12', '浙江商裕开盛创业投资合伙企业(有限合伙)', '10800000', '西藏自治区投资有限公司', '4735772', '深圳市中信联合创业投资有限公司', '海通证券股份有限公司', '7800000', '8800000', '博弘数君(天津)股权投资基金合伙企业(有限合伙)', '王仕孝', '华仪电器集团有限公司', '8000000', '7600000', '13900000', '36'}",1504031,0,set(),4,"{'36', '华仪电器集团有限公司', '现金', '12'}",19,"{'天津硅谷天堂阳光股权投资基金合伙企业(有限合伙)', '现金', '天迪创新(天津)资产管理合伙企业(有限合伙)', '12', '浙江商裕开盛创业投资合伙企业(有限合伙)', '10800000', '西藏自治区投资有限公司', '4735772', '深圳市中信联合创业投资有限公司', '海通证券股份有限公司', '7800000', '8800000', '博弘数君(天津)股权投资基金合伙企业(有限合伙)', '王仕孝', '华仪电器集团有限公司', '8000000', '7600000', '13900000', '36'}"
8,"{'现金', '1999999998', '中绒集团', '37037037', '中信证券', '246913580', '299999999.7', '36'}",726463,0,set(),4,"{'中信证券', '36', '现金', '中绒集团'}",8,"{'现金', '1999999998', '中绒集团', '37037037', '中信证券', '246913580', '299999999.7', '36'}"
8,"{'物美控股', '现金', '定价', '上海宝银', '2800000', '上海兆赢', '36', '51030000'}",1647406,2,"{'2800000', '51030000'}",6,"{'物美控股', '现金', '定价', '上海兆赢', '36', '上海宝银'}",6,"{'物美控股', '现金', '定价', '上海兆赢', '36', '上海宝银'}"
6,"{'现金', '中联水泥', '定价', '48000000', '302400000', '36'}",578154,1,{'302400000'},4,"{'定价', '中联水泥', '现金', '36'}",5,"{'现金', '中联水泥', '定价', '48000000', '36'}"
8,"{'139534245', '现金', '中国恒天', '中国纺机', '债权', '竞价', '300000000', '36'}",1411385,1,{'139534245'},6,"{'现金', '中国恒天', '中国纺机', '债权', '竞价', '36'}",7,"{'现金', '中国恒天', '中国纺机', '债权', '竞价', '300000000', '36'}"
5,"{'现金', '定价', '深圳华侨城资本投资管理有限公司', '153007945', '36'}",12057574,1,{'153007945'},4,"{'深圳华侨城资本投资管理有限公司', '36', '定价', '现金'}",4,"{'深圳华侨城资本投资管理有限公司', '定价', '现金', '36'}"
14,"{'现金', '龙岩市汇金永盛壹号投资合伙企业(有限合伙)', '九泰基金管理有限公司', '中意资产管理有限责任公司', '14754702', '鹏华资产管理有限公司', '定价', '山东高速股份有限公司', '2692785', '3319807', '768195', '四川三新创业投资有限责任公司', '2692733', '12'}",18274020,0,set(),8,"{'现金', '九泰基金管理有限公司', '中意资产管理有限责任公司', '鹏华资产管理有限公司', '定价', '山东高速股份有限公司', '四川三新创业投资有限责任公司', '12'}",14,"{'现金', '龙岩市汇金永盛壹号投资合伙企业(有限合伙)', '九泰基金管理有限公司', '中意资产管理有限责任公司', '14754702', '鹏华资产管理有限公司', '3319807', '山东高速股份有限公司', '2692785', '定价', '768195', '四川三新创业投资有限责任公司', '2692733', '12'}"
13,"{'上海尚铭金属材料有限公司', '中国人保资产管理股份有限公司', '北京金创年达投资管理有限公司', '2000000', '22300000', '上海奡骁商务咨询服务有限公司', '竞价', '3000000', '33450000', '7350000', '81952500', '12', '湖南嘉宇实业有限公司'}",551901,0,set(),3,"{'中国人保资产管理股份有限公司', '竞价', '12'}",13,"{'上海尚铭金属材料有限公司', '中国人保资产管理股份有限公司', '北京金创年达投资管理有限公司', '2000000', '22300000', '上海奡骁商务咨询服务有限公司', '33450000', '3000000', '竞价', '7350000', '81952500', '12', '湖南嘉宇实业有限公司'}"
5,"{'现金', '航天科工资产管理有限公司', '竞价', '中国航天科工集团公司', '36'}",1092784,0,set(),5,"{'现金', '航天科工资产管理有限公司', '竞价', '中国航天科工集团公司', '36'}",5,"{'现金', '航天科工资产管理有限公司', '竞价', '中国航天科工集团公司', '36'}"
10,"{'55873646', '现金', '方正集团', '149277978', '方正证券金橘1号', '92393502', '方正证券金橘2号', '202454874', '方正信产', '36'}",9857,4,"{'55873646', '202454874', '149277978', '92393502'}",3,"{'现金', '方正信产', '方正集团'}",6,"{'现金', '方正集团', '方正证券金橘1号', '方正证券金橘2号', '方正信产', '36'}"
19,"{'甘肃省信托投资有限责任公司', '上海融昌资产管理有限公司', '1000000', '广发证券股份有限公司', '4000000', '4350000', '7000000', '2900000', '易方达基金管理有限公司', 'Martin Currie Investment Management Limited', '竞价', '2000000', '深圳市光控投资咨询有限公司', '中国人寿资产管理有限公司', '许昌县新和工艺品有限责任公司', '国都证券有限责任公司', '8000000', '中海基金管理有限公司', '12'}",1524346,7,"{'4000000', 'Martin Currie Investment Management Limited', '2900000', '7000000', '2000000', '竞价', '1000000'}",3,"{'广发证券股份有限公司', '12', '许昌县新和工艺品有限责任公司'}",12,"{'甘肃省信托投资有限责任公司', '上海融昌资产管理有限公司', '广发证券股份有限公司', '4350000', '深圳市光控投资咨询有限公司', '易方达基金管理有限公司', '中国人寿资产管理有限公司', '许昌县新和工艺品有限责任公司', '国都证券有限责任公司', '8000000', '中海基金管理有限公司', '12'}"
4,"{'竞价', '现金', '36', '中国电能成套设备有限公司'}",1659623,1,{'竞价'},3,"{'现金', '36', '中国电能成套设备有限公司'}",3,"{'现金', '36', '中国电能成套设备有限公司'}"
18,"{'800000000', '209424083', '康美实业有限公司', '现金', '98167539', '163612565', '100000000', '52356020', '广发证券资产管理(广东)有限公司(广发原驰•康美药业1号定向资产管理计划)', '6544502', '竞价', '浙江天堂硅谷资产管理集团有限公司(天堂硅谷康赋资产管理计划)', '华安未来资产管理(上海)有限公司(华安资产湾流康美定增1号资产管理计划)', '长城国瑞证券有限公司(长城国瑞证券阳光2号定向资产管理计划)', '1500000000', '2500000000', '36', '3200000000'}",6121633,6,"{'800000000', '100000000', '竞价', '1500000000', '2500000000', '3200000000'}",3,"{'现金', '康美实业有限公司', '36'}",12,"{'209424083', '康美实业有限公司', '现金', '98167539', '163612565', '52356020', '广发证券资产管理(广东)有限公司(广发原驰•康美药业1号定向资产管理计划)', '6544502', '浙江天堂硅谷资产管理集团有限公司(天堂硅谷康赋资产管理计划)', '华安未来资产管理(上海)有限公司(华安资产湾流康美定增1号资产管理计划)', '长城国瑞证券有限公司(长城国瑞证券阳光2号定向资产管理计划)', '36'}"
13,"{'厦门豫联投资合伙企业(有限合伙)', '214797136', '河南豫联能源集团有限责任公司', '900000000', '合恩伟业(深圳)资产管理中心(有限合伙)', '北京银杏盛鸿投资管理有限公司', '107398568', '450000000', '厦门文创汇通投资合伙企业(有限合伙)', '北京蓝巨房地产投资基金管理中心(有限合伙)', '南通卓联资产管理有限公司', '厦门向日葵朝阳投资合伙企业(有限合伙)', '36'}",1907174,3,"{'450000000', '214797136', '900000000'}",4,"{'南通卓联资产管理有限公司', '河南豫联能源集团有限责任公司', '36', '北京银杏盛鸿投资管理有限公司'}",10,"{'厦门豫联投资合伙企业(有限合伙)', '36', '河南豫联能源集团有限责任公司', '合恩伟业(深圳)资产管理中心(有限合伙)', '北京银杏盛鸿投资管理有限公司', '厦门文创汇通投资合伙企业(有限合伙)', '北京蓝巨房地产投资基金管理中心(有限合伙)', '南通卓联资产管理有限公司', '厦门向日葵朝阳投资合伙企业(有限合伙)', '107398568'}"
5,"{'现金', '64000000', '竞价', '国有独资公司滨州市国有资产经营有限公司', '36'}",1179787,1,{'64000000'},4,"{'国有独资公司滨州市国有资产经营有限公司', '竞价', '现金', '36'}",4,"{'国有独资公司滨州市国有资产经营有限公司', '竞价', '现金', '36'}"
20,"{'6920323', '28859219', '王林', '咸阳市能源开发投资有限公司', '43995585', '四川恒康资产管理有限公司', '张政', '12', '定价', '深圳市奥格立电子科技有限公司', '楼允', '徐跃东', '浦伟杰', '138553701', '深圳市汇世邦科技有限公司', '3474886', '19553594', '陕西力加投资有限公司', '36', '13870094'}",913723,0,set(),13,"{'王林', '36', '咸阳市能源开发投资有限公司', '四川恒康资产管理有限公司', '12', '深圳市奥格立电子科技有限公司', '定价', '楼允', '徐跃东', '浦伟杰', '深圳市汇世邦科技有限公司', '陕西力加投资有限公司', '张政'}",20,"{'6920323', '28859219', '王林', '咸阳市能源开发投资有限公司', '43995585', '四川恒康资产管理有限公司', '张政', '12', '深圳市奥格立电子科技有限公司', '定价', '楼允', '徐跃东', '浦伟杰', '138553701', '深圳市汇世邦科技有限公司', '3474886', '19553594', '陕西力加投资有限公司', '36', '13870094'}"
23,"{'60349984.5', '天风证券股份有限公司', '59999985.5', '60000019.3', '国投瑞银基金管理有限公司', '3550297', '现金', '浙江天堂硅谷资产管理集团有限公司', '财通基金管理有限公司', '竞价', '60000002.4', '3571005', '鹏华资产管理(深圳)有限公司', '高王伟', '36', '12211834', '富国基金管理有限公司', '3550295', '93270018.4', '5518936', '3550296', '206379994.6', '12'}",9881489,1,{'竞价'},9,"{'高王伟', '现金', '天风证券股份有限公司', '12', '浙江天堂硅谷资产管理集团有限公司', '财通基金管理有限公司', '富国基金管理有限公司', '国投瑞银基金管理有限公司', '36'}",22,"{'60349984.5', '天风证券股份有限公司', '59999985.5', '60000019.3', '国投瑞银基金管理有限公司', '3550297', '现金', '浙江天堂硅谷资产管理集团有限公司', '财通基金管理有限公司', '60000002.4', '3571005', '鹏华资产管理(深圳)有限公司', '高王伟', '36', '12211834', '富国基金管理有限公司', '3550295', '93270018.4', '5518936', '3550296', '206379994.6', '12'}"
4,"{'竞价', '现金', '宁波峰梅', '36'}",15599322,0,set(),4,"{'竞价', '现金', '宁波峰梅', '36'}",4,"{'竞价', '现金', '宁波峰梅', '36'}"
30,"{'26800000', '3000000', '张邦辉', '张雷', '王韦', '200000000', '现金', '21164021', '352733', '4726631', '田萍', '1200000', '35273368', '程国浩', '10000000', '529100', '211640', '1763668', '傅衍', '60000000', '120000000', '25000000', '陆裕肖', '吴天星', '4409171', '10582010', '2000000', '胡来根', '陈能兴', '36'}",12088,8,"{'26800000', '60000000', '1200000', '3000000', '120000000', '25000000', '10000000', '200000000'}",12,"{'陆裕肖', '现金', '吴天星', '傅衍', '胡来根', '田萍', '程国浩', '张邦辉', '张雷', '王韦', '陈能兴', '36'}",22,"{'张邦辉', '张雷', '王韦', '现金', '21164021', '352733', '4726631', '田萍', '35273368', '211640', '529100', '程国浩', '1763668', '傅衍', '陆裕肖', '吴天星', '4409171', '10582010', '2000000', '胡来根', '陈能兴', '36'}"
10,"{'39102421', '现金', '章建平', '定价', '财通基金管理有限公司', '嘉实基金管理有限公司', '21328593', '中邮创业基金管理股份有限公司', '24883361', '12'}",9905304,0,set(),7,"{'章建平', '现金', '定价', '嘉实基金管理有限公司', '财通基金管理有限公司', '中邮创业基金管理股份有限公司', '12'}",10,"{'39102421', '章建平', '现金', '定价', '财通基金管理有限公司', '嘉实基金管理有限公司', '21328593', '中邮创业基金管理股份有限公司', '24883361', '12'}"
17,"{'565428', '吴鉴洪', '5000000', '现金', '陈小花', '方杰', '定价', '4000000', '403877', '7000000', '百善仁和', '170000000', '刘海兵', '郑郁', '323101', '36', '13731825'}",15699398,3,"{'565428', '323101', '403877'}",8,"{'吴鉴洪', '现金', '方杰', '定价', '百善仁和', '刘海兵', '郑郁', '陈小花'}",14,"{'吴鉴洪', '5000000', '现金', '方杰', '4000000', '定价', '7000000', '百善仁和', '170000000', '刘海兵', '郑郁', '陈小花', '36', '13731825'}"
6,"{'现金', '34251175', '袁亚琴', '竞价', '李海鹰', '36'}",1816112,2,"{'竞价', '34251175'}",4,"{'李海鹰', '现金', '袁亚琴', '36'}",4,"{'36', '李海鹰', '现金', '袁亚琴'}"
6,"{'现金', '1642000000', '定价', '199249088', '以化上海', '36'}",296122,1,{'1642000000'},4,"{'定价', '现金', '36', '以化上海'}",5,"{'现金', '定价', '199249088', '以化上海', '36'}"
16,"{'29579063', '九泰基金', '499999987.8', '现金', '泰康资管', '499999943.9', '1299999819', '定价', '11376564', '平安资管', '11376563', '兴证资管', '799999962.9', '18202502', '36', '博时基金'}",1668312,6,"{'29579063', '499999943.9', '1299999819', '11376563', '11376564', '18202502'}",8,"{'九泰基金', '泰康资管', '现金', '定价', '平安资管', '兴证资管', '36', '博时基金'}",10,"{'499999987.8', '九泰基金', '现金', '泰康资管', '定价', '平安资管', '兴证资管', '799999962.9', '36', '博时基金'}"
5,"{'现金', '1000000000', '竞价', '海航资本', '36'}",926247,1,{'1000000000'},4,"{'海航资本', '竞价', '现金', '36'}",4,"{'海航资本', '竞价', '现金', '36'}"
4,"{'36', '竞价', '110000000', '深圳市华融泰资产管理有限公司'}",813791,1,{'竞价'},2,"{'36', '深圳市华融泰资产管理有限公司'}",3,"{'36', '110000000', '深圳市华融泰资产管理有限公司'}"
14,"{'温旭普', '6000000', '5000000', '吉林省洮儿河酒业有限公司', '4000000', '陶景超', '5400000', '马利群', '杨学农', '唐嘉孺', '钟会强', '9900000', '吉祥大酒店有限公司', '36'}",1152707,0,set(),2,"{'吉祥大酒店有限公司', '吉林省洮儿河酒业有限公司'}",14,"{'温旭普', '6000000', '5000000', '吉林省洮儿河酒业有限公司', '4000000', '陶景超', '5400000', '马利群', '杨学农', '唐嘉孺', '钟会强', '9900000', '吉祥大酒店有限公司', '36'}"
17,"{'泰康资产管理有限责任公司', '3399489', '5000000', '现金', '周厚娟', '连云港港口集团有限公司', '12', '13000000', '周桂月', '昆明盛世景投资中心(有限合伙)', '竞价', '博弘数君(天津)股权投资基金合伙企业(有限合伙)', '深圳市宏邦兴业投资发展有限公司', '42335204', '8000000', '36', '天津证大金兔股权投资基金合伙企业(有限合伙)'}",502860,0,set(),9,"{'泰康资产管理有限责任公司', '现金', '周厚娟', '连云港港口集团有限公司', '12', '周桂月', '竞价', '深圳市宏邦兴业投资发展有限公司', '36'}",17,"{'泰康资产管理有限责任公司', '3399489', '5000000', '现金', '周厚娟', '连云港港口集团有限公司', '12', '13000000', '周桂月', '昆明盛世景投资中心(有限合伙)', '竞价', '博弘数君(天津)股权投资基金合伙企业(有限合伙)', '深圳市宏邦兴业投资发展有限公司', '42335204', '8000000', '36', '天津证大金兔股权投资基金合伙企业(有限合伙)'}"
16,"{'山西省乡镇煤炭运销集团有限公司', '杭州通诚投资有限公司', '5000000', '现金', 'Bill&melindagatesfoundation', '上投摩根基金管理有限公司', '甘肃宝能能源投资开发有限公司', '上海邦联资产管理有限公司', '7000000', '广发基金管理有限公司', '红塔证券股份有限公司', '6000000', '8000000', '28000000', '12', '无锡市宝联投资有限公司'}",1368521,1,{'5000000'},2,"{'现金', '12'}",15,"{'山西省乡镇煤炭运销集团有限公司', '杭州通诚投资有限公司', '现金', 'Bill&melindagatesfoundation', '上投摩根基金管理有限公司', '甘肃宝能能源投资开发有限公司', '上海邦联资产管理有限公司', '7000000', '广发基金管理有限公司', '红塔证券股份有限公司', '6000000', '8000000', '28000000', '12', '无锡市宝联投资有限公司'}"
8,"{'现金', '16638900', '圳市华建盈富投资企业(有限合伙)', '中铁信托有限责任公司', '8319451', '141431000', '国泰君安金融控股有限公司', '36'}",295431,0,set(),4,"{'现金', '中铁信托有限责任公司', '36', '国泰君安金融控股有限公司'}",8,"{'现金', '16638900', '圳市华建盈富投资企业(有限合伙)', '中铁信托有限责任公司', '8319451', '141431000', '国泰君安金融控股有限公司', '36'}"
15,"{'南京瑞森投资管理合伙企业(有限合伙)', '3800000', '5000000', '现金', '3500000', '招商基金管理有限公司', '郝慧', '竞价', '常州投资集团有限公司', '4200000', '东吴证券股份有限公司', '西藏瑞华投资发展有限公司', '泰康资产管理有限责任公司', '10000000', '12'}",1170733,1,{'竞价'},5,"{'现金', '郝慧', '常州投资集团有限公司', '泰康资产管理有限责任公司', '12'}",14,"{'南京瑞森投资管理合伙企业(有限合伙)', '3800000', '5000000', '现金', '3500000', '招商基金管理有限公司', '郝慧', '常州投资集团有限公司', '4200000', '东吴证券股份有限公司', '西藏瑞华投资发展有限公司', '泰康资产管理有限责任公司', '10000000', '12'}"
14,"{'14597970', '现金', '146494314.5', '创金合信基金管理有限公司', '11435934', '17954722', '161999999.7', '竞价', '12646370', '229999988.8', '天弘基金管理有限公司', '泰达宏利基金管理有限公司', '建信基金管理有限责任公司', '186999995.7'}",4946785,1,{'竞价'},5,"{'现金', '泰达宏利基金管理有限公司', '天弘基金管理有限公司', '创金合信基金管理有限公司', '建信基金管理有限责任公司'}",13,"{'14597970', '现金', '146494314.5', '创金合信基金管理有限公司', '11435934', '17954722', '161999999.7', '229999988.8', '12646370', '天弘基金管理有限公司', '泰达宏利基金管理有限公司', '建信基金管理有限责任公司', '186999995.7'}"
9,"{'120272398', '现金', '79376000', '浙江南洋科技股份有限公司-第1期员工持股计划', '定价', '1058397102', '邵奕兴', '36', '9020000'}",1775592,0,set(),4,"{'现金', '定价', '邵奕兴', '36'}",9,"{'120272398', '现金', '79376000', '浙江南洋科技股份有限公司-第1期员工持股计划', '定价', '1058397102', '邵奕兴', '36', '9020000'}"
5,"{'现金', '985748000', '竞价', '鸿达兴业集团', '36'}",14048119,2,"{'985748000', '竞价'}",3,"{'现金', '鸿达兴业集团', '36'}",3,"{'现金', '鸿达兴业集团', '36'}"
22,"{'东吴基金管理有限公司', '919542', '159999994.8', '12000023.1', '12260536', '华夏资本管理有限公司', '59999998.05', '兴业全球基金管理有限公司', '99999996.75', '4597701', '财通基金管理有限公司', '竞价', '鹏华基金管理有限公司', '南京瑞森投资管理合伙企业(有限合伙)', '82999996.65', '77999993.55', '6360153', '8199233', '嘉实基金管理有限公司', '106999990.7', '5977011', '7662835'}",905462,2,"{'106999990.7', '竞价'}",0,set(),20,"{'南京瑞森投资管理合伙企业(有限合伙)', '东吴基金管理有限公司', '华夏资本管理有限公司', '59999998.05', '兴业全球基金管理有限公司', '77999993.55', '82999996.65', '4597701', '7662835', '99999996.75', '919542', '嘉实基金管理有限公司', '财通基金管理有限公司', '5977011', '鹏华基金管理有限公司', '6360153', '159999994.8', '12000023.1', '12260536', '8199233'}"
5,"{'Art Garden', '竞价', '物产国际', '36', '46552901'}",1275837,1,{'竞价'},3,"{'物产国际', 'Art Garden', '36'}",4,"{'物产国际', '36', '46552901', 'Art Garden'}"
5,"{'现金', '海南控股', '定价', '海航集团', '36'}",1154515,0,set(),4,"{'海航集团', '定价', '现金', '海南控股'}",5,"{'现金', '海南控股', '定价', '海航集团', '36'}"
6,"{'现金', '138078380', '20578000', '定价', '保税科技2015年度员工持股计划', '36'}",12064594,0,set(),3,"{'定价', '现金', '36'}",6,"{'现金', '138078380', '20578000', '定价', '保税科技2015年度员工持股计划', '36'}"
23,"{'91934484', '2076800000', '27268702', '定价', '616000000', '1319500000', '92400000', '兴隆18号资管计划', '10907481', '5467374', '58410801', '吕清明', '丰信管理', '信利隆科技', '4090305', '兴隆17号资管计划', '246400000', '123508000', '556740000', '24645418', '德勤贸易', '龙跃投资', '36'}",16016791,0,set(),9,"{'兴隆17号资管计划', '吕清明', '丰信管理', '定价', '信利隆科技', '德勤贸易', '龙跃投资', '兴隆18号资管计划', '36'}",23,"{'91934484', '2076800000', '27268702', '定价', '616000000', '1319500000', '92400000', '兴隆18号资管计划', '10907481', '5467374', '58410801', '吕清明', '丰信管理', '信利隆科技', '4090305', '兴隆17号资管计划', '246400000', '123508000', '556740000', '24645418', '德勤贸易', '龙跃投资', '36'}"
20,"{'499999995.8', '广发证券资产管理(广东)有限公司', '太平洋资产管理有限责任公司', '现金', '250002000', '249999997.9', '长城(天津)股权投资基金管理有限责任公司', '财通基金管理有限公司', '48450000', '7170541', '国信国投基金管理(北京)有限公司', '竞价', '36999991.56', '50387596', '信泰人寿保险股份有限公司', '96899224', '华商基金管理有限公司', '12', '48449612', '259999995.4'}",19304784,2,"{'竞价', '259999995.4'}",7,"{'太平洋资产管理有限责任公司', '现金', '财通基金管理有限公司', '国信国投基金管理(北京)有限公司', '信泰人寿保险股份有限公司', '华商基金管理有限公司', '12'}",18,"{'499999995.8', '广发证券资产管理(广东)有限公司', '太平洋资产管理有限责任公司', '现金', '250002000', '249999997.9', '长城(天津)股权投资基金管理有限责任公司', '财通基金管理有限公司', '48450000', '7170541', '国信国投基金管理(北京)有限公司', '36999991.56', '50387596', '信泰人寿保险股份有限公司', '96899224', '华商基金管理有限公司', '12', '48449612'}"
12,"{'现金', '吉林省东丰药业股份有限公司', '412088', '1373626', '陈德康', '同药集团有限公司', '2747252', '中华联合财产保险股份有限公司', '平安资产鑫享7号资产管理产品', '浙江商裕投资管理有限公司', '5219782', '36'}",15553134,0,set(),8,"{'现金', '吉林省东丰药业股份有限公司', '陈德康', '同药集团有限公司', '浙江商裕投资管理有限公司', '中华联合财产保险股份有限公司', '平安资产鑫享7号资产管理产品', '36'}",12,"{'现金', '吉林省东丰药业股份有限公司', '412088', '1373626', '陈德康', '同药集团有限公司', '2747252', '中华联合财产保险股份有限公司', '平安资产鑫享7号资产管理产品', '浙江商裕投资管理有限公司', '5219782', '36'}"
4,"{'山东科信创业投资有限责任公司', '36', '现金', '山东富宇蓝石轮胎有限公司'}",1220314,0,set(),4,"{'山东富宇蓝石轮胎有限公司', '现金', '36', '山东科信创业投资有限责任公司'}",4,"{'山东科信创业投资有限责任公司', '36', '现金', '山东富宇蓝石轮胎有限公司'}"
15,"{'149967500', '100015500', '现金', '13450000', '111500000', '定价', '兰坤', '财通基金管理有限公司', '33450000', '3000000', '8970000', '方德-香山3号证券投资基金', '10000000', '36', '王寿纯'}",1783887,8,"{'149967500', '100015500', '13450000', '111500000', '33450000', '8970000', '方德-香山3号证券投资基金', '10000000'}",6,"{'现金', '定价', '兰坤', '财通基金管理有限公司', '36', '王寿纯'}",7,"{'现金', '定价', '兰坤', '财通基金管理有限公司', '3000000', '36', '王寿纯'}"
6,"{'799999958.3', '现金', '湖南老百姓医药投资管理有限公司', '定价', '17945266', '36'}",16923747,1,{'799999958.3'},3,"{'36', '定价', '现金'}",5,"{'现金', '湖南老百姓医药投资管理有限公司', '定价', '17945266', '36'}"
28,"{'1106559994', '271749999', '申万菱信(上海)资产管理有限公司', '泰达宏利基金管理有限公司', '28073347', '现金', '34338006', '财通基金管理有限公司', '中广核财务有限责任公司', '竞价', '41313181', '15772574', '36', '399394999.5', '陕西煤业化工集团有限责任公司', '29735537', '中节能资本控股有限公司', '249472998.7', '287839998.2', '152678516.3', '332391898.1', '399911592.1', '114314049', '25772004', '华宝信托有限责任公司', '创金合信基金管理有限公司', '41259814', '12'}",1841876,4,"{'399911592.1', '287839998.2', '271749999', '332391898.1'}",10,"{'现金', '陕西煤业化工集团有限责任公司', '创金合信基金管理有限公司', '12', '中节能资本控股有限公司', '中广核财务有限责任公司', '华宝信托有限责任公司', '竞价', '泰达宏利基金管理有限公司', '36'}",24,"{'1106559994', '申万菱信(上海)资产管理有限公司', '泰达宏利基金管理有限公司', '28073347', '现金', '34338006', '财通基金管理有限公司', '中广核财务有限责任公司', '41313181', '竞价', '15772574', '36', '399394999.5', '陕西煤业化工集团有限责任公司', '29735537', '中节能资本控股有限公司', '249472998.7', '152678516.3', '114314049', '25772004', '华宝信托有限责任公司', '创金合信基金管理有限公司', '41259814', '12'}"
6,"{'现金', '定价', '第一期员工持股计划', '254000000', '25000000', '36'}",14768951,2,"{'254000000', '25000000'}",4,"{'第一期员工持股计划', '36', '定价', '现金'}",4,"{'第一期员工持股计划', '定价', '现金', '36'}"
4,"{'北京华信六合投资有限公司', '竞价', '60', '现金'}",397447,0,set(),4,"{'北京华信六合投资有限公司', '竞价', '60', '现金'}",4,"{'北京华信六合投资有限公司', '60', '现金', '竞价'}"
5,"{'现金', '423728813', '定价', '漯河银鸽实业集团有限公司', '36'}",1692273,0,set(),4,"{'定价', '漯河银鸽实业集团有限公司', '现金', '36'}",5,"{'现金', '423728813', '定价', '漯河银鸽实业集团有限公司', '36'}"
6,"{'21505400', '现金', '100000000', '建设集团', '竞价', '36'}",2036029,2,"{'100000000', '21505400'}",4,"{'建设集团', '竞价', '现金', '36'}",4,"{'建设集团', '竞价', '现金', '36'}"
65,"{'5592505', '34379920', '郑善伟', '50933211', '11409014', '20373296', '372833', '冯天放', '宇扬锦达', '3106947', '22919915', '331407', '76399839', '许小平', '2796251', '杨俊杰', '王德宁', '828519', '9167967', '114599757', '9320842', '1398126', '徐厚华', '4660421', '陈静', '申海山', '8141560', '1757817', '137519718', '赵忠彬', '天图投资', '利源顶盛', '1151641', '28318872', '天图兴瑞', '何长津', '117146425', '天图兴盛', '车志远', '43224730', '1035647', '卓程达', '高淑杰', '89133129', '25466583', '唐征卫', '132426382', '68759836', '932082', '3624771', '8149310', '394732524', '利扬盛达', '200200970', '王有昌', '黄玉珍', '2071297', '杨雨', '16052562', '施侃', '中金盛世', '229199511', '4763986', '徐庆良', '江苏国投'}",2355102,12,"{'932082', '3624771', '828519', '1398126', '372833', '4660421', '2071297', '1035647', '3106947', '4763986', '1151641', '2796251'}",27,"{'郑善伟', '冯天放', '宇扬锦达', '许小平', '杨俊杰', '王德宁', '徐厚华', '陈静', '申海山', '赵忠彬', '天图投资', '利源顶盛', '天图兴瑞', '何长津', '天图兴盛', '车志远', '唐征卫', '卓程达', '高淑杰', '利扬盛达', '王有昌', '黄玉珍', '杨雨', '施侃', '中金盛世', '徐庆良', '江苏国投'}",53,"{'5592505', '34379920', '郑善伟', '50933211', '11409014', '20373296', '冯天放', '宇扬锦达', '22919915', '331407', '76399839', '许小平', '杨俊杰', '王德宁', '9167967', '114599757', '9320842', '徐厚华', '陈静', '申海山', '8141560', '1757817', '137519718', '赵忠彬', '天图投资', '利源顶盛', '28318872', '天图兴瑞', '何长津', '117146425', '天图兴盛', '车志远', '43224730', '唐征卫', '卓程达', '高淑杰', '89133129', '25466583', '132426382', '68759836', '8149310', '394732524', '利扬盛达', '200200970', '王有昌', '黄玉珍', '杨雨', '16052562', '施侃', '中金盛世', '229199511', '徐庆良', '江苏国投'}"
11,"{'招商财富资产管理有限公司', '现金', '山西证券股份有限公司', '5390835', '张友明', '定价', '12722371', '2695417', '6041377', '12', '上银基金管理有限公司'}",1727309,1,{'2695417'},3,"{'定价', '现金', '12'}",10,"{'招商财富资产管理有限公司', '现金', '山西证券股份有限公司', '张友明', '5390835', '定价', '12722371', '6041377', '12', '上银基金管理有限公司'}"
5,"{'现金', '中国贵州航空工业(集团)有限责任公司', '竞价', '4481', '36'}",550717,2,"{'4481', '竞价'}",1,{'现金'},3,"{'现金', '36', '中国贵州航空工业(集团)有限责任公司'}"
5,"{'现金', '329000000', '竞价', '国投电力', '36'}",122616,2,"{'竞价', '329000000'}",3,"{'现金', '国投电力', '36'}",3,"{'现金', '国投电力', '36'}"
4,"{'竞价', '现金', '第五季国际投资控股有限公司', '36'}",892081,0,set(),4,"{'竞价', '现金', '第五季国际投资控股有限公司', '36'}",4,"{'竞价', '现金', '第五季国际投资控股有限公司', '36'}"
5,"{'现金', '4000000000', '竞价', '中航集团公司', '36'}",1837462,2,"{'竞价', '4000000000'}",3,"{'中航集团公司', '现金', '36'}",3,"{'中航集团公司', '现金', '36'}"
5,"{'现金', '竞价', '50000000', '杨晓涛', '36'}",1061647,1,{'50000000'},4,"{'36', '竞价', '现金', '杨晓涛'}",4,"{'杨晓涛', '竞价', '现金', '36'}"
6,"{'现金', '12', '其他发行对象', '竞价', '葛洲坝集团', '36'}",1112288,0,set(),6,"{'36', '现金', '其他发行对象', '竞价', '葛洲坝集团', '12'}",6,"{'现金', '12', '其他发行对象', '竞价', '葛洲坝集团', '36'}"
9,"{'现金', '10046642', '竞价', '国海创新资本投资管理有限公司', '20093283', '西藏瑞华投资发展有限公司', '南通威望实业有限公司', '36', '30139925'}",1741219,1,{'竞价'},5,"{'现金', '国海创新资本投资管理有限公司', '西藏瑞华投资发展有限公司', '南通威望实业有限公司', '36'}",8,"{'现金', '10046642', '国海创新资本投资管理有限公司', '20093283', '西藏瑞华投资发展有限公司', '南通威望实业有限公司', '36', '30139925'}"
12,"{'张旭', '沈沧琼', '中融国际信托有限公司', '铁岭新鑫铜业有限公司', '7000000', '竞价', '施宝忠', '5745200', '11200000', '10000000', '12', '陈炳林'}",1249325,1,{'竞价'},1,{'12'},11,"{'张旭', '沈沧琼', '中融国际信托有限公司', '铁岭新鑫铜业有限公司', '7000000', '施宝忠', '5745200', '11200000', '10000000', '12', '陈炳林'}"
4,"{'中环投资', '现金', '竞价', '36'}",15781034,0,set(),4,"{'中环投资', '现金', '竞价', '36'}",4,"{'中环投资', '现金', '竞价', '36'}"
5,"{'现金', '西湖电子集团', '竞价', '16680000', '36'}",6423343,1,{'16680000'},4,"{'竞价', '现金', '36', '西湖电子集团'}",4,"{'竞价', '现金', '36', '西湖电子集团'}"
12,"{'5000000', '现金', '中航鑫港担保有限公司', '大成基金管理有限公司', '7400000', '陈世明', '4100000', '竞价', '富国基金管理有限公司', '上海天迪科技投资发展有限公司', '10000000', '12'}",1442933,1,{'竞价'},7,"{'现金', '中航鑫港担保有限公司', '大成基金管理有限公司', '陈世明', '富国基金管理有限公司', '上海天迪科技投资发展有限公司', '12'}",11,"{'5000000', '现金', '中航鑫港担保有限公司', '大成基金管理有限公司', '7400000', '陈世明', '4100000', '富国基金管理有限公司', '上海天迪科技投资发展有限公司', '10000000', '12'}"
9,"{'现金', '4155463', '九泰基金-花园生物定增1号资产管理计划', '竞价', '6159863', '龚锦青', '169999991.3', '251999995.3', '12'}",18872014,1,{'竞价'},3,"{'现金', '龚锦青', '12'}",8,"{'现金', '4155463', '九泰基金-花园生物定增1号资产管理计划', '6159863', '龚锦青', '169999991.3', '251999995.3', '12'}"
12,"{'浙江商裕开盛创业投资合伙企业(有限合伙', '现金', '北京齐物阳光投资有限公司', '邦信资产管理有限公司', '2680000', '中国银河投资管理有限公司', '4100000', '四川信托有限公司', '2800000', '中信证券股份有限公司', '3000000', '12'}",1213136,2,"{'3000000', '4100000'}",7,"{'北京齐物阳光投资有限公司', '现金', '邦信资产管理有限公司', '12', '中国银河投资管理有限公司', '中信证券股份有限公司', '四川信托有限公司'}",10,"{'浙江商裕开盛创业投资合伙企业(有限合伙', '现金', '北京齐物阳光投资有限公司', '邦信资产管理有限公司', '12', '2680000', '中国银河投资管理有限公司', '2800000', '中信证券股份有限公司', '四川信托有限公司'}"
9,"{'369999997.6', '现金', '39194915', '49999998.4', '启迪科服投资', '竞价', '万安兴业', '36', '5296610'}",1817257,1,{'竞价'},4,"{'现金', '万安兴业', '启迪科服投资', '36'}",8,"{'369999997.6', '现金', '39194915', '49999998.4', '启迪科服投资', '万安兴业', '36', '5296610'}"
15,"{'5000000', '8000000', '新华人寿保险股份有限公司', '4000000', '定价', '博时基金管理有限公司', '东方证券股份有限公司', '招商基金管理有限公司', '上海星河数码投资有限公司', '3000000', '上海国际信托投资有限公司', '上海致群实业发展有限公司', '9000000', '宬隆控股有限公司', '12'}",1523641,2,"{'9000000', '8000000'}",10,"{'新华人寿保险股份有限公司', '博时基金管理有限公司', '定价', '东方证券股份有限公司', '招商基金管理有限公司', '上海星河数码投资有限公司', '上海国际信托投资有限公司', '上海致群实业发展有限公司', '宬隆控股有限公司', '12'}",13,"{'5000000', '新华人寿保险股份有限公司', '4000000', '博时基金管理有限公司', '招商基金管理有限公司', '东方证券股份有限公司', '定价', '上海星河数码投资有限公司', '3000000', '上海国际信托投资有限公司', '上海致群实业发展有限公司', '宬隆控股有限公司', '12'}"
17,"{'华基丰收(天津)投资合伙企业(有限合伙)', '5000000', '4500000', '安邦保险集团股份有限公司', '中国银河投资管理有限公司', '2000000', '易方达基金管理有限公司', '1200000', '江苏苏豪投资管理有限公司', '海通证券股份有限公司', '5300000', '鹏华基金管理有限公司', '3000000', '上海东方证券资产管理有限公司', '深圳市平安创新资本投资有限公司', '广州重成机器物资贸易有限公司', '12'}",165958,3,"{'1200000', '4500000', '2000000'}",9,"{'安邦保险集团股份有限公司', '12', '中国银河投资管理有限公司', '易方达基金管理有限公司', '江苏苏豪投资管理有限公司', '上海东方证券资产管理有限公司', '鹏华基金管理有限公司', '广州重成机器物资贸易有限公司', '深圳市平安创新资本投资有限公司'}",14,"{'华基丰收(天津)投资合伙企业(有限合伙)', '5000000', '安邦保险集团股份有限公司', '中国银河投资管理有限公司', '易方达基金管理有限公司', '江苏苏豪投资管理有限公司', '海通证券股份有限公司', '5300000', '鹏华基金管理有限公司', '3000000', '上海东方证券资产管理有限公司', '深圳市平安创新资本投资有限公司', '广州重成机器物资贸易有限公司', '12'}"
19,"{'150000000', '风天成资产管理有限公司', '现金', '66666700', '荣睿立人投资管理合伙企业(有限合伙)', '400000000', '杭州乐远股权投资合伙企业(有限合伙)', '宁波卓木众石投资合伙企业(有限合伙)', '立众和瑞投资管理合伙企业(有限合伙)', '竞价', '300000000', '50000000', '喀什双子股权投资有限公司', '25000000', '上海华富利得资产管理有限公司', '北京亦合高科技产业投资合伙企业(有限合伙)', '五洲协和投资有限公司', '36', '红塔资产管理有限公司'}",1766185,7,"{'150000000', '66666700', '400000000', '竞价', '300000000', '50000000', '25000000'}",7,"{'风天成资产管理有限公司', '现金', '上海华富利得资产管理有限公司', '喀什双子股权投资有限公司', '五洲协和投资有限公司', '36', '红塔资产管理有限公司'}",12,"{'风天成资产管理有限公司', '现金', '荣睿立人投资管理合伙企业(有限合伙)', '杭州乐远股权投资合伙企业(有限合伙)', '宁波卓木众石投资合伙企业(有限合伙)', '立众和瑞投资管理合伙企业(有限合伙)', '北京亦合高科技产业投资合伙企业(有限合伙)', '上海华富利得资产管理有限公司', '喀什双子股权投资有限公司', '五洲协和投资有限公司', '36', '红塔资产管理有限公司'}"
4,"{'竞价', '现金', '36', '河北凌云工业集团有限公司'}",1249630,1,{'竞价'},3,"{'现金', '36', '河北凌云工业集团有限公司'}",3,"{'现金', '36', '河北凌云工业集团有限公司'}"
29,"{'1200000000', '600000000', '东富新投', '中航基金', '9342883', '贵阳工投', '37371535', '18685767', '现金', '湖南国发基金', '定价', '31142946', '140143257', '300000000', '15571473', '中国航发', '7162877', '4500000000', '陕西航空产业集团', '370000000', '230000000', '1000000000', '11522890', '诺安基金', '沈阳恒信', '贵州产投', '500000000', '中车金证', '36'}",15359467,8,"{'230000000', '600000000', '4500000000', '1200000000', '1000000000', '370000000', '300000000', '500000000'}",13,"{'现金', '湖南国发基金', '东富新投', '定价', '中航基金', '陕西航空产业集团', '诺安基金', '沈阳恒信', '贵州产投', '中车金证', '中国航发', '36', '贵阳工投'}",21,"{'东富新投', '中航基金', '9342883', '贵阳工投', '37371535', '18685767', '现金', '湖南国发基金', '定价', '31142946', '140143257', '15571473', '中国航发', '7162877', '陕西航空产业集团', '诺安基金', '11522890', '沈阳恒信', '贵州产投', '中车金证', '36'}"
21,"{'214281153', '35000000', '安徽国贸集团控股有限公司', '45000000', '纳爱斯浙江投资有限公司', '40000000', '定价', '佛山市美的投资管理有限公司', '43000000', '57000000', '10000000', '36', '中天证券有限责任公司', '浙江江南涤化有限公司', '15000000', '江苏瑞华投资发展有限公司', '深圳市海丰源投资股份有限公司', '广西君合投资有限公司', '华锦集团', '12', '江苏开元国际集团轻工业品进出口股份有限公司'}",816550,0,set(),5,"{'12', '定价', '深圳市海丰源投资股份有限公司', '华锦集团', '36'}",21,"{'214281153', '35000000', '安徽国贸集团控股有限公司', '45000000', '纳爱斯浙江投资有限公司', '40000000', '定价', '佛山市美的投资管理有限公司', '43000000', '57000000', '10000000', '36', '中天证券有限责任公司', '浙江江南涤化有限公司', '15000000', '江苏瑞华投资发展有限公司', '深圳市海丰源投资股份有限公司', '广西君合投资有限公司', '华锦集团', '12', '江苏开元国际集团轻工业品进出口股份有限公司'}"
13,"{'122310000', '中兵投资管理有限责任公司', '现金', '兵工财务有限责任公司', '定价', '18000000', '244620000', '汇添富-光电制导1号资产管理计划', '汇添富-光电制导2号资产管理计划', '9000000', '611550000', '36', '45000000'}",1861629,1,{'45000000'},5,"{'中兵投资管理有限责任公司', '现金', '兵工财务有限责任公司', '定价', '36'}",12,"{'122310000', '中兵投资管理有限责任公司', '现金', '兵工财务有限责任公司', '18000000', '汇添富-光电制导1号资产管理计划', '244620000', '汇添富-光电制导2号资产管理计划', '定价', '9000000', '611550000', '36'}"
3,"{'现金', '36', '柳州产投'}",939521,0,set(),3,"{'现金', '36', '柳州产投'}",3,"{'现金', '36', '柳州产投'}"
21,"{'3800000', '51490000', '厦门国贸投资有限公司', '申万菱信(上海)资产管理有限公司', '88346000', '6520000', '现金', '财通基金管理有限公司', '竞价', '36462196.35', '48509000', '汇添富基金管理股份有限公司', '3580000', '178182500', '7700000', '兴证证券资产管理有限公司', '104335000', '2690937', '浙江浙旅投资有限责任公司', '13150000', '12'}",1664167,9,"{'51490000', '104335000', '178182500', '2690937', '88346000', '竞价', '36462196.35', '48509000', '7700000'}",2,"{'现金', '12'}",12,"{'3800000', '现金', '厦门国贸投资有限公司', '兴证证券资产管理有限公司', '3580000', '申万菱信(上海)资产管理有限公司', '财通基金管理有限公司', '浙江浙旅投资有限责任公司', '13150000', '6520000', '汇添富基金管理股份有限公司', '12'}"
15,"{'9700000', '盟科投资控股有限公司', '现金', '5000000', '天津凯石益利股权投资基金合伙企业(有限合伙)', '浙江天堂硅谷盈通创业投资有限公司', '1780500', '4400000', '浙江商裕控股集团投资有限公司', '鞍山钢铁集团公司', '22000000', '竞价', '富国基金管理有限公司', '4900000', '12'}",1497628,2,"{'鞍山钢铁集团公司', '1780500'}",7,"{'盟科投资控股有限公司', '现金', '浙江天堂硅谷盈通创业投资有限公司', '浙江商裕控股集团投资有限公司', '竞价', '富国基金管理有限公司', '12'}",13,"{'9700000', '盟科投资控股有限公司', '现金', '5000000', '天津凯石益利股权投资基金合伙企业(有限合伙)', '浙江天堂硅谷盈通创业投资有限公司', '4400000', '浙江商裕控股集团投资有限公司', '22000000', '竞价', '富国基金管理有限公司', '4900000', '12'}"
13,"{'上海贝御', '现金', '西藏瑞华', '天津通万', '定价', '263591433', '深圳兴航', '527182866', '中加基金管理的中加邮储1号', '中信建投定增11号', '海航资本', '广州城投投资', '36'}",1861296,0,set(),9,"{'上海贝御', '西藏瑞华', '现金', '天津通万', '定价', '深圳兴航', '海航资本', '广州城投投资', '36'}",13,"{'上海贝御', '现金', '西藏瑞华', '天津通万', '定价', '263591433', '深圳兴航', '527182866', '中加基金管理的中加邮储1号', '中信建投定增11号', '海航资本', '广州城投投资', '36'}"
4,"{'252982456', '现金', '36', '东旭集团'}",1571275,1,{'252982456'},3,"{'现金', '36', '东旭集团'}",3,"{'现金', '36', '东旭集团'}"
4,"{'鑫茂集团', '竞价', '现金', '36'}",580474,0,set(),4,"{'鑫茂集团', '竞价', '现金', '36'}",4,"{'鑫茂集团', '竞价', '现金', '36'}"
9,"{'现金', '喜临门2015年度第一期员工持股计划', '100000000', '定价', '59989287', '7141582', '华易投资', '840000000', '36'}",4929162,1,{'840000000'},5,"{'现金', '喜临门2015年度第一期员工持股计划', '定价', '华易投资', '36'}",8,"{'现金', '喜临门2015年度第一期员工持股计划', '100000000', '定价', '59989287', '7141582', '华易投资', '36'}"
11,"{'现金', '591619933', '股权、现金', '华君电力', '111111111', '保华兴资产', '38009696', '定价', '瑞尔德', '股权', '36'}",2045205,4,"{'38009696', '111111111', '591619933', '股权、现金'}",7,"{'现金', '华君电力', '保华兴资产', '定价', '瑞尔德', '股权', '36'}",7,"{'现金', '华君电力', '保华兴资产', '定价', '瑞尔德', '股权', '36'}"
8,"{'现金', '兰坤', '3000000', '深圳市方德智联投资管理有限公司—方德-香山3号证券投资基金', '8970000', '10000000', '36', '王寿纯'}",1881241,2,"{'深圳市方德智联投资管理有限公司—方德-香山3号证券投资基金', '8970000'}",4,"{'现金', '兰坤', '36', '王寿纯'}",6,"{'现金', '兰坤', '3000000', '10000000', '36', '王寿纯'}"
4,"{'36', '竞价', '现金', '矿冶总院'}",579378,0,set(),4,"{'矿冶总院', '竞价', '现金', '36'}",4,"{'36', '竞价', '现金', '矿冶总院'}"
21,"{'3800000', '季峰', '北京市融成源投资有限公司', '现金', '工银瑞信基金管理有限公司', '197200000', '67048000', '上海鼎基投资有限公司', '10000000', '149872000', '36', '15000000', '昝圣达', '3400000', '华夏基金管理有限公司', '观唐投资控股有限公司', '74936000', '295800000', '7600000', '12', '天津证大金兔股权投资基金合伙企业(有限合伙)'}",1506431,8,"{'3800000', '197200000', '74936000', '295800000', '3400000', '7600000', '67048000', '149872000'}",10,"{'36', '现金', '工银瑞信基金管理有限公司', '华夏基金管理有限公司', '季峰', '观唐投资控股有限公司', '昝圣达', '北京市融成源投资有限公司', '上海鼎基投资有限公司', '12'}",13,"{'36', '现金', '工银瑞信基金管理有限公司', '华夏基金管理有限公司', '季峰', '观唐投资控股有限公司', '15000000', '昝圣达', '北京市融成源投资有限公司', '上海鼎基投资有限公司', '10000000', '12', '天津证大金兔股权投资基金合伙企业(有限合伙)'}"
18,"{'南京瑞森投资管理合伙企业(有限合伙)', '现金', '华安基金管理有限公司', '神州学人集团股份有限公司', '5326594', '4665629', '4666945', '王震宇', '杭州必达金融服务外包有限公司', '5132192', '黄白华', '7947667', '1110896', '9331259', '张怀斌', '12', '5053654', '福建省鞋帽进出口集团公司'}",760794,0,set(),9,"{'现金', '华安基金管理有限公司', '神州学人集团股份有限公司', '王震宇', '杭州必达金融服务外包有限公司', '黄白华', '张怀斌', '12', '福建省鞋帽进出口集团公司'}",18,"{'南京瑞森投资管理合伙企业(有限合伙)', '现金', '华安基金管理有限公司', '神州学人集团股份有限公司', '5326594', '4665629', '4666945', '王震宇', '杭州必达金融服务外包有限公司', '5132192', '黄白华', '7947667', '1110896', '9331259', '张怀斌', '12', '5053654', '福建省鞋帽进出口集团公司'}"
8,"{'5931198', '现金', '湖南红翔投资合伙企业(有限合伙)', '100000000', '朱明楚', '69000000', '4092526', '36'}",319870,4,"{'5931198', '4092526', '100000000', '69000000'}",3,"{'朱明楚', '现金', '36'}",4,"{'朱明楚', '现金', '36', '湖南红翔投资合伙企业(有限合伙)'}"
27,"{'29999996.76', '中意资产管理有限责任公司', '109999998.4', '6000000', '2909796', '国机资本控股有限公司', '5334626', '现金', '深圳市益田集团股份有限公司', '张家界市经济发展投资集团有限公司', '财通基金管理有限公司', '竞价', '39999995.68', '19398642', '诺德基金管理有限公司', '36', '11930164', '北信瑞丰基金管理有限公司', '54999994.06', '199999999', '3879728', '金东资本投资有限公司', '中原股权投资管理有限公司', '10669253', '122999990.8', '12', '61860000'}",16372503,1,{'竞价'},12,"{'国机资本控股有限公司', '现金', '北信瑞丰基金管理有限公司', '中意资产管理有限责任公司', '深圳市益田集团股份有限公司', '12', '金东资本投资有限公司', '张家界市经济发展投资集团有限公司', '财通基金管理有限公司', '中原股权投资管理有限公司', '诺德基金管理有限公司', '36'}",26,"{'29999996.76', '中意资产管理有限责任公司', '109999998.4', '6000000', '2909796', '国机资本控股有限公司', '5334626', '现金', '深圳市益田集团股份有限公司', '张家界市经济发展投资集团有限公司', '财通基金管理有限公司', '39999995.68', '19398642', '诺德基金管理有限公司', '36', '11930164', '北信瑞丰基金管理有限公司', '54999994.06', '199999999', '3879728', '金东资本投资有限公司', '中原股权投资管理有限公司', '10669253', '122999990.8', '12', '61860000'}"
4,"{'北京城建集团有限责任公司', '现金', '竞价', '36'}",1502649,1,{'竞价'},3,"{'北京城建集团有限责任公司', '现金', '36'}",3,"{'北京城建集团有限责任公司', '现金', '36'}"
13,"{'9424984', '4424778', '昂展置业', '62416313', '天利2号', '隆兴茂达', '9482218', '陈峰', '5654990', '腾兴旺达', '中兴通讯', '36', '147281921'}",2371164,0,set(),6,"{'昂展置业', '隆兴茂达', '陈峰', '腾兴旺达', '中兴通讯', '36'}",13,"{'9424984', '4424778', '昂展置业', '62416313', '天利2号', '隆兴茂达', '9482218', '陈峰', '5654990', '腾兴旺达', '中兴通讯', '36', '147281921'}"
9,"{'3090000', '现金', '12', '谭颂斌', '600000', '8124000', '林登灿', '41838600', '36'}",320926,3,"{'8124000', '41838600', '36'}",4,"{'现金', '林登灿', '谭颂斌', '12'}",6,"{'3090000', '现金', '谭颂斌', '600000', '林登灿', '12'}"
9,"{'现金', '赵小强', '新余乐活投资管理中心(普通合伙)', '新余天游投资管理中心(普通合伙)', '1000000000', '78249600', '竞价', '85500000', '36'}",9879900,2,"{'78249600', '85500000'}",4,"{'竞价', '现金', '36', '赵小强'}",7,"{'现金', '赵小强', '新余乐活投资管理中心(普通合伙)', '1000000000', '竞价', '新余天游投资管理中心(普通合伙)', '36'}"
30,"{'江苏彩浩投资有限公司', '16000000', '659785800', '229020000', '124711800', '6500000', '140639100', '现金', '216632100', '达孜县恒隆股权投资合伙企业(有限合伙', '11980000', '20790000', '南通琦艺投资有限公司', '759930000', '达孜县恒盛股权投资合伙企业(有限合伙)', '南通泓翔股权投资合伙企业(有限合伙)', '13510000', '67665000', '216423900', '商赢控股有限公司', '旭森国际控股(集团)有限公司', '20810000', '青岛盈和投资合伙企业(有限合伙)', '63380000', '江苏隆明投资有限公司', '22000000', '166560000', '73000000', '旭源投资有限公司', '36'}",1569307,18,"{'20790000', '759930000', '16000000', '659785800', '20810000', '216632100', '13510000', '63380000', '229020000', '11980000', '124711800', '22000000', '166560000', '6500000', '73000000', '140639100', '67665000', '216423900'}",7,"{'江苏彩浩投资有限公司', '现金', '南通琦艺投资有限公司', '商赢控股有限公司', '江苏隆明投资有限公司', '旭源投资有限公司', '36'}",12,"{'江苏彩浩投资有限公司', '现金', '南通琦艺投资有限公司', '达孜县恒盛股权投资合伙企业(有限合伙)', '旭森国际控股(集团)有限公司', '商赢控股有限公司', '南通泓翔股权投资合伙企业(有限合伙)', '青岛盈和投资合伙企业(有限合伙)', '达孜县恒隆股权投资合伙企业(有限合伙', '江苏隆明投资有限公司', '旭源投资有限公司', '36'}"
12,"{'天津联亿乾坤贸易有限公司', '现金', '1000000', '大连乾阳科技有限公司', '51230000', '115267500', '北京中京伟业投资管理有限责任公司', '竞价', '北京隆达创展科贸有限公司', '荣继华', '2250000', '12'}",1886245,1,{'竞价'},3,"{'荣继华', '现金', '12'}",11,"{'天津联亿乾坤贸易有限公司', '现金', '1000000', '大连乾阳科技有限公司', '51230000', '115267500', '北京中京伟业投资管理有限责任公司', '北京隆达创展科贸有限公司', '荣继华', '2250000', '12'}"
11,"{'现金', '李永明', '方东红', '400000', '竞价', '333062', '800000', '蒋灿明', '蓝思远', '913690', '36'}",1176366,5,"{'竞价', '333062', '800000', '400000', '913690'}",6,"{'现金', '李永明', '方东红', '蒋灿明', '蓝思远', '36'}",6,"{'现金', '李永明', '方东红', '蒋灿明', '蓝思远', '36'}"
28,"{'3850000000', '盈协丰投资发展', '105189340', '42075736', '98737727', '32678821', '现金', '36000000', '400000000', '704000000', '达孜映邦', '竞价', '300000000', '达孜鹏欣资源', '光启空间技术', '233000000', '顺宇居投资发展', '36', '45021037', '岩嵩投资', '321000000', '5049088', '天汇强阳', '750000000', '56100981', '539971949', '巨力华兴投资发展', '新余超研投资'}",15700026,8,"{'3850000000', '36000000', '400000000', '704000000', '竞价', '750000000', '321000000', '233000000'}",11,"{'顺宇居投资发展', '现金', '盈协丰投资发展', '达孜映邦', '新余超研投资', '达孜鹏欣资源', '天汇强阳', '光启空间技术', '岩嵩投资', '巨力华兴投资发展', '36'}",20,"{'顺宇居投资发展', '现金', '岩嵩投资', '盈协丰投资发展', '45021037', '105189340', '42075736', '达孜映邦', '98737727', '新余超研投资', '32678821', '5049088', '300000000', '达孜鹏欣资源', '天汇强阳', '光启空间技术', '56100981', '539971949', '巨力华兴投资发展', '36'}"
5,"{'现金', '上海环指投资中心', '1000000000', '竞价', '36'}",382002,0,set(),4,"{'上海环指投资中心', '竞价', '现金', '36'}",5,"{'现金', '上海环指投资中心', '1000000000', '竞价', '36'}"
19,"{'华夏资本管理有限公司', '华安基金管理有限公司', '24399989.64', '28932143.76', '812425', '财通基金管理有限公司', '上海证大投资管理有限公司', '19399986', '931899', '20399991.75', '23399983.89', '上海尚雅投资管理有限公司', '西藏瑞华投资发展有限公司', '772600', '77399993.07', '971724', '12', '1152216', '3082437'}",303745,6,"{'812425', '931899', '3082437', '772600', '971724', '1152216'}",7,"{'华夏资本管理有限公司', '华安基金管理有限公司', '上海证大投资管理有限公司', '财通基金管理有限公司', '上海尚雅投资管理有限公司', '西藏瑞华投资发展有限公司', '12'}",13,"{'华夏资本管理有限公司', '华安基金管理有限公司', '24399989.64', '28932143.76', '财通基金管理有限公司', '上海证大投资管理有限公司', '19399986', '20399991.75', '23399983.89', '上海尚雅投资管理有限公司', '西藏瑞华投资发展有限公司', '77399993.07', '12'}"
18,"{'800000000', '汇添富-优势医药企业定增计划1号、2号资产管理计划', '现金', '35650624', '兴全定增45号特定多客户资产管理计划', '王学海', '66844920', '1336898', '20000000', '定价', '891265', '1500000000', '8912656', '当代科技', '200000000', '30000000', '36', '李杰'}",374697,12,"{'800000000', '20000000', '汇添富-优势医药企业定增计划1号、2号资产管理计划', '35650624', '兴全定增45号特定多客户资产管理计划', '1336898', '1500000000', '8912656', '66844920', '200000000', '30000000', '891265'}",6,"{'现金', '王学海', '定价', '李杰', '当代科技', '36'}",6,"{'现金', '王学海', '定价', '李杰', '当代科技', '36'}"
3,"{'现金', '仪电集团', '36'}",415415,0,set(),3,"{'36', '仪电集团', '现金'}",3,"{'现金', '仪电集团', '36'}"
13,"{'国之杰', '现金', '岚桥港务', '70000000', '60', '90000000', '瀚博汇鑫', '60000000', '50000000', '湘财证券', '公信实业', '80000000', '36'}",1803054,4,"{'70000000', '80000000', '50000000', '60000000'}",8,"{'国之杰', '现金', '岚桥港务', '60', '瀚博汇鑫', '湘财证券', '公信实业', '36'}",9,"{'国之杰', '现金', '岚桥港务', '60', '90000000', '瀚博汇鑫', '湘财证券', '公信实业', '36'}"
4,"{'36', '竞价', '现金', '中船重工集团'}",504865,0,set(),4,"{'36', '竞价', '现金', '中船重工集团'}",4,"{'36', '竞价', '现金', '中船重工集团'}"
26,"{'41120000', '恒越投资', '谷欣投资', '512040000', '68000000', '国泰铭源', '301200000', '朝阳投资', '浩然明达', '川宏燃料', '现金', '40000000', '浩泽嘉业', '竞价', '594870000', '549690000', '79000000', '京马投资', '137946879', '1038739999', '逸合投资', '309633600', '132880000', '1000586400', '73000000', '36'}",93464,2,"{'1038739999', '竞价'}",11,"{'恒越投资', '川宏燃料', '现金', '谷欣投资', '浩泽嘉业', '国泰铭源', '逸合投资', '朝阳投资', '浩然明达', '京马投资', '36'}",24,"{'41120000', '恒越投资', '谷欣投资', '512040000', '68000000', '国泰铭源', '301200000', '朝阳投资', '浩然明达', '川宏燃料', '现金', '40000000', '浩泽嘉业', '594870000', '549690000', '79000000', '京马投资', '137946879', '逸合投资', '309633600', '132880000', '1000586400', '73000000', '36'}"
25,"{'12000000', '855530000', '33369880', '16000000', '陈建成', '杭州百赛', '301330000', '卧龙控股', '144489900', '6000000', '54180000', '现金', '18060000', '陈永苗', '王建乔', '27685492', '94743078', '温州隆涵', '安徽铁路', '光大保德信', '2000000', '250000000', '安徽投资', '108360000', '36'}",281409,7,"{'855530000', '54180000', '301330000', '250000000', '144489900', '18060000', '108360000'}",11,"{'王建乔', '现金', '陈建成', '杭州百赛', '温州隆涵', '安徽铁路', '光大保德信', '卧龙控股', '安徽投资', '陈永苗', '36'}",18,"{'94743078', '王建乔', '33369880', '现金', '27685492', '16000000', '陈建成', '12000000', '杭州百赛', '温州隆涵', '安徽铁路', '光大保德信', '2000000', '卧龙控股', '安徽投资', '6000000', '陈永苗', '36'}"
4,"{'第一期员工持股计划', '现金', '定价', '36'}",5860010,0,set(),4,"{'第一期员工持股计划', '36', '定价', '现金'}",4,"{'第一期员工持股计划', '定价', '现金', '36'}"
6,"{'现金', '2158240000', '329000000', '竞价', '国投电力', '36'}",1881646,0,set(),4,"{'竞价', '现金', '国投电力', '36'}",6,"{'现金', '2158240000', '329000000', '竞价', '国投电力', '36'}"
14,"{'12000000', '杭州蓝海投资有限公司', '现金', '天津富禾矿业投资中心', '5000000', '盱眙金泰产业服务有限公司', '江苏中韩国际经贸有限公司', '定价', '15000000', '26000000', '联达东方商业投资有限公司', '10000000', '36', '盱眙银信投资服务有限公司'}",887885,0,set(),9,"{'杭州蓝海投资有限公司', '现金', '天津富禾矿业投资中心', '盱眙金泰产业服务有限公司', '江苏中韩国际经贸有限公司', '定价', '联达东方商业投资有限公司', '36', '盱眙银信投资服务有限公司'}",14,"{'12000000', '杭州蓝海投资有限公司', '现金', '天津富禾矿业投资中心', '5000000', '盱眙金泰产业服务有限公司', '江苏中韩国际经贸有限公司', '定价', '15000000', '26000000', '联达东方商业投资有限公司', '10000000', '36', '盱眙银信投资服务有限公司'}"
6,"{'现金', '定价', '员工持股计划', '307889600', '15189420', '36'}",1662288,2,"{'307889600', '15189420'}",4,"{'36', '定价', '现金', '员工持股计划'}",4,"{'定价', '现金', '36', '员工持股计划'}"
20,"{'中车金证投资有限公司', '406999988.2', '28661971', '长城基金管理有限公司', '522000037.2', '易方达基金管理有限公司', '竞价', '21197183', '青岛城投金融控股集团有限公司', '易方达资产管理有限公司', '38732394', '21126760', '299999992', '安信基金管理有限责任公司', '300999998.6', '华融证券股份有限公司', '549999994.8', '12', '前海开源基金管理有限公司', '36760566'}",14669809,1,{'竞价'},1,{'12'},19,"{'中车金证投资有限公司', '406999988.2', '28661971', '长城基金管理有限公司', '522000037.2', '易方达基金管理有限公司', '21197183', '青岛城投金融控股集团有限公司', '易方达资产管理有限公司', '38732394', '21126760', '299999992', '安信基金管理有限责任公司', '300999998.6', '华融证券股份有限公司', '549999994.8', '12', '前海开源基金管理有限公司', '36760566'}"
4,"{'刘道明', '现金', '竞价', '36'}",15033311,0,set(),4,"{'刘道明', '现金', '竞价', '36'}",4,"{'刘道明', '现金', '竞价', '36'}"
4,"{'1944000000', '泛海建设控股有限公司', '36', '400000000'}",949418,2,"{'1944000000', '400000000'}",2,"{'泛海建设控股有限公司', '36'}",2,"{'泛海建设控股有限公司', '36'}"
9,"{'孙建科', '李占明', '现金', '7022933', '5016373', '定价', '46150546', '杨媛', '36'}",1692033,0,set(),6,"{'孙建科', '李占明', '现金', '定价', '杨媛', '36'}",9,"{'孙建科', '李占明', '现金', '7022933', '5016373', '定价', '46150546', '杨媛', '36'}"
32,"{'500000006.3', '22293333', '299999992.5', '146900013.8', '88888889', '现金', '江苏省张家港经济开发区实业总公司', '22284444', '12', '北京首沣投资管理有限公司', '竞价', '22222222', '36', '26666666', '北京合创开元投资有限公司', '250799996.3', '44444445', '351999990', '22240000', '13057779', '沈沧琼', '上海石基投资有限公司', '1000000001', '250200000', '中国人保资产管理股份有限公司', '中信建投证券有限责任公司', '厦门恒兴集团有限公司', '李贞淑', '31288888', '250699995', '249999997.5', '彩虹集团公司'}",420864,3,"{'500000006.3', '146900013.8', '250799996.3'}",14,"{'36', '江苏省张家港经济开发区实业总公司', '现金', '彩虹集团公司', '上海石基投资有限公司', '中信建投证券有限责任公司', '12', '中国人保资产管理股份有限公司', '北京首沣投资管理有限公司', '厦门恒兴集团有限公司', '李贞淑', '竞价', '北京合创开元投资有限公司', '沈沧琼'}",29,"{'22293333', '299999992.5', '88888889', '江苏省张家港经济开发区实业总公司', '22284444', '现金', '12', '北京首沣投资管理有限公司', '竞价', '22222222', '36', '26666666', '北京合创开元投资有限公司', '44444445', '351999990', '13057779', '22240000', '沈沧琼', '上海石基投资有限公司', '1000000001', '250200000', '中国人保资产管理股份有限公司', '中信建投证券有限责任公司', '厦门恒兴集团有限公司', '李贞淑', '31288888', '250699995', '249999997.5', '彩虹集团公司'}"
15,"{'张维亮', '金媛', '张家港保税区金港资产经营有限公', '施建刚', '12', '定价', '6900000', '范方锐', '张家港市金茂科技投资管理有限公司', '2259959', '2800000', '3000000', '36', '2300000', '颜惠敏'}",145992,0,set(),10,"{'36', '张维亮', '金媛', '张家港保税区金港资产经营有限公', '施建刚', '定价', '范方锐', '张家港市金茂科技投资管理有限公司', '12', '颜惠敏'}",15,"{'张维亮', '金媛', '张家港保税区金港资产经营有限公', '施建刚', '12', '6900000', '定价', '范方锐', '张家港市金茂科技投资管理有限公司', '2259959', '2800000', '3000000', '36', '2300000', '颜惠敏'}"
13,"{'34999991.73', '4072134', '2036067', '现金', '上海中兵国泰君安投资中心(有限合伙)', '9770566', '国寿安保基金管理有限公司', '69999983.46', '上海君政投资中心(有限合伙)', '167956029.5', '竞价', '江西大道国鼎实业发展有限公司', '12'}",16853526,1,{'竞价'},4,"{'国寿安保基金管理有限公司', '现金', '12', '江西大道国鼎实业发展有限公司'}",12,"{'34999991.73', '4072134', '2036067', '现金', '上海中兵国泰君安投资中心(有限合伙)', '9770566', '国寿安保基金管理有限公司', '69999983.46', '上海君政投资中心(有限合伙)', '167956029.5', '江西大道国鼎实业发展有限公司', '12'}"
7,"{'5000000', '现金', '定价', '中铁信托有限责任公司', '深圳市华建盈富投资企业(有限合伙)', '国泰君安金融控股有限公司', '36'}",968095,1,{'5000000'},5,"{'现金', '定价', '中铁信托有限责任公司', '国泰君安金融控股有限公司', '36'}",6,"{'现金', '定价', '中铁信托有限责任公司', '深圳市华建盈富投资企业(有限合伙)', '国泰君安金融控股有限公司', '36'}"
23,"{'94999979.1', '3809514', '3914977', '7611334', '南方基金管理有限公司', '187999949.8', '94094995.8', '财通基金管理有限公司', '52591487', '竞价', '3846153', '宝盈基金管理有限公司', '西藏中昇信投资管理有限公司', '2129210', '平安大华基金管理有限公司', '信诚基金管理有限公司', '96699931.9', '319998948.1', '94119992.2', '3810526', '第一创业证券股份有限公司', '12955423', '12'}",12024534,0,set(),9,"{'平安大华基金管理有限公司', '第一创业证券股份有限公司', '信诚基金管理有限公司', '财通基金管理有限公司', '竞价', '南方基金管理有限公司', '宝盈基金管理有限公司', '12', '西藏中昇信投资管理有限公司'}",23,"{'94999979.1', '3809514', '3914977', '7611334', '南方基金管理有限公司', '187999949.8', '94094995.8', '财通基金管理有限公司', '52591487', '竞价', '3846153', '宝盈基金管理有限公司', '2129210', '西藏中昇信投资管理有限公司', '平安大华基金管理有限公司', '信诚基金管理有限公司', '96699931.9', '319998948.1', '94119992.2', '3810526', '第一创业证券股份有限公司', '12955423', '12'}"
13,"{'孔鑫明', '现金', '北京鑫达唯特投资管理中心(有限合伙)', '浙江硅谷天堂产业投资管理有限公司', '定价', '深圳市创东方长盈投资企业(有限合伙)', '上海晨灿投资中心(有限合伙)', '鹏华基金管理有限公司', '2820000', '杭州君达投资管理有限公司', '泰达宏利基金管理有限公司', '5640000', '36'}",1672508,1,{'5640000'},8,"{'孔鑫明', '现金', '浙江硅谷天堂产业投资管理有限公司', '定价', '鹏华基金管理有限公司', '杭州君达投资管理有限公司', '泰达宏利基金管理有限公司', '36'}",12,"{'孔鑫明', '现金', '北京鑫达唯特投资管理中心(有限合伙)', '浙江硅谷天堂产业投资管理有限公司', '定价', '深圳市创东方长盈投资企业(有限合伙)', '上海晨灿投资中心(有限合伙)', '鹏华基金管理有限公司', '2820000', '杭州君达投资管理有限公司', '泰达宏利基金管理有限公司', '36'}"
10,"{'现金', '3935701', '林建伟', '林峻', '陶晓海', '定价', '49933909', '93039972', '1180437608', '36'}",12020062,0,set(),6,"{'现金', '林建伟', '林峻', '陶晓海', '定价', '36'}",10,"{'现金', '3935701', '林建伟', '林峻', '陶晓海', '定价', '49933909', '93039972', '1180437608', '36'}"
13,"{'122100195', '1000000597', '12', '定价', '122100122', '732600733', '张远捷', '中国保利集团公司', '999999999.2', '东吴证券股份有限公司', '泰康资产管理有限责任公司', '6000000003', '36'}",4990031,1,{'999999999.2'},7,"{'36', '定价', '张远捷', '中国保利集团公司', '东吴证券股份有限公司', '泰康资产管理有限责任公司', '12'}",12,"{'122100195', '1000000597', '12', '定价', '122100122', '732600733', '张远捷', '中国保利集团公司', '东吴证券股份有限公司', '泰康资产管理有限责任公司', '6000000003', '36'}"
9,"{'1155110400', '现金', '定价', '17760000', '福建建工', '泰禾金控', '288777600', '71040000', '36'}",15472835,4,"{'288777600', '1155110400', '71040000', '17760000'}",5,"{'现金', '定价', '福建建工', '泰禾金控', '36'}",5,"{'现金', '定价', '福建建工', '泰禾金控', '36'}"
23,"{'274999996.8', '82000036.8', '华泰资产管理有限公司', '7083333', '100999987.2', '7013888', '泰达宏利基金管理有限公司', '现金', '中融基金管理有限公司', '定价', '6944444', '财通基金管理有限公司', '5694447', '101999995.2', '19097222', '博时基金管理有限公司', '国泰基金管理有限公司', '长信基金管理有限责任公司', '招商财富资产管理有限公司', '139999996.8', '99999993.6', '9722222', '12'}",16941045,0,set(),11,"{'招商财富资产管理有限公司', '现金', '中融基金管理有限公司', '定价', '博时基金管理有限公司', '财通基金管理有限公司', '华泰资产管理有限公司', '国泰基金管理有限公司', '长信基金管理有限责任公司', '泰达宏利基金管理有限公司', '12'}",23,"{'274999996.8', '82000036.8', '华泰资产管理有限公司', '7083333', '100999987.2', '7013888', '泰达宏利基金管理有限公司', '现金', '中融基金管理有限公司', '6944444', '定价', '财通基金管理有限公司', '5694447', '101999995.2', '19097222', '博时基金管理有限公司', '国泰基金管理有限公司', '长信基金管理有限责任公司', '招商财富资产管理有限公司', '139999996.8', '99999993.6', '9722222', '12'}"
4,"{'现金', '40000000', '四川长虹', '400000000'}",1245783,2,"{'40000000', '400000000'}",2,"{'现金', '四川长虹'}",2,"{'现金', '四川长虹'}"
9,"{'乐清意诚电气有限公司', '现金', '172566313', '竞价', '上海京遥贸易有限公司', '26592800', '408465408', '12', '11234786'}",19342865,2,"{'172566313', '竞价'}",4,"{'乐清意诚电气有限公司', '现金', '上海京遥贸易有限公司', '12'}",7,"{'乐清意诚电气有限公司', '现金', '上海京遥贸易有限公司', '26592800', '408465408', '12', '11234786'}"
7,"{'南药集团', '现金', '96153846', '竞价', '107691072', 'Alliance Healthcare', '36'}",304350,2,"{'竞价', '96153846'}",4,"{'南药集团', 'Alliance Healthcare', '现金', '36'}",5,"{'南药集团', '现金', '107691072', 'Alliance Healthcare', '36'}"
8,"{'金王集团', '17441860', '现金', '180000000', '沃德创富', '40697674', '420000000', '36'}",89356,2,"{'420000000', '180000000'}",4,"{'沃德创富', '现金', '36', '金王集团'}",6,"{'金王集团', '17441860', '现金', '沃德创富', '40697674', '36'}"
21,"{'102649993.6', '武汉人和鼎钧投资管理有限公司', '104999977.9', '国联安基金管理有限公司', '申万菱信基金管理有限公司', '国投瑞银基金管理有限公司', '31200072.21', '1500214', '1466638', '2857551', '竞价', '199999994.5', '2643234', '北京和聚投资管理有限公司', '445779', '184999947.7', '福建省新兴产业股权投资有限合伙企业', '4286326', '299999956.7', '12', '海富通基金管理有限公司'}",14248490,5,"{'104999977.9', '199999994.5', '竞价', '31200072.21', '184999947.7'}",8,"{'武汉人和鼎钧投资管理有限公司', '国联安基金管理有限公司', '福建省新兴产业股权投资有限合伙企业', '申万菱信基金管理有限公司', '北京和聚投资管理有限公司', '国投瑞银基金管理有限公司', '12', '海富通基金管理有限公司'}",16,"{'1466638', '102649993.6', '武汉人和鼎钧投资管理有限公司', '国联安基金管理有限公司', '福建省新兴产业股权投资有限合伙企业', '2857551', '4286326', '申万菱信基金管理有限公司', '2643234', '北京和聚投资管理有限公司', '国投瑞银基金管理有限公司', '445779', '299999956.7', '1500214', '12', '海富通基金管理有限公司'}"
16,"{'金鹰基金管理有限公司', '202999989.5', '现金', '17391304', '宁波东方集团有限公司', '99999998', '12', '8695652', '18000000', '207000000', '金元顺安基金管理有限公司', '竞价', '199999996', '泰达宏利基金管理有限公司', '36', '17652173'}",18776213,0,set(),5,"{'现金', '宁波东方集团有限公司', '12', '竞价', '36'}",16,"{'金鹰基金管理有限公司', '202999989.5', '现金', '17391304', '宁波东方集团有限公司', '99999998', '12', '8695652', '18000000', '207000000', '金元顺安基金管理有限公司', '199999996', '竞价', '泰达宏利基金管理有限公司', '36', '17652173'}"
23,"{'华安基金管理有限公司', '12690476', '262930', '11903571', '泰达宏利基金管理有限公司', '10714285', '现金', '财通基金管理有限公司', '13422619', '鹏华基金管理有限公司', '12095238', '10716000', '五矿资本控股有限公司', '鹏华资产管理(深圳)有限公司', '36', '湘电集团有限公司', '10759325', '上银基金管理有限公司', '40476190', '平安资产管理有限公司', '天弘基金管理有限公司', '11880000', '12'}",1560219,0,set(),12,"{'现金', '华安基金管理有限公司', '12', '财通基金管理有限公司', '天弘基金管理有限公司', '湘电集团有限公司', '鹏华基金管理有限公司', '泰达宏利基金管理有限公司', '五矿资本控股有限公司', '36', '上银基金管理有限公司', '平安资产管理有限公司'}",23,"{'华安基金管理有限公司', '12690476', '262930', '11903571', '泰达宏利基金管理有限公司', '10714285', '现金', '财通基金管理有限公司', '13422619', '鹏华基金管理有限公司', '12095238', '10716000', '五矿资本控股有限公司', '鹏华资产管理(深圳)有限公司', '36', '湘电集团有限公司', '10759325', '上银基金管理有限公司', '40476190', '平安资产管理有限公司', '天弘基金管理有限公司', '11880000', '12'}"
4,"{'定价', '北京有色金属悁究旙院', '现金', '36'}",182909,0,set(),4,"{'定价', '北京有色金属悁究旙院', '现金', '36'}",4,"{'定价', '现金', '36', '北京有色金属悁究旙院'}"
11,"{'4219409', '李俊英', '中铁宇丰物资贸易有限公司', '罗明远', '63291139', '6329114', '常青藤联创', '李冰侠', '晋商联盟控股股份有限公司', '36', '42194093'}",94421,0,set(),7,"{'36', '李俊英', '中铁宇丰物资贸易有限公司', '罗明远', '李冰侠', '晋商联盟控股股份有限公司', '常青藤联创'}",11,"{'4219409', '李俊英', '中铁宇丰物资贸易有限公司', '罗明远', '63291139', '6329114', '常青藤联创', '李冰侠', '晋商联盟控股股份有限公司', '36', '42194093'}"
19,"{'1572327', '9999999.72', '现金', '179999995', '1886792', '3930817', '南京国资混改基金有限公司', '12', '定价', '张国强', '23584905', '徐民丰', '28301886', '董柳波', '南京新工投资集团有限责任公司', '149999995.8', '24999996.12', '11999997.12', '36'}",20270527,1,{'179999995'},9,"{'36', '现金', '南京国资混改基金有限公司', '张国强', '定价', '徐民丰', '董柳波', '南京新工投资集团有限责任公司', '12'}",18,"{'1572327', '9999999.72', '现金', '1886792', '3930817', '南京国资混改基金有限公司', '12', '张国强', '定价', '23584905', '徐民丰', '28301886', '董柳波', '南京新工投资集团有限责任公司', '149999995.8', '24999996.12', '11999997.12', '36'}"
16,"{'448949994.9', '15244482', '上海国际资管', '国盛投资', '华安资管', '77196290', '锦江酒店集团', '20325976', '2273430741', '定价', '长城资管', '598599993.2', '10162988', '弘毅投资基金', '36', '299299996.6'}",12000196,1,{'2273430741'},8,"{'上海国际资管', '华安资管', '国盛投资', '锦江酒店集团', '定价', '长城资管', '弘毅投资基金', '36'}",15,"{'448949994.9', '15244482', '上海国际资管', '国盛投资', '华安资管', '77196290', '锦江酒店集团', '20325976', '定价', '长城资管', '598599993.2', '10162988', '弘毅投资基金', '36', '299299996.6'}"
25,"{'宝山钢铁股份有限公司', '华泰资产管理有限公司', '海通证券股份有限公司', '申万菱信基金管理有限公司', '144999983.8', '国投瑞银基金管理有限公司', '9050068.28', '1397949', '现金', '75999989.12', '1359506', '财通基金管理有限公司', '竞价', '15258621', '59999971.08', '210859', '36', '诺安基金管理有限公司', '光大保德信基金管理有限公司', '3378378', '58349997.52', '兴证证券资产管理有限公司', '654900013.3', '1770736', '12'}",1788967,6,"{'58349997.52', '75999989.12', '宝山钢铁股份有限公司', '144999983.8', '59999971.08', '9050068.28'}",12,"{'现金', '兴证证券资产管理有限公司', '12', '诺安基金管理有限公司', '华泰资产管理有限公司', '财通基金管理有限公司', '光大保德信基金管理有限公司', '竞价', '海通证券股份有限公司', '申万菱信基金管理有限公司', '国投瑞银基金管理有限公司', '36'}",19,"{'210859', '现金', '兴证证券资产管理有限公司', '12', '1359506', '诺安基金管理有限公司', '华泰资产管理有限公司', '财通基金管理有限公司', '光大保德信基金管理有限公司', '竞价', '654900013.3', '1770736', '15258621', '申万菱信基金管理有限公司', '海通证券股份有限公司', '国投瑞银基金管理有限公司', '3378378', '36', '1397949'}"
4,"{'中化股份', '现金', '竞价', '36'}",159620,0,set(),4,"{'中化股份', '现金', '竞价', '36'}",4,"{'中化股份', '现金', '竞价', '36'}"
6,"{'现金', '34251175', '定价', '袁亚琴', '李海鹰', '36'}",4930990,1,{'34251175'},5,"{'现金', '定价', '袁亚琴', '李海鹰', '36'}",5,"{'现金', '定价', '袁亚琴', '李海鹰', '36'}"
11,"{'现金', '东吴基金管理有限公司', '230000000', '上海六禾投资有限公司', '65000000', '70000000', '兴业财富资产管理有限公司', '财通基金管理有限公司', '竞价', '500000000', '12'}",15568032,3,"{'65000000', '竞价', '230000000'}",6,"{'东吴基金管理有限公司', '现金', '上海六禾投资有限公司', '兴业财富资产管理有限公司', '财通基金管理有限公司', '12'}",8,"{'东吴基金管理有限公司', '现金', '上海六禾投资有限公司', '70000000', '兴业财富资产管理有限公司', '财通基金管理有限公司', '500000000', '12'}"
9,"{'赵方平', '现金', '陈建忠', '中基矿业', '7000000', '2000000', '21000000', '竞价', '36'}",1209385,2,"{'竞价', '2000000'}",5,"{'赵方平', '现金', '陈建忠', '中基矿业', '36'}",7,"{'赵方平', '现金', '陈建忠', '中基矿业', '7000000', '21000000', '36'}"
6,"{'现金', '定价', '大唐集团', '8333999998', '2401729106', '36'}",20199507,1,{'8333999998'},4,"{'定价', '现金', '36', '大唐集团'}",5,"{'现金', '定价', '大唐集团', '2401729106', '36'}"
5,"{'现金', '兖州市金太阳投资有限公司', '定价', '145189606', '36'}",575988,2,"{'145189606', '36'}",3,"{'现金', '定价', '兖州市金太阳投资有限公司'}",3,"{'现金', '定价', '兖州市金太阳投资有限公司'}"
21,"{'深圳市创新投资集团有限公司', '149999995.2', '399498000', '160053003', '8491310', '151409999.4', '60530000', '定价', '36', '56042646', '22727272', '黄河集团', '150016350', '24250455', '上银基金管理有限公司', '兴证证券资产管理有限公司', '22940909', '安信证券股份有限公司', '泰康资产管理有限责任公司', '22729750', '12'}",66166,0,set(),9,"{'兴证证券资产管理有限公司', '深圳市创新投资集团有限公司', '12', '黄河集团', '定价', '安信证券股份有限公司', '泰康资产管理有限责任公司', '36', '上银基金管理有限公司'}",21,"{'深圳市创新投资集团有限公司', '149999995.2', '399498000', '160053003', '8491310', '151409999.4', '60530000', '定价', '36', '56042646', '22727272', '黄河集团', '150016350', '24250455', '上银基金管理有限公司', '兴证证券资产管理有限公司', '22940909', '安信证券股份有限公司', '泰康资产管理有限责任公司', '22729750', '12'}"
7,"{'8849676', '天方集团', '1816196', '通用技术集团', '医控公司', '36', '4300448'}",1133691,0,set(),4,"{'医控公司', '通用技术集团', '36', '天方集团'}",7,"{'8849676', '天方集团', '1816196', '通用技术集团', '医控公司', '36', '4300448'}"
4,"{'定价', '21390374', '长城影视文化企业集团有限公司', '36'}",1924141,0,set(),3,"{'定价', '36', '长城影视文化企业集团有限公司'}",4,"{'定价', '21390374', '长城影视文化企业集团有限公司', '36'}"
14,"{'580000000', '东海基金—金龙16号资产管理计划', '林海峰', '800000000', '14051522', '苏州北恒创业投资合伙企业(有限合伙)', '定价', '117096019', '1000000000', '120000000', '67915691', '陈耀民', '93676815', '36'}",1572859,5,"{'580000000', '800000000', '苏州北恒创业投资合伙企业(有限合伙)', '1000000000', '120000000'}",5,"{'东海基金—金龙16号资产管理计划', '林海峰', '定价', '陈耀民', '36'}",9,"{'东海基金—金龙16号资产管理计划', '林海峰', '14051522', '117096019', '定价', '67915691', '陈耀民', '93676815', '36'}"
17,"{'190000064.8', '中华联合', '现金', '同药集团', '99999972.8', '定价', '412088', '浙江商裕', '1373626', '陈德康', '15000003.2', '2747252', '平安资产鑫享7号资产管理产品', '东丰药业', '5219782', '36', '49999986.4'}",9871167,0,set(),8,"{'中华联合', '现金', '同药集团', '定价', '浙江商裕', '陈德康', '东丰药业', '36'}",17,"{'190000064.8', '中华联合', '现金', '同药集团', '99999972.8', '定价', '412088', '浙江商裕', '1373626', '陈德康', '15000003.2', '2747252', '平安资产鑫享7号资产管理产品', '东丰药业', '5219782', '36', '49999986.4'}"
21,"{'九州增发二期”集合资产管理计划', '中信信诚·华实金融投资1号”专项资产管理计划', '512035011', '5000000000', '328227571', '现金', '新时代华资实业定增1号”集合资产管理计划', '定价', '1750547046', '16000000000', '218818381', '547045951', '2000000000', '109409190', '前海金鹰粤通36号”专项资产管理计划', '郁金香投资', '1000000000', '草原糖业', '4680000000', '3000000000', '36'}",1768375,10,"{'16000000000', '218818381', '512035011', '547045951', '1750547046', '1000000000', '2000000000', '109409190', '4680000000', '328227571'}",7,"{'现金', '郁金香投资', '九州增发二期”集合资产管理计划', '定价', '5000000000', '草原糖业', '36'}",11,"{'现金', '郁金香投资', '九州增发二期”集合资产管理计划', '中信信诚·华实金融投资1号”专项资产管理计划', '定价', '新时代华资实业定增1号”集合资产管理计划', '5000000000', '草原糖业', '3000000000', '前海金鹰粤通36号”专项资产管理计划', '36'}"
5,"{'现金', '985748000', '竞价', '鸿达兴业集团', '36'}",15600240,2,"{'985748000', '竞价'}",3,"{'现金', '鸿达兴业集团', '36'}",3,"{'现金', '鸿达兴业集团', '36'}"
6,"{'现金', '350000000', '32407407', '定价', '36', '北京智度德广投资中心(有限合伙)'}",15642199,1,{'350000000'},3,"{'现金', '定价', '36'}",5,"{'现金', '32407407', '定价', '36', '北京智度德广投资中心(有限合伙)'}"
20,"{'1690000', '1560000', '现金', '尹卫泽', '单银木', '定价', '6630000', '王爱民', '刘安贵', '许荣根', '2548000', '张振勇', '7800000', '6500000', '寿林平', '2730000', '36400000', '郭立湘', '36', '陆拥军'}",1765814,0,set(),12,"{'现金', '尹卫泽', '单银木', '定价', '王爱民', '许荣根', '张振勇', '郭立湘', '寿林平', '刘安贵', '36', '陆拥军'}",20,"{'1690000', '1560000', '现金', '尹卫泽', '单银木', '定价', '6630000', '王爱民', '刘安贵', '许荣根', '2548000', '张振勇', '7800000', '6500000', '寿林平', '2730000', '36400000', '郭立湘', '36', '陆拥军'}"
15,"{'5000000', '江苏瑞华投资发展有限公司', '北京阳光嘉瑞科技开发有限公司', '4000000', '定价', '7000000', '2000000', '上海丰泽科技发展有限公司', '中国人寿资产管理有限公司', '上海卡瓦格博投资有限公司', '深圳菱丰国际投资有限公司', '1000000', '四川慧舟实业发展有限公司', '12', '嘉鑫投资有限公司'}",539570,0,set(),4,"{'江苏瑞华投资发展有限公司', '定价', '12', '中国人寿资产管理有限公司'}",15,"{'5000000', '江苏瑞华投资发展有限公司', '北京阳光嘉瑞科技开发有限公司', '4000000', '定价', '7000000', '2000000', '上海丰泽科技发展有限公司', '中国人寿资产管理有限公司', '上海卡瓦格博投资有限公司', '深圳菱丰国际投资有限公司', '1000000', '四川慧舟实业发展有限公司', '12', '嘉鑫投资有限公司'}"
20,"{'25380710', '九泰基金', '王伟', '现金', '九立投资', '20000000', '400000000', '38071065', '80000000', '张怀斌', '定价', '10152284', '常春藤', '2538071', '300000000', '张平', '常熟市铝箔厂', '200000000', '36', '50761421'}",1629331,5,"{'20000000', '400000000', '200000000', '300000000', '80000000'}",10,"{'九泰基金', '王伟', '现金', '九立投资', '定价', '常春藤', '张平', '常熟市铝箔厂', '张怀斌', '36'}",15,"{'25380710', '九泰基金', '王伟', '现金', '九立投资', '张怀斌', '38071065', '定价', '10152284', '常春藤', '张平', '常熟市铝箔厂', '2538071', '36', '50761421'}"
12,"{'1006357', '现金', '7944915', '249999992', '苏州市历史文化名城发展集团创业投资有限公司', '兴业财富资产管理有限公司', '149999995.2', '财通基金管理有限公司', '新华基金管理股份有限公司', '19000020.16', '13241525', '渤海汇金证券资产管理有限公司'}",15594029,0,set(),1,{'现金'},12,"{'1006357', '现金', '7944915', '249999992', '苏州市历史文化名城发展集团创业投资有限公司', '兴业财富资产管理有限公司', '149999995.2', '财通基金管理有限公司', '新华基金管理股份有限公司', '19000020.16', '13241525', '渤海汇金证券资产管理有限公司'}"
9,"{'现金', '399674532.1', '竞价', '122050447', '32546786', '1498779489', '36', '天津中环电子信息集团有限公司', '天津渤海信息产业结构调整股权投资基金有限公司'}",1221883,2,"{'竞价', '399674532.1'}",2,"{'现金', '36'}",7,"{'现金', '122050447', '32546786', '1498779489', '36', '天津中环电子信息集团有限公司', '天津渤海信息产业结构调整股权投资基金有限公司'}"
4,"{'现金', '竞价', '中超集团', '36'}",214989,1,{'竞价'},3,"{'现金', '中超集团', '36'}",3,"{'现金', '中超集团', '36'}"
14,"{'上海华沅投资管理合伙企业(有限合伙)', '3800000', '4800000', '现金', '18200000', '林林', '5000000', '马晓', '陈峰', '7600000', '廖俊德', '湖南华实资本创业投资中心(有限合伙)', '马孝武', '36'}",1557097,5,"{'上海华沅投资管理合伙企业(有限合伙)', '3800000', '7600000', '湖南华实资本创业投资中心(有限合伙)', '4800000'}",7,"{'现金', '林林', '马晓', '陈峰', '廖俊德', '马孝武', '36'}",9,"{'5000000', '现金', '18200000', '林林', '马晓', '陈峰', '廖俊德', '马孝武', '36'}"
7,"{'现金', '浙江天堂硅谷久融股权投资合伙企业', '杭州永银投资合伙企业', '竞价', '3000000', '37000000', '36'}",294076,2,"{'竞价', '37000000'}",5,"{'现金', '浙江天堂硅谷久融股权投资合伙企业', '杭州永银投资合伙企业', '3000000', '36'}",5,"{'现金', '浙江天堂硅谷久融股权投资合伙企业', '杭州永银投资合伙企业', '3000000', '36'}"
18,"{'中国南方电网有限责任公司', '40000000', '哈尔滨电气股份有限公司', '华夏基金管理有限公司', '55000000', '定价', '博时基金管理有限公司', '中船重工财务有限责任公司', '60000000', '东方电气股份有限公司', '50000000', '鹏华基金管理有限公司', '中国人寿资产管理有限公司', '泰康资产管理有限责任公司', '80000000', '95000000', '12', '海富通基金管理有限公司'}",183094,3,"{'55000000', '定价', '95000000'}",11,"{'中国南方电网有限责任公司', '哈尔滨电气股份有限公司', '华夏基金管理有限公司', '博时基金管理有限公司', '中船重工财务有限责任公司', '东方电气股份有限公司', '鹏华基金管理有限公司', '中国人寿资产管理有限公司', '泰康资产管理有限责任公司', '12', '海富通基金管理有限公司'}",15,"{'中国南方电网有限责任公司', '40000000', '哈尔滨电气股份有限公司', '华夏基金管理有限公司', '博时基金管理有限公司', '中船重工财务有限责任公司', '60000000', '东方电气股份有限公司', '50000000', '鹏华基金管理有限公司', '中国人寿资产管理有限公司', '泰康资产管理有限责任公司', '80000000', '12', '海富通基金管理有限公司'}"
4,"{'228102189', '前海开源基金管理有限公司', '36', '中国远洋运输(集团)总公司'}",1891460,0,set(),2,"{'前海开源基金管理有限公司', '36'}",4,"{'228102189', '前海开源基金管理有限公司', '36', '中国远洋运输(集团)总公司'}"
14,"{'国药集团', '现金', '400000000', '100000000', '浦东科投', '6839945', '财通基金通过其管理的77号计划', '27359781', '60000000', '医工总院', '950000000', '64979480', '4103967', '36'}",281506,4,"{'100000000', '950000000', '财通基金通过其管理的77号计划', '400000000'}",6,"{'现金', '国药集团', '浦东科投', '60000000', '医工总院', '36'}",10,"{'国药集团', '现金', '浦东科投', '6839945', '27359781', '60000000', '医工总院', '64979480', '4103967', '36'}"
31,"{'浙江省物产集团有限公司', '36500000', '34931506', '国联安基金管理有限公司', '25684931', '263500004.3', '5000000', '现金', '定价', '财通基金管理有限公司', '12200008.2', '浙江物产金属集团有限公司', '187499996.3', '20684932', '36', '太平洋资产管理有限责任公司', '149999998.5', '1671234', '北京世纪力宏计算机软件科技有限公司', '诺安基金管理有限公司', '153300000', '290999994.9', '李怡名', '254999993.8', '20547945', '36095891', '151000003.6', '21000000', '39863013', '华安未来资产管理(上海)有限公司', '12'}",390075,0,set(),5,"{'浙江省物产集团有限公司', '现金', '12', '浙江物产金属集团有限公司', '36'}",31,"{'浙江省物产集团有限公司', '36500000', '34931506', '国联安基金管理有限公司', '25684931', '263500004.3', '5000000', '现金', '定价', '财通基金管理有限公司', '12200008.2', '浙江物产金属集团有限公司', '187499996.3', '20684932', '36', '太平洋资产管理有限责任公司', '149999998.5', '1671234', '北京世纪力宏计算机软件科技有限公司', '诺安基金管理有限公司', '153300000', '290999994.9', '李怡名', '254999993.8', '20547945', '36095891', '151000003.6', '21000000', '39863013', '华安未来资产管理(上海)有限公司', '12'}"
20,"{'李雪', '1690000', '1920000', '现金', '白明垠', '10480000', '17690000', '1000000', '黄松', '潘峰', '2990000', '9120000', '王毅刚', '肖荣', '竞价', '王全', '13420000', '孙河生', '36', '张海汀'}",1576811,1,{'竞价'},11,"{'李雪', '现金', '白明垠', '潘峰', '黄松', '王毅刚', '肖荣', '王全', '孙河生', '36', '张海汀'}",19,"{'李雪', '1690000', '1920000', '现金', '白明垠', '10480000', '17690000', '1000000', '黄松', '潘峰', '2990000', '9120000', '王毅刚', '肖荣', '王全', '13420000', '孙河生', '36', '张海汀'}"
20,"{'20000000', '陶安祥', '现金', '6723800', '150008000', '4484000', '89240000', '66930000', '4000000', '陈松兴', '35750000', '陈魁', '李明华', '3000000', '钟葱', '797582500', '100038000', '446200000', '36', '金质信息'}",2618501,10,"{'6723800', '4484000', '150008000', '89240000', '66930000', '4000000', '35750000', '100038000', '797582500', '446200000'}",8,"{'陶安祥', '现金', '陈松兴', '陈魁', '李明华', '钟葱', '36', '金质信息'}",10,"{'20000000', '陶安祥', '现金', '陈松兴', '3000000', '陈魁', '李明华', '钟葱', '36', '金质信息'}"
4,"{'敯国华电集团公司', '竞价', '现金', '36'}",559946,0,set(),4,"{'敯国华电集团公司', '竞价', '现金', '36'}",4,"{'敯国华电集团公司', '竞价', '现金', '36'}"
6,"{'34679789', '69359578', '定价', '青海雪驰', '36', '凯迪矿业'}",675939,0,set(),4,"{'青海雪驰', '定价', '36', '凯迪矿业'}",6,"{'34679789', '69359578', '定价', '青海雪驰', '36', '凯迪矿业'}"
18,"{'金鹰基金管理有限公司', '现金', '深圳天风天成资产管理有限公司', '26241799', '定价', '国联安基金管理有限公司', '26116838', '财通基金管理有限公司', '汇安基金管理有限责任公司', '易方达基金管理有限公司', '中信证券股份有限公司', '46579194', '20525265', '浙江浙银资本管理有限公司', '华富基金管理有限公司', '36363636', '12', '26023117'}",15621146,0,set(),4,"{'定价', '现金', '12', '中信证券股份有限公司'}",18,"{'金鹰基金管理有限公司', '现金', '深圳天风天成资产管理有限公司', '26241799', '定价', '国联安基金管理有限公司', '26116838', '财通基金管理有限公司', '汇安基金管理有限责任公司', '易方达基金管理有限公司', '中信证券股份有限公司', '46579194', '20525265', '浙江浙银资本管理有限公司', '华富基金管理有限公司', '36363636', '12', '26023117'}"
4,"{'36', '定价', '现金', '山东重工集团有限公司'}",1146775,0,set(),4,"{'山东重工集团有限公司', '36', '定价', '现金'}",4,"{'山东重工集团有限公司', '定价', '现金', '36'}"
24,"{'吕旭幸', '钟婉珍', '10048520', '217454997.1', '9043668', '任军', '上海华富利得资产管理有限公司(华富资管-富鼎6号专项资产管理计划)', '10550946', '现金', '112839069.9', '曹蕾', '陈尧根', '竞价', '13063076', '207099997.2', '5474967', '269229996.4', '12899290', '265854366.9', '沈依伊', '3166761', '65266944.21', '186389997.5', '36'}",14704968,8,"{'269229996.4', '112839069.9', '217454997.1', '竞价', '3166761', '186389997.5', '13063076', '5474967'}",8,"{'吕旭幸', '现金', '曹蕾', '钟婉珍', '陈尧根', '沈依伊', '任军', '36'}",16,"{'10550946', '吕旭幸', '现金', '65266944.21', '12899290', '曹蕾', '钟婉珍', '10048520', '陈尧根', '265854366.9', '沈依伊', '9043668', '207099997.2', '任军', '36', '上海华富利得资产管理有限公司(华富资管-富鼎6号专项资产管理计划)'}"
7,"{'西南证券有限责任公司', '现金', '季芬莲', '深圳东方壹投资有限公司', '曹晴霞', '30000000', '12'}",808046,0,set(),6,"{'季芬莲', '西南证券有限责任公司', '现金', '深圳东方壹投资有限公司', '曹晴霞', '12'}",7,"{'季芬莲', '西南证券有限责任公司', '现金', '深圳东方壹投资有限公司', '曹晴霞', '30000000', '12'}"
20,"{'120997746.1', '嘉定建业投资开发公司', '上海南翔资产经营有限公司', '672219990.5', '上海安霞投资中心(有限合伙)', '398923992', '110199993.8', '25186575.73', '35302365', '2329933', '62185013', '381618565.7', '中邮创业基金管理股份有限公司', '嘉实基金管理有限公司', '北京光控安宇投资中心(有限合伙)', '卫保川', '36903237', '11193131', '36', '10194264'}",1892759,3,"{'398923992', '25186575.73', '381618565.7'}",6,"{'嘉定建业投资开发公司', '上海南翔资产经营有限公司', '嘉实基金管理有限公司', '中邮创业基金管理股份有限公司', '卫保川', '36'}",17,"{'120997746.1', '嘉定建业投资开发公司', '上海南翔资产经营有限公司', '672219990.5', '上海安霞投资中心(有限合伙)', '110199993.8', '35302365', '2329933', '62185013', '中邮创业基金管理股份有限公司', '嘉实基金管理有限公司', '北京光控安宇投资中心(有限合伙)', '卫保川', '36903237', '11193131', '36', '10194264'}"
11,"{'现金', '中南通富海投资管理中心(有限合伙)', '6909547', '6281407', '石莉', '定价', '12562814', '上海静观创业合伙企业(有限合伙)', '宁波博创金甬投资中心(有限合伙)', '北京广源利达投资发展中心(有限合伙)', '36'}",362709,4,"{'12562814', '中南通富海投资管理中心(有限合伙)', '6909547', '6281407'}",4,"{'定价', '现金', '36', '石莉'}",7,"{'现金', '石莉', '定价', '上海静观创业合伙企业(有限合伙)', '宁波博创金甬投资中心(有限合伙)', '北京广源利达投资发展中心(有限合伙)', '36'}"
15,"{'107999992.6', '现金', '北信瑞丰基金管理有限公司', '安徽省铁路发展基金股份有限公司', '8450940', '156595918.2', '5828386', '定价', '6422018', '博时基金管理有限公司', '118999993.5', '8338051', '财通基金管理有限公司', '154504085', '12'}",16407049,1,{'107999992.6'},7,"{'现金', '安徽省铁路发展基金股份有限公司', '北信瑞丰基金管理有限公司', '定价', '博时基金管理有限公司', '财通基金管理有限公司', '12'}",14,"{'156595918.2', '北信瑞丰基金管理有限公司', '安徽省铁路发展基金股份有限公司', '8450940', '现金', '5828386', '定价', '6422018', '博时基金管理有限公司', '118999993.5', '8338051', '财通基金管理有限公司', '154504085', '12'}"
4,"{'竞价', '现金', '36', '亿利集团'}",9881338,0,set(),4,"{'竞价', '现金', '36', '亿利集团'}",4,"{'竞价', '现金', '36', '亿利集团'}"
9,"{'现金', '10135013', '朗源股份有限公司', '张轩松', '112600000', '上海市糖业烟酒(集团)有限公司', '36', '790452000', '71147794'}",1105897,0,set(),4,"{'张轩松', '现金', '36', '朗源股份有限公司'}",9,"{'现金', '10135013', '朗源股份有限公司', '张轩松', '112600000', '上海市糖业烟酒(集团)有限公司', '36', '790452000', '71147794'}"
7,"{'何启强', '现金', '7766900', '竞价', '4001100', '麦正辉', '36'}",1826583,3,"{'竞价', '4001100', '7766900'}",4,"{'36', '何启强', '现金', '麦正辉'}",4,"{'何启强', '现金', '麦正辉', '36'}"
4,"{'太安堂集团', '竞价', '现金', '36'}",682728,0,set(),4,"{'太安堂集团', '竞价', '现金', '36'}",4,"{'太安堂集团', '竞价', '现金', '36'}"
22,"{'石家庄合力投资咨询中心(有限合伙)', '19047620', '3766666', '厦门时则股权投资管理合伙企业', '李华青', '254475000', '现金', '59325000', '定价', '西藏瑞华资本管理有限公司', '300000000', '4603174', '16157142', '109999968.8', '6984125', '股权', '72500000', '苏州弘德源投资管理中心(有限合伙)', '100000000', '财通基金管理的资管计划', '6349207', '36'}",15691625,1,{'109999968.8'},8,"{'现金', '财通基金管理的资管计划', '定价', '西藏瑞华资本管理有限公司', '厦门时则股权投资管理合伙企业', '李华青', '股权', '36'}",21,"{'石家庄合力投资咨询中心(有限合伙)', '19047620', '3766666', '厦门时则股权投资管理合伙企业', '李华青', '254475000', '59325000', '现金', '定价', '西藏瑞华资本管理有限公司', '300000000', '4603174', '16157142', '6984125', '股权', '72500000', '苏州弘德源投资管理中心(有限合伙)', '100000000', '财通基金管理的资管计划', '6349207', '36'}"
21,"{'13400000', '现金', '定价', '苏州工业园区资产管理有限公司', '9000000', '10000000', '57039479', '36', '江西铜业集团公司', '6300000', '中融国际信托投资有限公司', '三江航天集团财务有限责任公司', '五矿投资发展有限责任公司', '4456048', '国泰君安投资管理股份有限公司', '股权', '无锡市国联发展(集团)有限公司', '7600000', '上海融昌资产管理有限公司', '12', '上海源海实业有限公司'}",546975,0,set(),12,"{'36', '现金', '上海融昌资产管理有限公司', '江西铜业集团公司', '五矿投资发展有限责任公司', '定价', '中融国际信托投资有限公司', '三江航天集团财务有限责任公司', '国泰君安投资管理股份有限公司', '股权', '12', '上海源海实业有限公司'}",21,"{'13400000', '现金', '定价', '苏州工业园区资产管理有限公司', '9000000', '10000000', '57039479', '36', '江西铜业集团公司', '6300000', '中融国际信托投资有限公司', '三江航天集团财务有限责任公司', '五矿投资发展有限责任公司', '4456048', '国泰君安投资管理股份有限公司', '股权', '无锡市国联发展(集团)有限公司', '7600000', '上海融昌资产管理有限公司', '12', '上海源海实业有限公司'}"
5,"{'定价', '350830083', '1259479998', '36', '上海建工员工持股计划(由受托管理该计划的资管机构长江养老设立专项产品予以认购)'}",15752073,1,{'1259479998'},2,"{'定价', '36'}",4,"{'36', '定价', '350830083', '上海建工员工持股计划(由受托管理该计划的资管机构长江养老设立专项产品予以认购)'}"
15,"{'现金', '2948717', '友邦华泰基金管理有限公司', '华夏基金管理有限公司', '中国人保资产管理股份有限公司', '定价', '嘉实基金管理有限公司', '广西君合投资有限公司', '3076923', '3846153', '南方基金管理有限公司', '2948722', '华商基金管理有限公司', '12', '江苏开元国际集团轻工业品进出口股份有限公司'}",1342728,0,set(),9,"{'现金', '友邦华泰基金管理有限公司', '华夏基金管理有限公司', '中国人保资产管理股份有限公司', '定价', '嘉实基金管理有限公司', '广西君合投资有限公司', '南方基金管理有限公司', '12'}",15,"{'2948717', '友邦华泰基金管理有限公司', '现金', '华夏基金管理有限公司', '中国人保资产管理股份有限公司', '定价', '嘉实基金管理有限公司', '广西君合投资有限公司', '3076923', '3846153', '南方基金管理有限公司', '2948722', '华商基金管理有限公司', '12', '江苏开元国际集团轻工业品进出口股份有限公司'}"
27,"{'47826086', '45144927', '311499996.3', '376999998.9', '54637681', '329999993.4', '深圳市综彩绿色投资管理合伙企业(有限合伙)', '21115945', '68115942', '兴业全球基金管理有限公司', '财通基金管理有限公司', '54927536', '145700020.5', '北京富邦恒业科技发展有限公司', '36', '华夏人寿保险股份有限公司', '309999998.4', '诺安基金管理有限公司', '378999998.4', '广东宝丽华集团有限公司', '466799993.7', '44927536', '469999999.8', '华鑫证券有限责任公司', '67652173', '嘉实基金管理有限公司', '12'}",2298956,0,set(),4,"{'广东宝丽华集团有限公司', '12', '36', '北京富邦恒业科技发展有限公司'}",27,"{'47826086', '45144927', '311499996.3', '376999998.9', '54637681', '329999993.4', '深圳市综彩绿色投资管理合伙企业(有限合伙)', '21115945', '68115942', '兴业全球基金管理有限公司', '财通基金管理有限公司', '54927536', '145700020.5', '北京富邦恒业科技发展有限公司', '36', '华夏人寿保险股份有限公司', '309999998.4', '诺安基金管理有限公司', '378999998.4', '广东宝丽华集团有限公司', '466799993.7', '44927536', '469999999.8', '华鑫证券有限责任公司', '67652173', '嘉实基金管理有限公司', '12'}"
16,"{'12000000', '499200000', '5000000', '现金', '4038161', '166400000', '定价', '15000000', '上海昊益实业有限公司', '雅戈尔集团股份有限公司', '134389998.1', '深圳市平安创新资本投资有限公司', '中国人寿资产管理有限公司', '信达澳银基金管理有限公司', '399360000', '12'}",1177301,1,{'134389998.1'},5,"{'现金', '12', '定价', '中国人寿资产管理有限公司', '深圳市平安创新资本投资有限公司'}",15,"{'12000000', '499200000', '5000000', '现金', '4038161', '166400000', '定价', '15000000', '上海昊益实业有限公司', '雅戈尔集团股份有限公司', '深圳市平安创新资本投资有限公司', '中国人寿资产管理有限公司', '信达澳银基金管理有限公司', '399360000', '12'}"
5,"{'现金', '中电投集团', '竞价', '2500000000', '36'}",1224736,1,{'2500000000'},4,"{'竞价', '现金', '36', '中电投集团'}",4,"{'竞价', '现金', '36', '中电投集团'}"
6,"{'现金', '北京中融鼎新投资管理有限公司', '中铁宝盈-宝益16号资管计划', '陈利泉', '36', '深圳盛合汇富二期股权投资合伙企业(有限合伙)'}",1873170,1,{'中铁宝盈-宝益16号资管计划'},4,"{'北京中融鼎新投资管理有限公司', '现金', '陈利泉', '36'}",5,"{'现金', '北京中融鼎新投资管理有限公司', '陈利泉', '36', '深圳盛合汇富二期股权投资合伙企业(有限合伙)'}"
17,"{'25400000', '253750000', '现金', '14500000', '11100000', '兴业全球基金管理有限公司', '北信瑞丰基金管理有限公司', '444500000', '财通基金管理有限公司', '15800000', '114730000', '276500000', '6556000', '194250000', '前海开源基金管理有限公司', '12', '上银基金管理有限公司'}",280194,8,"{'25400000', '253750000', '11100000', '444500000', '276500000', '6556000', '194250000', '114730000'}",2,"{'现金', '12'}",9,"{'现金', '14500000', '北信瑞丰基金管理有限公司', '兴业全球基金管理有限公司', '财通基金管理有限公司', '15800000', '前海开源基金管理有限公司', '12', '上银基金管理有限公司'}"
18,"{'135500000', '中国水务投资有限公司', '8000000', '新华水利控股集团公司', '12', '46999990.7', '国联安基金管理有限公司', '338750000', '108400000', '9000000', '泰达宏利基金管理有限公司', '25000000', '广东省盐业集团有限公司', '杨征', '121950000', '10000000', '36', '3468634'}",66244,0,set(),8,"{'中国水务投资有限公司', '36', '新华水利控股集团公司', '国联安基金管理有限公司', '泰达宏利基金管理有限公司', '广东省盐业集团有限公司', '杨征', '12'}",18,"{'135500000', '中国水务投资有限公司', '8000000', '新华水利控股集团公司', '12', '46999990.7', '国联安基金管理有限公司', '338750000', '108400000', '9000000', '泰达宏利基金管理有限公司', '25000000', '广东省盐业集团有限公司', '杨征', '121950000', '10000000', '36', '3468634'}"
9,"{'常州常荣创业投资有限公司', '现金', '曹鲁江', '上海世讯会展服务有限公司', '1817900', '刘爱新', '8000000', '12', '7500000'}",1248801,0,set(),6,"{'常州常荣创业投资有限公司', '现金', '曹鲁江', '上海世讯会展服务有限公司', '刘爱新', '12'}",9,"{'常州常荣创业投资有限公司', '现金', '曹鲁江', '上海世讯会展服务有限公司', '1817900', '刘爱新', '8000000', '12', '7500000'}"
22,"{'19047620', '李华青', '254475000', '西藏瑞华', '现金', '财通基金拟设立的资产管理计划', '竞价', '弘德源', '300000000', '4603174', '时则投资', '16157142', '450000000', '股权', '10793650', '合力投资', '72500000', '100000000', '28571429', '6349207', '170000000', '36'}",1837687,4,"{'4603174', '竞价', '72500000', '254475000'}",7,"{'西藏瑞华', '现金', '弘德源', '李华青', '股权', '36', '合力投资'}",18,"{'西藏瑞华', '现金', '19047620', '时则投资', '100000000', '450000000', '10793650', '财通基金拟设立的资产管理计划', '28571429', '6349207', '弘德源', '300000000', '16157142', '170000000', '李华青', '股权', '36', '合力投资'}"
3,"{'中国平安保险(集团)股份有限公司', '1323384991', '36'}",1043479,0,set(),1,{'36'},3,"{'中国平安保险(集团)股份有限公司', '1323384991', '36'}"
17,"{'华龙证券有限责任公司', '现金', '工银瑞信基金管理有限公司', '7499090', '国信证券股份有限公司', '甘肃省国有资产投资集团有限公司', '7000000', '中国北方工业公司', '22000000', '11000000', '17000000', '北京阳光嘉瑞科技开发有限公司', '10000000', '12750455', '12', '孙慧', '东海证券有限责任公司'}",1131424,1,{'现金'},1,{'12'},16,"{'华龙证券有限责任公司', '工银瑞信基金管理有限公司', '7499090', '国信证券股份有限公司', '甘肃省国有资产投资集团有限公司', '7000000', '中国北方工业公司', '22000000', '11000000', '17000000', '北京阳光嘉瑞科技开发有限公司', '10000000', '12750455', '12', '孙慧', '东海证券有限责任公司'}"
21,"{'40798416', '28599464', '32653061', '29387755', '广东富氧基金管理有限公司', '广东恒健资本管理有限公司', '28693877', '现金', '财通基金管理有限公司', '竞价', '鹏华基金管理有限公司', '珠海华发集团有限公司', '华夏人寿保险股份有限公司', '28571428', '36', '国华人寿保险股份有限公司', '博时基金管理有限公司', '国泰基金管理有限公司', '29124571', '105600000', '12'}",1824551,1,{'竞价'},3,"{'12', '现金', '36'}",20,"{'40798416', '28599464', '32653061', '28571428', '华夏人寿保险股份有限公司', '现金', '29387755', '12', '国华人寿保险股份有限公司', '博时基金管理有限公司', '广东富氧基金管理有限公司', '财通基金管理有限公司', '国泰基金管理有限公司', '29124571', '105600000', '广东恒健资本管理有限公司', '鹏华基金管理有限公司', '珠海华发集团有限公司', '28693877', '36'}"
11,"{'兴全定增61号特定多客户资产管理计划', '36', '12259700', '宏图瑞利', '25293600', '定价', '兴全定增62号特定多客户资产管理计划', '13393900', '财通基金-富春71号资产管理计划', '财通基金-富春72号资产管理计划', '13015800'}",1666813,4,"{'13393900', '12259700', '25293600', '13015800'}",3,"{'定价', '宏图瑞利', '36'}",7,"{'兴全定增61号特定多客户资产管理计划', '36', '宏图瑞利', '定价', '兴全定增62号特定多客户资产管理计划', '财通基金-富春71号资产管理计划', '财通基金-富春72号资产管理计划'}"
20,"{'张广佳', '1907183', '现金', '郭江', '1684678', '郭为', '26500000', '297100000', '635727', '3178639', '中信建投基金', '50000000', '帅勇', '349650', '5500000', '蔡忠', '10000000', '30000000', '36', '18887476'}",15366483,10,"{'1907183', '1684678', '26500000', '5500000', '297100000', '3178639', '349650', '635727', '10000000', '18887476'}",8,"{'张广佳', '现金', '郭江', '郭为', '中信建投基金', '帅勇', '蔡忠', '36'}",10,"{'张广佳', '现金', '郭江', '郭为', '中信建投基金', '50000000', '帅勇', '蔡忠', '30000000', '36'}"
4,"{'99000000', '晋正企业股份有限公司', '36', '802890000'}",399203,2,"{'99000000', '802890000'}",2,"{'晋正企业股份有限公司', '36'}",2,"{'晋正企业股份有限公司', '36'}"
6,"{'浙江新湖集团股份有限公司', '95238095', '现金', '1000000000', '竞价', '36'}",1819151,3,"{'1000000000', '竞价', '95238095'}",3,"{'36', '浙江新湖集团股份有限公司', '现金'}",3,"{'现金', '浙江新湖集团股份有限公司', '36'}"
14,"{'上海金保利投资有限公司', '5000000', '1340000', '张传义', '深圳市天寅投资有限公司', '12', '凌俊', '1600000', '2000000', '3000000', '460000', '河北沧州东塑集团股份有限公司', '36', '湖南嘉宇实业有限公司'}",1257920,1,{'1340000'},3,"{'36', '河北沧州东塑集团股份有限公司', '12'}",13,"{'上海金保利投资有限公司', '36', '5000000', '深圳市天寅投资有限公司', '张传义', '凌俊', '1600000', '2000000', '3000000', '460000', '河北沧州东塑集团股份有限公司', '12', '湖南嘉宇实业有限公司'}"
4,"{'竞价', '现金', '36', '深圳市创东方投资有限公司拟筹建和管理的股权投资基金'}",1090233,1,{'竞价'},3,"{'现金', '36', '深圳市创东方投资有限公司拟筹建和管理的股权投资基金'}",3,"{'现金', '36', '深圳市创东方投资有限公司拟筹建和管理的股权投资基金'}"
27,"{'600000000', '180505415', '499999999.6', '920000000', '324909747', '200000000', '72202166', '现金', '332129963', '中国铁建', '北方工业', '上海彤关', '180000000', '900000000', '员工持股计划', '64981949', '南京璇玑', '216606498', '北京韬蕴', '100000000', '有色控股', '180505000', '36101083', '499998850', '国华人寿', '申万菱信', '36'}",1789296,9,"{'72202166', '332129963', '216606498', '180505415', '499999999.6', '64981949', '180505000', '36101083', '324909747'}",11,"{'现金', '北京韬蕴', '中国铁建', '有色控股', '员工持股计划', '北方工业', '上海彤关', '国华人寿', '申万菱信', '36', '南京璇玑'}",18,"{'现金', '900000000', '600000000', '100000000', '中国铁建', '北京韬蕴', '有色控股', '员工持股计划', '920000000', '北方工业', '上海彤关', '499998850', '180000000', '申万菱信', '200000000', '36', '南京璇玑', '国华人寿'}"
20,"{'现金', '22666666', '350000040', '中邮创业基金管理有限公司', '450000000', '诺安基金管理有限公司', '国机财务有限责任公司', '15000000', '679999980', '广西柳工集团有限公司', '上海昊益实业有限公司', '11666668', '易方达基金管理有限公司', '竞价', '300000000', '深圳市平安创新资本投资有限公司', '南方基金管理有限公司', '10000000', '309999990', '10333333'}",566614,1,{'竞价'},2,"{'现金', '广西柳工集团有限公司'}",19,"{'现金', '22666666', '350000040', '中邮创业基金管理有限公司', '450000000', '诺安基金管理有限公司', '国机财务有限责任公司', '15000000', '679999980', '广西柳工集团有限公司', '上海昊益实业有限公司', '11666668', '易方达基金管理有限公司', '300000000', '深圳市平安创新资本投资有限公司', '南方基金管理有限公司', '10000000', '309999990', '10333333'}"
13,"{'52560646', '19460916', '现金', '44139558', '56199460', '定价', '大成创新资本管理有限公司', '22237196', '上海锐懿资产管理有限公司', '创金合信基金管理有限公司', '万家共赢资产管理有限公司', '鹏华资产管理(深圳)有限公司', '12'}",2158066,0,set(),7,"{'现金', '定价', '大成创新资本管理有限公司', '上海锐懿资产管理有限公司', '创金合信基金管理有限公司', '万家共赢资产管理有限公司', '12'}",13,"{'52560646', '19460916', '现金', '44139558', '56199460', '定价', '大成创新资本管理有限公司', '22237196', '上海锐懿资产管理有限公司', '创金合信基金管理有限公司', '万家共赢资产管理有限公司', '鹏华资产管理(深圳)有限公司', '12'}"
24,"{'412800000', '张近东', '23000000', '430000000', '17441860', '现金', '40000000', '18187384', '516000000', '30000000', '斯坦福大学', '24000000', '36', '雅戈尔集团股份有限公司', '国泰基金管理有限公司', '25000000', '富国基金管理有限公司', '688000000', '大成基金管理有限公司', '中国人保资产管理股份有限公司', '395600000', '312823004.8', '299999992', '12'}",1071363,0,set(),5,"{'现金', '12', '张近东', '富国基金管理有限公司', '36'}",24,"{'412800000', '张近东', '23000000', '430000000', '17441860', '现金', '40000000', '18187384', '516000000', '30000000', '斯坦福大学', '24000000', '36', '雅戈尔集团股份有限公司', '国泰基金管理有限公司', '25000000', '富国基金管理有限公司', '688000000', '大成基金管理有限公司', '中国人保资产管理股份有限公司', '395600000', '312823004.8', '299999992', '12'}"
18,"{'152719600', '265240000', '现金', '深圳市弘茂盛欣投资企业(有限合伙)', '东方富华(北京)投资基金管理有限公司', '刘楠', '55840000', '厦门时则壹号投资管理合伙企业(有限合伙)', '定价', '15000000', '10939800', '4000000', '418800000', '19000000', '泰州市金洋源投资中心(有限合伙)', '30000000', '36', '209400000'}",2269294,5,"{'152719600', '265240000', '55840000', '418800000', '209400000'}",4,"{'定价', '现金', '36', '刘楠'}",13,"{'现金', '深圳市弘茂盛欣投资企业(有限合伙)', '东方富华(北京)投资基金管理有限公司', '刘楠', '厦门时则壹号投资管理合伙企业(有限合伙)', '定价', '15000000', '10939800', '4000000', '泰州市金洋源投资中心(有限合伙)', '30000000', '36', '19000000'}"
21,"{'华安基金管理有限公司', '吉林化纤福润德纺织有限公司', '10937500', '70000000', '200000000', '46875000', '北京郁金香天玑资本管理中心(有限合伙)', '现金', '400000000', '吉林化纤集团有限责任公司', '12', '财通基金管理有限公司', '竞价', '300000000', '天治基金管理有限公司', '150000000', '吉林九富资产经营管理有限公司', '62500000', '23437500', '31250000', '36'}",2373328,0,set(),10,"{'现金', '吉林九富资产经营管理有限公司', '华安基金管理有限公司', '吉林化纤福润德纺织有限公司', '吉林化纤集团有限责任公司', '12', '财通基金管理有限公司', '竞价', '天治基金管理有限公司', '36'}",21,"{'华安基金管理有限公司', '吉林化纤福润德纺织有限公司', '10937500', '70000000', '200000000', '46875000', '北京郁金香天玑资本管理中心(有限合伙)', '现金', '400000000', '吉林化纤集团有限责任公司', '12', '财通基金管理有限公司', '竞价', '300000000', '天治基金管理有限公司', '150000000', '吉林九富资产经营管理有限公司', '62500000', '23437500', '31250000', '36'}"
19,"{'湖南轻盐创业投资管理有限公司', '20000000', '现金', '安徽省投资集团有限责任公司', '山西证券股份有限公司', '江苏瑞华投资发展有限公司', '12', '马鞍山市工业投资有限责任公司', '上海莱乐客投资管理合伙企业(有限合伙)', '竞价', '22000000', '25000000', '昆仑信托有限责任公司', '林彬彬', '博弘数君(天津)股权投资基金合伙企业(有限合伙)', '41666600', '21333400', '30000000', '36'}",1262802,1,{'竞价'},9,"{'现金', '安徽省投资集团有限责任公司', '山西证券股份有限公司', '江苏瑞华投资发展有限公司', '12', '马鞍山市工业投资有限责任公司', '林彬彬', '昆仑信托有限责任公司', '36'}",18,"{'湖南轻盐创业投资管理有限公司', '20000000', '安徽省投资集团有限责任公司', '现金', '山西证券股份有限公司', '江苏瑞华投资发展有限公司', '12', '马鞍山市工业投资有限责任公司', '上海莱乐客投资管理合伙企业(有限合伙)', '22000000', '25000000', '昆仑信托有限责任公司', '林彬彬', '博弘数君(天津)股权投资基金合伙企业(有限合伙)', '41666600', '21333400', '30000000', '36'}"
3,"{'竞价', '现金', '钟百胜'}",9895455,0,set(),3,"{'竞价', '现金', '钟百胜'}",3,"{'竞价', '现金', '钟百胜'}"
6,"{'现金', '100000000', '定价', '什邡宏达发展有限公司', '1469000000', '36'}",546471,1,{'1469000000'},4,"{'36', '定价', '现金', '什邡宏达发展有限公司'}",5,"{'现金', '100000000', '定价', '什邡宏达发展有限公司', '36'}"
4,"{'现金', '竞价', '包钢集团', '36'}",556888,0,set(),4,"{'竞价', '现金', '36', '包钢集团'}",4,"{'现金', '竞价', '包钢集团', '36'}"
17,"{'现金', '19672131', '合源投资', '100182149', '12', '定价', '联想控股', '98360656', '229872495', '平安资本', '63752277', '新奥基金', '涛石基金', '泛海投资', '新奥控股', '36', '78688525'}",1135826,1,{'229872495'},11,"{'36', '现金', '合源投资', '定价', '联想控股', '平安资本', '泛海投资', '新奥基金', '涛石基金', '新奥控股', '12'}",16,"{'现金', '19672131', '合源投资', '100182149', '12', '定价', '联想控股', '98360656', '平安资本', '63752277', '泛海投资', '新奥基金', '涛石基金', '新奥控股', '36', '78688525'}"
8,"{'5000000', '现金', '3000000', '孙宝良', '泰德佳予', '甘肃开然投资', '36', '上海厚丰投资'}",913616,0,set(),6,"{'现金', '孙宝良', '泰德佳予', '甘肃开然投资', '36', '上海厚丰投资'}",8,"{'5000000', '现金', '3000000', '孙宝良', '泰德佳予', '甘肃开然投资', '36', '上海厚丰投资'}"
13,"{'109999986.5', '4829270', '第一创业证券股份有限公司', '99000035', '定价', '博时基金管理有限公司', '中广核财务有限责任公司', '5365853', '财通基金管理有限公司', '120999999.5', '5902439', '襄垣县永利科技有限公司', '12'}",2230078,0,set(),7,"{'第一创业证券股份有限公司', '博时基金管理有限公司', '定价', '中广核财务有限责任公司', '财通基金管理有限公司', '襄垣县永利科技有限公司', '12'}",13,"{'109999986.5', '4829270', '第一创业证券股份有限公司', '99000035', '博时基金管理有限公司', '定价', '中广核财务有限责任公司', '5365853', '财通基金管理有限公司', '120999999.5', '5902439', '襄垣县永利科技有限公司', '12'}"
16,"{'上银瑞金资产管理(上海)有限公司', '48733832', '89784431', '12', '泰达宏利基金管理有限公司', '财通基金管理有限公司', '华富基金管理有限公司', '竞价', '71855029', '58424309', '中国平安保险(集团)股份有限公司', '210206652', '易方达资产管理有限公司', '36', '47943113', '银河资本资产管理有限公司'}",1643527,7,"{'48733832', '89784431', '竞价', '71855029', '58424309', '210206652', '47943113'}",2,"{'12', '36'}",9,"{'上银瑞金资产管理(上海)有限公司', '36', '财通基金管理有限公司', '泰达宏利基金管理有限公司', '中国平安保险(集团)股份有限公司', '华富基金管理有限公司', '易方达资产管理有限公司', '12', '银河资本资产管理有限公司'}"
40,"{'4318347', '孙毅', '中国平煤神马能源化工集团有限责任公司', '308453', '南京龙瀚投资咨询有限公司', '平顶山煤业(集团)大庄矿劳动服务公司', '深圳市同盛创业投资企业(有限合伙)', '3084534', '曲丽伟', '天津同益信能股权投资合伙企业(有限合伙)', '493525', '616907', '97663326', '123381', '青海科源实业有限公司', '5552161', '定价', '河南创业投资股份有限公司', '买智勇', '925360', '梁贵振', '国信弘盛投资有限公司', '天津长安创新光伏股权投资合伙企业(有限合伙)', '36', '1880751', '郑州汉威光电技术有限公司', '天津和光远见股权投资基金合伙企业(有限合伙)', '杜水峰', '河南省兆腾投资有限公司', '6169068', '翟志国', '148058', '宋中学', '河南惠和投资中心(有限合伙)', '3701441', '夏军', '1850720', '张鹤顶', '天津和光创展股权投资基金合伙企业(有限合伙)', '12'}",680607,0,set(),4,"{'36', '定价', '12', '中国平煤神马能源化工集团有限责任公司'}",40,"{'4318347', '孙毅', '中国平煤神马能源化工集团有限责任公司', '308453', '南京龙瀚投资咨询有限公司', '平顶山煤业(集团)大庄矿劳动服务公司', '深圳市同盛创业投资企业(有限合伙)', '3084534', '曲丽伟', '天津同益信能股权投资合伙企业(有限合伙)', '493525', '616907', '97663326', '123381', '青海科源实业有限公司', '5552161', '定价', '河南创业投资股份有限公司', '买智勇', '925360', '梁贵振', '国信弘盛投资有限公司', '天津长安创新光伏股权投资合伙企业(有限合伙)', '36', '1880751', '郑州汉威光电技术有限公司', '天津和光远见股权投资基金合伙企业(有限合伙)', '杜水峰', '河南省兆腾投资有限公司', '6169068', '翟志国', '148058', '宋中学', '河南惠和投资中心(有限合伙)', '3701441', '夏军', '1850720', '张鹤顶', '天津和光创展股权投资基金合伙企业(有限合伙)', '12'}"
22,"{'12000000', '20000000', '132800000', '169320000', '9277532', '8000000', '现金', '亨通集团有限公司', '工银瑞信基金管理有限公司', '199200000', '财通基金管理有限公司', '154007047.8', '竞价', '36', '9277533', '博时基金管理有限公司', '东海基金管理有限责任公司', '10200000', '332000000', '融通基金管理有限公司', '154007031.2', '12'}",925661,1,{'竞价'},6,"{'36', '现金', '亨通集团有限公司', '东海基金管理有限责任公司', '财通基金管理有限公司', '12'}",21,"{'12000000', '20000000', '132800000', '169320000', '9277532', '8000000', '现金', '亨通集团有限公司', '工银瑞信基金管理有限公司', '199200000', '财通基金管理有限公司', '154007047.8', '36', '9277533', '博时基金管理有限公司', '东海基金管理有限责任公司', '10200000', '332000000', '融通基金管理有限公司', '154007031.2', '12'}"
19,"{'999999965', '现金', '泰康资管', '中国人寿', '51063830', '1200000005', '29787236', '12765958', '汇添富', '招商财富', '竞价', '中信建投基金', '42553190', '亿利资源', '中融鼎新', '300000013', '700000046', '安徽铁建', '36'}",1590416,1,{'竞价'},10,"{'泰康资管', '现金', '中国人寿', '汇添富', '招商财富', '中信建投基金', '亿利资源', '中融鼎新', '安徽铁建', '36'}",18,"{'999999965', '现金', '泰康资管', '中国人寿', '51063830', '1200000005', '29787236', '12765958', '汇添富', '招商财富', '中信建投基金', '42553190', '亿利资源', '中融鼎新', '300000013', '700000046', '安徽铁建', '36'}"
4,"{'胡智雄', '现金', '胡智彪', '36'}",321150,0,set(),4,"{'胡智雄', '现金', '胡智彪', '36'}",4,"{'胡智雄', '现金', '胡智彪', '36'}"
5,"{'1499999998', '423728813', '定价', '漯河银鸽实业集团有限公司', '36'}",1692311,0,set(),3,"{'漯河银鸽实业集团有限公司', '定价', '36'}",5,"{'1499999998', '423728813', '定价', '漯河银鸽实业集团有限公司', '36'}"
11,"{'江苏圆周', '现金', '牛奶有限公司', '143467220', '张轩松', '95704621', '定价', '239261552', '239261553', '36', '京东邦能'}",1723678,4,"{'95704621', '239261553', '143467220', '239261552'}",7,"{'江苏圆周', '现金', '牛奶有限公司', '张轩松', '定价', '36', '京东邦能'}",7,"{'江苏圆周', '现金', '牛奶有限公司', '张轩松', '定价', '36', '京东邦能'}"
5,"{'现金', '中电投集团', '竞价', '2500000000', '36'}",558615,1,{'2500000000'},4,"{'竞价', '现金', '36', '中电投集团'}",4,"{'竞价', '现金', '36', '中电投集团'}"
5,"{'现金', '1000000000', '竞价', '海航资本', '36'}",1082218,1,{'1000000000'},4,"{'海航资本', '竞价', '现金', '36'}",4,"{'海航资本', '竞价', '现金', '36'}"
5,"{'现金', '苏高新集团', '竞价', '36', '15578161'}",90306,1,{'15578161'},4,"{'苏高新集团', '竞价', '现金', '36'}",4,"{'苏高新集团', '竞价', '现金', '36'}"
11,"{'吴知勇', '52800000', '天津滨海浙商投资集团有限公司', '定价', '6400000', '浙江隆北实业有限公司', '6500000', '53625000', '华泰证券股份有限公司', '河北鑫融投资管理有限公司', '12'}",1157060,2,"{'52800000', '53625000'}",3,"{'定价', '12', '吴知勇'}",9,"{'吴知勇', '天津滨海浙商投资集团有限公司', '6400000', '定价', '浙江隆北实业有限公司', '6500000', '华泰证券股份有限公司', '河北鑫融投资管理有限公司', '12'}"
4,"{'36', '现金', '谭颂斌', '60000000'}",1570984,1,{'60000000'},3,"{'谭颂斌', '现金', '36'}",3,"{'36', '现金', '谭颂斌'}"
5,"{'现金', '盛屯集团', '189053800', '竞价', '36'}",2380896,2,"{'竞价', '189053800'}",3,"{'36', '盛屯集团', '现金'}",3,"{'现金', '盛屯集团', '36'}"
7,"{'20000000', '现金', '广发基金', '中邮基金', '广发证券', '10000000', '12'}",346217,2,"{'20000000', '10000000'}",5,"{'现金', '广发基金', '中邮基金', '广发证券', '12'}",5,"{'现金', '广发基金', '中邮基金', '广发证券', '12'}"
14,"{'5000000', '现金', '45500000', '12', '斯坦福大学', '15000000', '上海世讯会展服务有限公司', '上海盛太投资管理有限公司', '2091240', '重庆建峰工业集团有限公司', '竞价', '江阴市长江钢管有限公司', '上海汇银投资有限公司', '36'}",1153865,1,{'竞价'},8,"{'36', '现金', '上海世讯会展服务有限公司', '上海盛太投资管理有限公司', '上海汇银投资有限公司', '江阴市长江钢管有限公司', '斯坦福大学', '12'}",13,"{'5000000', '现金', '45500000', '12', '斯坦福大学', '15000000', '上海世讯会展服务有限公司', '上海盛太投资管理有限公司', '2091240', '重庆建峰工业集团有限公司', '江阴市长江钢管有限公司', '上海汇银投资有限公司', '36'}"
5,"{'现金', '交运集团', '1450000000', '竞价', '36'}",1687955,1,{'1450000000'},4,"{'36', '竞价', '交运集团', '现金'}",4,"{'现金', '竞价', '交运集团', '36'}"
8,"{'36', '现金', '竞价', '700000000', '2000000000', '海航旅游', '12', '凯撒世嘉投资公司'}",14782102,2,"{'700000000', '2000000000'}",6,"{'36', '现金', '竞价', '海航旅游', '12', '凯撒世嘉投资公司'}",6,"{'现金', '12', '竞价', '海航旅游', '36', '凯撒世嘉投资公司'}"
21,"{'138999990.8', '14882226', '21413276', '王志成', '148499994.4', '现金', '199999997.8', '万家基金管理有限公司', '威海纺织集团进出口有限责任公司', '财通基金管理有限公司', '竞价', '15899357', '宝盈基金管理有限公司', '100000008.3', '36', '10706639', '16059957', '149999998.4', '国融基金管理有限公司', '12', '海富通基金管理有限公司'}",20371858,5,"{'148499994.4', '14882226', '149999998.4', '竞价', '100000008.3'}",5,"{'36', '现金', '王志成', '12', '海富通基金管理有限公司'}",16,"{'现金', '138999990.8', '16059957', '199999997.8', '12', '万家基金管理有限公司', '威海纺织集团进出口有限责任公司', '10706639', '财通基金管理有限公司', '21413276', '王志成', '国融基金管理有限公司', '15899357', '宝盈基金管理有限公司', '36', '海富通基金管理有限公司'}"
5,"{'现金', '竞价', '500000000', '上海环指投资中心(有限合伙)', '36'}",348989,2,"{'上海环指投资中心(有限合伙)', '500000000'}",3,"{'竞价', '现金', '36'}",3,"{'竞价', '现金', '36'}"
19,"{'1025916235', '现金', '民生加银基金管理有限公司', '471727748', '北信瑞丰基金管理有限公司', '518835066', '红土创新基金管理有限公司', '信诚基金管理有限公司', '建信基金管理有限责任公司', '博时基金管理有限公司', '526329109', '中国国有企业结构调整基金股份有限公司', '777486910', '174291319', '竞价', '477748691', '泰达宏利基金管理有限公司', '739706806', '12'}",16412123,1,{'竞价'},10,"{'现金', '民生加银基金管理有限公司', '北信瑞丰基金管理有限公司', '红土创新基金管理有限公司', '信诚基金管理有限公司', '博时基金管理有限公司', '中国国有企业结构调整基金股份有限公司', '泰达宏利基金管理有限公司', '建信基金管理有限责任公司', '12'}",18,"{'1025916235', '471727748', '民生加银基金管理有限公司', '北信瑞丰基金管理有限公司', '现金', '518835066', '红土创新基金管理有限公司', '信诚基金管理有限公司', '建信基金管理有限责任公司', '博时基金管理有限公司', '526329109', '中国国有企业结构调整基金股份有限公司', '777486910', '174291319', '477748691', '泰达宏利基金管理有限公司', '739706806', '12'}"
6,"{'现金', '定价', '中国机械工业集团有限公司', '13043478', '105000000', '36'}",1974129,1,{'105000000'},4,"{'现金', '中国机械工业集团有限公司', '定价', '36'}",5,"{'现金', '定价', '中国机械工业集团有限公司', '13043478', '36'}"
15,"{'37300000', '现金', '中国机电出口产品投资有限公司', '华夏基金管理有限公司', '交银施罗德基金管理有限公司', '12', '国华人寿保险股份有限公司', '12200000', '融通基金管理有限公司', '何剑锋', '财通基金管理有限公司', '1820000', '竞价', '17500000', '36'}",1163616,4,"{'1820000', '37300000', '竞价', '17500000'}",6,"{'现金', '华夏基金管理有限公司', '交银施罗德基金管理有限公司', '12', '融通基金管理有限公司', '36'}",11,"{'现金', '中国机电出口产品投资有限公司', '华夏基金管理有限公司', '交银施罗德基金管理有限公司', '12', '国华人寿保险股份有限公司', '12200000', '融通基金管理有限公司', '何剑锋', '财通基金管理有限公司', '36'}"
4,"{'竞价', '现金', '36', '亿利集团'}",14109984,0,set(),4,"{'竞价', '现金', '36', '亿利集团'}",4,"{'竞价', '现金', '36', '亿利集团'}"
15,"{'瑞士银行(UBS AG)', '1588391', '12', '中国人保资产管理股份有限公司', '定价', '2186675', '中能源电力燃料有限公司', '7000000', '内蒙古博源投资集团有限公司', '比尔盖茨和梅琳达基金会( Bill& Melinda Gates Foundation)', '2100923', '10000000', '上海证大投资发展有限公司', '无锡市新宝联投资有限公司', '36'}",814248,2,"{'比尔盖茨和梅琳达基金会( Bill& Melinda Gates Foundation)', '瑞士银行(UBS AG)'}",8,"{'12', '中国人保资产管理股份有限公司', '定价', '中能源电力燃料有限公司', '内蒙古博源投资集团有限公司', '上海证大投资发展有限公司', '无锡市新宝联投资有限公司', '36'}",13,"{'1588391', '12', '中国人保资产管理股份有限公司', '定价', '2186675', '中能源电力燃料有限公司', '7000000', '内蒙古博源投资集团有限公司', '2100923', '10000000', '上海证大投资发展有限公司', '无锡市新宝联投资有限公司', '36'}"
5,"{'现金', '1000000000', '竞价', '永泰能源', '36'}",1485130,1,{'1000000000'},4,"{'竞价', '现金', '永泰能源', '36'}",4,"{'竞价', '现金', '永泰能源', '36'}"
14,"{'现金', '东方点石投资管理有限公司--东方点钻-东兴礡璞3号投资基金', '16474464', '19494783', '西藏康盛投资管理有限公司', '100000000', '上海国泰君安证券资产管理有限公司-国泰君安君享新发集合资产管理计划', '5491488', '竞价', '上海东方明珠新媒体股份有限公司', '300000000', '同方股份有限公司', '36', '355000000'}",1670986,3,"{'竞价', '300000000', '355000000'}",5,"{'现金', '西藏康盛投资管理有限公司', '上海东方明珠新媒体股份有限公司', '同方股份有限公司', '36'}",11,"{'现金', '东方点石投资管理有限公司--东方点钻-东兴礡璞3号投资基金', '16474464', '19494783', '西藏康盛投资管理有限公司', '100000000', '上海国泰君安证券资产管理有限公司-国泰君安君享新发集合资产管理计划', '5491488', '上海东方明珠新媒体股份有限公司', '同方股份有限公司', '36'}"
25,"{'富威特', '37965072', '鼎泰宏源', '26575550', '50000000', '200000000', '国能金汇', '侯毅', '400000000', '定价', '3796507', '30372058', '6074412', '7593014', '万赛投资', '15186029', '国能金海', '120000000', '9111617', '华弘润泽', '100000000', '350000000', '500000000', '80000000', '36'}",2322809,5,"{'80000000', '100000000', '350000000', '120000000', '200000000'}",9,"{'国能金汇', '华弘润泽', '富威特', '万赛投资', '定价', '鼎泰宏源', '国能金海', '36', '侯毅'}",20,"{'9111617', '国能金汇', '400000000', '华弘润泽', '富威特', '37965072', '定价', '万赛投资', '鼎泰宏源', '15186029', '3796507', '30372058', '6074412', '26575550', '国能金海', '50000000', '500000000', '7593014', '36', '侯毅'}"
27,"{'华安基金管理有限公司', '10204081', '国联安基金管理有限公司', '8673469', '广东中科招商创业投资管理有限责任公司', '现金', '武汉雷石融泰投资合伙企业(有限合伙)', '深圳市吉富启瑞投资合伙企业(有限合伙)', '财通基金管理有限公司', '69999998.6', '8265306', '816329', '84999996.2', '7142857', '14285714', '万家共赢资产管理有限公司', '71999992.4', '139999997.2', '8000024.2', '中信证券股份有限公司', '7551020', '80999998.8', '华商基金管理有限公司', '73999996', '7346938', '99999993.8', '12'}",11800,0,set(),2,"{'现金', '12'}",27,"{'华安基金管理有限公司', '10204081', '国联安基金管理有限公司', '8673469', '广东中科招商创业投资管理有限责任公司', '现金', '武汉雷石融泰投资合伙企业(有限合伙)', '深圳市吉富启瑞投资合伙企业(有限合伙)', '财通基金管理有限公司', '69999998.6', '8265306', '816329', '84999996.2', '7142857', '14285714', '万家共赢资产管理有限公司', '71999992.4', '139999997.2', '8000024.2', '中信证券股份有限公司', '7551020', '80999998.8', '华商基金管理有限公司', '73999996', '7346938', '99999993.8', '12'}"
24,"{'邓栋', '马剑', '3000000', '5000000', '现金', '阮海明', '周新华', '82080000', '5400000', '118560000', '45600000', '9000000', '饶陆华', '246240000', '林训先', '聂志勇', '黄幼平', '49248000', '13000000', '27360000', '深圳市创东方慈爱投资企业(有限合伙)', '27000000', '上海景贤投资有限公司', '36'}",398516,0,set(),11,"{'现金', '饶陆华', '邓栋', '马剑', '阮海明', '周新华', '林训先', '聂志勇', '黄幼平', '上海景贤投资有限公司', '36'}",24,"{'邓栋', '马剑', '3000000', '5000000', '现金', '阮海明', '周新华', '82080000', '5400000', '118560000', '45600000', '9000000', '饶陆华', '246240000', '林训先', '聂志勇', '黄幼平', '49248000', '13000000', '27360000', '深圳市创东方慈爱投资企业(有限合伙)', '27000000', '上海景贤投资有限公司', '36'}"
27,"{'73461892', '1301060720', '27548209', '55096419', '深圳新华富时资产管理有限公司', '2500000000', '600000003.3', '现金', '299999996', '北京郁金香财富资本管理中心(有限合伙)', '2353019278', '82644628', '竞价', '上海纪辉资产管理有限公司', '西藏格桑梅朵科技有限公司(设立中)', '1300000001', '119375574', '共青城量能投资管理合伙企业(有限合伙)', '216071559', '天安人寿保险股份有限公司', '800000003.9', '899999998.9', '119472977', '229568411', '西藏丹巴达杰科技有限公司(设立中)', '余斌', '36'}",1756390,6,"{'2353019278', '1301060720', '800000003.9', '竞价', '600000003.3', '1300000001'}",6,"{'现金', '天安人寿保险股份有限公司', '上海纪辉资产管理有限公司', '余斌', '深圳新华富时资产管理有限公司', '36'}",21,"{'73461892', '27548209', '55096419', '深圳新华富时资产管理有限公司', '2500000000', '现金', '299999996', '北京郁金香财富资本管理中心(有限合伙)', '82644628', '上海纪辉资产管理有限公司', '西藏格桑梅朵科技有限公司(设立中)', '119375574', '共青城量能投资管理合伙企业(有限合伙)', '216071559', '天安人寿保险股份有限公司', '899999998.9', '119472977', '229568411', '西藏丹巴达杰科技有限公司(设立中)', '余斌', '36'}"
15,"{'217915000.7', '42358634', '房华', '现金', '应保良', '41350095', '朱建星', '4740133', '223230001.2', '竞价', '24980500.91', '20170778', '瑞福通达', '106300000.1', '36'}",385774,4,"{'217915000.7', '223230001.2', '竞价', '106300000.1'}",6,"{'房华', '现金', '应保良', '朱建星', '瑞福通达', '36'}",11,"{'房华', '42358634', '现金', '应保良', '41350095', '朱建星', '4740133', '20170778', '24980500.91', '瑞福通达', '36'}"
12,"{'20000000', '现金', '欧小平', '7177000', '7000000', '竞价', '彭锡明', '第一创业证券有限责任公司', '北京京富融源投资管理有限公司', '刘固湘', '8000000', '12'}",1273478,1,{'竞价'},2,"{'现金', '12'}",11,"{'20000000', '现金', '欧小平', '7177000', '7000000', '彭锡明', '第一创业证券有限责任公司', '北京京富融源投资管理有限公司', '刘固湘', '8000000', '12'}"
12,"{'12000000', '195960000', '现金', '342930000', '15000000', '21000000', '南通乐源汇达资产管理有限公司', '244950000', '上海界龙集团有限公司', '三一重工股份有限公司', '建信基金管理有限责任公司', '36'}",1802249,3,"{'342930000', '195960000', '244950000'}",6,"{'现金', '南通乐源汇达资产管理有限公司', '三一重工股份有限公司', '上海界龙集团有限公司', '建信基金管理有限责任公司', '36'}",9,"{'12000000', '现金', '15000000', '21000000', '南通乐源汇达资产管理有限公司', '上海界龙集团有限公司', '三一重工股份有限公司', '建信基金管理有限责任公司', '36'}"
12,"{'20000000', '现金', '6230530', '1118000000', '定价', '刘祥华', '皮晓君', '120000000', '郑军', '58047767', '36', '1038422'}",365170,6,"{'20000000', '6230530', '1118000000', '120000000', '58047767', '1038422'}",6,"{'现金', '定价', '刘祥华', '皮晓君', '郑军', '36'}",6,"{'现金', '定价', '刘祥华', '皮晓君', '郑军', '36'}"
16,"{'北京金谷融通投资有限公司', '5000000', '北京新荣拓展投资管理有限公司', '国力民生', '76560000', '张传义', '35000000', '14000000', '304500000', '奉友谊', '1567816', '13639999.2', '8800000', '43500000', '121800000', '36'}",1329270,6,"{'76560000', '35000000', '304500000', '13639999.2', '43500000', '121800000'}",4,"{'北京金谷融通投资有限公司', '北京新荣拓展投资管理有限公司', '国力民生', '36'}",10,"{'北京金谷融通投资有限公司', '5000000', '北京新荣拓展投资管理有限公司', '国力民生', '张传义', '14000000', '奉友谊', '1567816', '8800000', '36'}"
6,"{'现金', '定价', '广东移动', '2207511410', '39459266454', '36'}",1286357,2,"{'2207511410', '39459266454'}",4,"{'广东移动', '定价', '现金', '36'}",4,"{'广东移动', '定价', '现金', '36'}"
11,"{'现金', '230000000', '申能集团', '定价', '48', '上海海烟投资', '上海报业集团', '120000000', '50000000', '750000000', '36'}",15747267,4,"{'50000000', '230000000', '120000000', '750000000'}",7,"{'现金', '申能集团', '定价', '上海海烟投资', '48', '上海报业集团', '36'}",7,"{'现金', '申能集团', '定价', '上海海烟投资', '48', '上海报业集团', '36'}"
13,"{'44999995.89', '现金', '杨文仕', '119520008.4', '179999999.8', '新疆宏盛开源股权投资合伙企业(有限合伙)', '李红', '山东一圈一带产业投资基金有限公司', '竞价', '11090573', '7364141', '12', '2772643'}",20239739,3,"{'44999995.89', '竞价', '179999999.8'}",5,"{'现金', '杨文仕', '李红', '山东一圈一带产业投资基金有限公司', '12'}",10,"{'现金', '杨文仕', '119520008.4', '新疆宏盛开源股权投资合伙企业(有限合伙)', '李红', '山东一圈一带产业投资基金有限公司', '11090573', '7364141', '12', '2772643'}"
5,"{'现金', '昆钢控股', '585894720', '竞价', '36'}",306327,1,{'585894720'},4,"{'36', '竞价', '昆钢控股', '现金'}",4,"{'现金', '竞价', '昆钢控股', '36'}"
23,"{'12000000', '吴光蓉', '顾斌', '4268500', '7000000', '6000000', '8000000', '现金', '定价', '10000000', '3600000', '高建明', '5500000', '1500000', '郭忠河', '杨学平', '厦门三微投资管理股份有限公司', '何小丽', '孙汉宗', '王丽娟', '陈建煌', '7200000', '36'}",1503287,3,"{'3600000', '4268500', '5500000'}",13,"{'吴光蓉', '何小丽', '现金', '顾斌', '孙汉宗', '王丽娟', '定价', '高建明', '陈建煌', '郭忠河', '杨学平', '厦门三微投资管理股份有限公司', '36'}",20,"{'12000000', '6000000', '现金', '8000000', '吴光蓉', '何小丽', '顾斌', '孙汉宗', '王丽娟', '定价', '高建明', '7000000', '1500000', '陈建煌', '郭忠河', '杨学平', '7200000', '10000000', '厦门三微投资管理股份有限公司', '36'}"
8,"{'方振淳', '63997920', '2539600', '定价', '财通基金管理有限公司', '上海山楂树投资管理中心(有限合伙)', '31998960', '1269800'}",1836983,3,"{'上海山楂树投资管理中心(有限合伙)', '63997920', '31998960'}",3,"{'定价', '方振淳', '财通基金管理有限公司'}",5,"{'方振淳', '2539600', '定价', '财通基金管理有限公司', '1269800'}"
6,"{'140515222', '现金', '1199999996', '定价', '巨化集团', '36'}",1587392,1,{'1199999996'},4,"{'定价', '现金', '36', '巨化集团'}",5,"{'现金', '140515222', '定价', '巨化集团', '36'}"
25,"{'539999988', '安徽省铁路建设投资基金有限公司', '24545454', '5790912', '279999984', '现金', '26363636', '财通基金管理有限公司', '安徽省投资集团控股有限公司', '15095454', '竞价', '宝盈基金管理有限公司', '270999982', '12318181', '诺安基金管理有限公司', '国华人寿保险股份有限公司', '15000000', '579999992', '中国长城资产管理公司', '西南证券股份有限公司', '127400064', '330000000', '332099988', '12727272', '12'}",687479,1,{'竞价'},2,"{'现金', '12'}",24,"{'539999988', '安徽省铁路建设投资基金有限公司', '24545454', '5790912', '279999984', '现金', '26363636', '财通基金管理有限公司', '安徽省投资集团控股有限公司', '15095454', '宝盈基金管理有限公司', '270999982', '12318181', '诺安基金管理有限公司', '国华人寿保险股份有限公司', '15000000', '579999992', '中国长城资产管理公司', '西南证券股份有限公司', '127400064', '330000000', '332099988', '12727272', '12'}"
22,"{'深圳平安大华汇通财富管理有限公司', '299999952', '易方达基金管理有限公司', '泰达宏利基金管理有限公司', '16106400', '21008400', '现金', '安徽皖投工业投资有限公司', '定价', '2101100', '财通基金管理有限公司', '安徽省投资集团控股有限公司', '26610600', '23109200', '229999392', '南京瑞森投资管理合伙企业(有限合伙)', '东海基金管理有限责任公司', '30003708', '379999368', '329999376', '上银基金管理有限公司', '12'}",349623,0,set(),3,"{'现金', '定价', '12'}",22,"{'深圳平安大华汇通财富管理有限公司', '299999952', '易方达基金管理有限公司', '泰达宏利基金管理有限公司', '16106400', '21008400', '现金', '安徽皖投工业投资有限公司', '定价', '2101100', '财通基金管理有限公司', '安徽省投资集团控股有限公司', '26610600', '23109200', '229999392', '南京瑞森投资管理合伙企业(有限合伙)', '东海基金管理有限责任公司', '30003708', '379999368', '329999376', '上银基金管理有限公司', '12'}"
4,"{'现金', '竞价', '王相荣', '36'}",1121432,0,set(),4,"{'36', '竞价', '王相荣', '现金'}",4,"{'36', '竞价', '王相荣', '现金'}"
28,"{'50709983.7', '1198590', '52999556.65', '51000004.5', '51005195.6', '许利银', '现金', '51000047.05', '101859977', '定价', '2374420', '财通基金管理有限公司', '47493629.2', '陈邦锐', '1245583', '36', '2393889', '博时基金管理有限公司', '泓德基金管理有限公司', '101031571', '1116184', '1198712', '第一创业证券股份有限公司', '上海韬韫投资管理有限公司', '1191774', '1198591', '浙江东港投资有限公司', '12'}",14765352,1,{'101859977'},12,"{'36', '许利银', '现金', '第一创业证券股份有限公司', '博时基金管理有限公司', '上海韬韫投资管理有限公司', '定价', '财通基金管理有限公司', '陈邦锐', '浙江东港投资有限公司', '12', '泓德基金管理有限公司'}",27,"{'50709983.7', '1198590', '52999556.65', '51000004.5', '51005195.6', '现金', '12', '2374420', '51000047.05', '定价', '财通基金管理有限公司', '47493629.2', '陈邦锐', '1245583', '36', '2393889', '博时基金管理有限公司', '泓德基金管理有限公司', '101031571', '1116184', '1198712', '第一创业证券股份有限公司', '上海韬韫投资管理有限公司', '1191774', '1198591', '浙江东港投资有限公司', '许利银'}"
17,"{'胡惠康', '现金', '5555556', '长航联合', '厦门华鑫丰', '7407407', '当代文化', '13888889', '吕桧瑛', '134259259', '南方资本-当代东方定向增发专项资产管理计划', '50925926', '4629630', '先锋亚太', '9259259', '36', '厦门旭熙'}",569471,4,"{'13888889', '9259259', '134259259', '50925926'}",9,"{'胡惠康', '现金', '长航联合', '厦门华鑫丰', '当代文化', '吕桧瑛', '先锋亚太', '36', '厦门旭熙'}",13,"{'胡惠康', '现金', '5555556', '长航联合', '厦门华鑫丰', '7407407', '当代文化', '吕桧瑛', '南方资本-当代东方定向增发专项资产管理计划', '4629630', '先锋亚太', '36', '厦门旭熙'}"
16,"{'平安大华基金管理有限公司', '天津鑫茂科技投资集团有限公司', '36', '现金', '长安基金管理有限公司', '8600000', '华宝信托有限责任公司', '竞价', '10555610', '25000000', '26064982', '房红梅', '深圳市融通资本财富管理有限公司', '11400000', '12', '28700000'}",76415,1,{'竞价'},9,"{'平安大华基金管理有限公司', '36', '天津鑫茂科技投资集团有限公司', '长安基金管理有限公司', '现金', '华宝信托有限责任公司', '房红梅', '深圳市融通资本财富管理有限公司', '12'}",15,"{'平安大华基金管理有限公司', '天津鑫茂科技投资集团有限公司', '36', '现金', '长安基金管理有限公司', '8600000', '华宝信托有限责任公司', '10555610', '25000000', '26064982', '房红梅', '深圳市融通资本财富管理有限公司', '11400000', '12', '28700000'}"
26,"{'顾子皿', '267000000', '13350000', '申万菱信基金管理有限公司', '12500000', '227000000', '财通基金管理有限公司', '178000000', '125000000', '竞价', '深圳中植产投互联网金融投资企业(有限合伙)', '民生加银基金管理有限公司', '8900000', '8450000', '6250000', '中欧盛世资产管理(上海)有限公司', '11350000', '金鹰基金管理有限公司', '218000000', '169000000', '第一创业证券股份有限公司', '250000000', '11800000', '236000000', '10900000', '12'}",1888769,15,"{'218000000', '169000000', '227000000', '267000000', '8900000', '125000000', '178000000', '13350000', '250000000', '竞价', '8450000', '6250000', '236000000', '10900000', '11350000'}",6,"{'金鹰基金管理有限公司', '第一创业证券股份有限公司', '民生加银基金管理有限公司', '财通基金管理有限公司', '申万菱信基金管理有限公司', '12'}",11,"{'金鹰基金管理有限公司', '顾子皿', '第一创业证券股份有限公司', '民生加银基金管理有限公司', '财通基金管理有限公司', '11800000', '12500000', '中欧盛世资产管理(上海)有限公司', '申万菱信基金管理有限公司', '深圳中植产投互联网金融投资企业(有限合伙)', '12'}"
9,"{'34965000', '现金', '9990000', '长城嘉信雅才2号专项资产管理计划', '定价', '山东阳谷华泰化工股份有限公司第1期员工持股计划', '4995000', '惠申(天津)股权投资基金管理有限公司', '36'}",1646123,4,"{'山东阳谷华泰化工股份有限公司第1期员工持股计划', '34965000', '9990000', '4995000'}",3,"{'定价', '现金', '36'}",5,"{'现金', '长城嘉信雅才2号专项资产管理计划', '定价', '惠申(天津)股权投资基金管理有限公司', '36'}"
6,"{'现金', '刘水', '12', '其他特定发行对象', '200000000', '36'}",446050,1,{'200000000'},5,"{'刘水', '现金', '12', '其他特定发行对象', '36'}",5,"{'现金', '刘水', '12', '其他特定发行对象', '36'}"
7,"{'现金', '中国网安', '中电科投资', '竞价', '300000000', '200000000', '36'}",1951162,2,"{'300000000', '200000000'}",5,"{'现金', '中国网安', '中电科投资', '竞价', '36'}",5,"{'36', '现金', '中国网安', '竞价', '中电科投资'}"
25,"{'35000000', '海通证券股份有限公司', '50000000', '29500000', '现金', '105310800', '定价', '264600000', '11940000', '30000000', '308700000', '博时基金管理有限公司', '平安资产管理有限责任公司', '60000000', '国泰基金管理有限公司', '中信证券股份有限公司', '441000000', '37000000', '326340000', '西南证券股份有限公司', '260190000', '中国人保资产管理股份有限公司', '529200000', '泰康资产管理有限责任公司', '12'}",1450790,7,"{'105310800', '260190000', '308700000', '529200000', '264600000', '441000000', '326340000'}",3,"{'定价', '现金', '12'}",18,"{'现金', '中国人保资产管理股份有限公司', '35000000', '博时基金管理有限公司', '西南证券股份有限公司', '平安资产管理有限责任公司', '11940000', '60000000', '定价', '国泰基金管理有限公司', '中信证券股份有限公司', '海通证券股份有限公司', '50000000', '37000000', '泰康资产管理有限责任公司', '30000000', '12', '29500000'}"
4,"{'36', '冀中能源集团有限责任公司', '现金', '252227171'}",756843,0,set(),3,"{'冀中能源集团有限责任公司', '现金', '36'}",4,"{'36', '冀中能源集团有限责任公司', '现金', '252227171'}"
4,"{'竞价', '现金', '36', '河南省宛西控股股份有限公司'}",362621,0,set(),4,"{'竞价', '现金', '36', '河南省宛西控股股份有限公司'}",4,"{'竞价', '现金', '36', '河南省宛西控股股份有限公司'}"
17,"{'199810000', '现金', '中再资产管理股份有限公司', '深圳潇湘君亨投资企业(有限合伙)', '399910000', '中国华录集团有限公司', '中国华融资产管理股份有限公司', '561280500', '202420000', '13790000', '6890000', '6980000', '19354500', '宁波华易智诚投资合伙企业(有限合伙)', '36', '7985500', '231579500'}",306833,10,"{'199810000', '19354500', '561280500', '202420000', '13790000', '6890000', '6980000', '399910000', '7985500', '231579500'}",5,"{'中再资产管理股份有限公司', '现金', '中国华录集团有限公司', '中国华融资产管理股份有限公司', '36'}",7,"{'现金', '中再资产管理股份有限公司', '深圳潇湘君亨投资企业(有限合伙)', '中国华录集团有限公司', '中国华融资产管理股份有限公司', '宁波华易智诚投资合伙企业(有限合伙)', '36'}"
18,"{'1715000', '现金', '张立俊', '412471952', '定价', '93656150', '183116', '黄健', '1200000', '65532000', '毛朗', '10000000', '天风证券天浩51号定向资产管理计划', '3662332', '黄小倢', '7553048', '200000000', '36'}",1730428,4,"{'412471952', '10000000', '93656150', '65532000'}",7,"{'现金', '张立俊', '定价', '黄健', '毛朗', '黄小倢', '36'}",14,"{'1715000', '现金', '张立俊', '定价', '183116', '黄健', '1200000', '毛朗', '天风证券天浩51号定向资产管理计划', '3662332', '黄小倢', '7553048', '200000000', '36'}"
3,"{'现金', '36', '仰帆投资'}",1129350,0,set(),3,"{'现金', '36', '仰帆投资'}",3,"{'现金', '36', '仰帆投资'}"
14,"{'18796992', '现金', '中融基金管理有限公司', '大成基金管理有限公司', '圆信永丰基金管理有限公司', '银华基金管理股份有限公司', '申万菱信(上海)资产管理有限公司', '7518796', '鹏华基金管理有限公司', '富国基金管理有限公司', '5974937', '12531328', '12', '10275689'}",15645456,0,set(),8,"{'现金', '圆信永丰基金管理有限公司', '大成基金管理有限公司', '中融基金管理有限公司', '银华基金管理股份有限公司', '鹏华基金管理有限公司', '富国基金管理有限公司', '12'}",14,"{'18796992', '现金', '中融基金管理有限公司', '大成基金管理有限公司', '圆信永丰基金管理有限公司', '银华基金管理股份有限公司', '申万菱信(上海)资产管理有限公司', '7518796', '鹏华基金管理有限公司', '富国基金管理有限公司', '5974937', '12531328', '12', '10275689'}"
27,"{'138650000', '176250000', '96350000', '5900000', '5000000', '新华基金管理有限公司', '安徽皖投工业投资有限公司', '东兴证券股份有限公司', '定价', '117500000', '54199953.5', '5200000', '平安大华基金管理有限公司', '36', '蚌埠玻璃工业设计研究院', '119850000', '兵工财务有限责任公司', '7446810', '华商基金管理有限公司', '122200000', '7500000', '5100000', '安徽安粮控股股份有限公司', '4100000', '175000035', '12', '2306381'}",238880,0,set(),3,"{'36', '定价', '12'}",27,"{'138650000', '176250000', '96350000', '5900000', '5000000', '新华基金管理有限公司', '安徽皖投工业投资有限公司', '12', '定价', '117500000', '54199953.5', '5200000', '平安大华基金管理有限公司', '36', '蚌埠玻璃工业设计研究院', '119850000', '兵工财务有限责任公司', '7446810', '华商基金管理有限公司', '122200000', '7500000', '5100000', '安徽安粮控股股份有限公司', '4100000', '175000035', '东兴证券股份有限公司', '2306381'}"
4,"{'592000000', '44780000', '新华基金管理有限公司', '12'}",718469,2,"{'592000000', '44780000'}",1,{'12'},2,"{'新华基金管理有限公司', '12'}"
5,"{'现金', '鞍山钢铁集团公司', '竞价', '3000000000', '36'}",573640,1,{'3000000000'},4,"{'鞍山钢铁集团公司', '竞价', '现金', '36'}",4,"{'鞍山钢铁集团公司', '竞价', '现金', '36'}"
16,"{'现金', '福建省长乐市长源纺织有限公司', '厦门路桥五缘投资有限公司', '上海汽车集团股权投资有限公司', '108695651', '定价', '三峡资本控股有限责任公司', '平安资产管理有限责任公司', '嘉实基金管理有限公司', '福州港务集团有限公司', '32608695', '10869564', '方正富邦基金管理有限公司', '福建省交通运输集团有限责任公司', '36', '21739129'}",1870731,0,set(),3,"{'定价', '现金', '36'}",16,"{'福建省长乐市长源纺织有限公司', '现金', '厦门路桥五缘投资有限公司', '上海汽车集团股权投资有限公司', '108695651', '定价', '三峡资本控股有限责任公司', '平安资产管理有限责任公司', '嘉实基金管理有限公司', '福州港务集团有限公司', '32608695', '10869564', '方正富邦基金管理有限公司', '福建省交通运输集团有限责任公司', '36', '21739129'}"
16,"{'现金', '4743833', '陈坤亮', '潘叶江', '100000000', '定价', '320000000', '珠海华创投', '吴焯民', '50000000', '1423149', '2371917', '15180265', '30000000', '36', '俞毅'}",14473752,3,"{'100000000', '320000000', '30000000'}",8,"{'现金', '陈坤亮', '潘叶江', '定价', '吴焯民', '珠海华创投', '36', '俞毅'}",13,"{'现金', '4743833', '陈坤亮', '潘叶江', '定价', '珠海华创投', '吴焯民', '50000000', '1423149', '2371917', '15180265', '36', '俞毅'}"
5,"{'现金', '新疆艾比湖农工商联合企业总公司', '竞价', '6000000', '36'}",1095322,1,{'6000000'},4,"{'36', '竞价', '现金', '新疆艾比湖农工商联合企业总公司'}",4,"{'36', '竞价', '现金', '新疆艾比湖农工商联合企业总公司'}"
23,"{'12000000', '525875000', '1465000', '12500000', '420700000', '8000000', '现金', '新华人寿保险股份有限公司', '504840000', '中国东方电气集团有限公司', '10000000', '2522727550', '36', '太平洋资产管理有限责任公司', '国泰基金管理有限公司', '雅戈尔集团股份有限公司', '61632550', '五矿投资发展有限责任公司', '刘益谦', '59965000', '中国人寿资产管理有限公司', '336560000', '12'}",1447669,0,set(),11,"{'太平洋资产管理有限责任公司', '现金', '新华人寿保险股份有限公司', '12', '中国东方电气集团有限公司', '国泰基金管理有限公司', '雅戈尔集团股份有限公司', '中国人寿资产管理有限公司', '五矿投资发展有限责任公司', '36', '刘益谦'}",23,"{'12000000', '525875000', '1465000', '12500000', '420700000', '8000000', '现金', '新华人寿保险股份有限公司', '504840000', '中国东方电气集团有限公司', '10000000', '2522727550', '36', '太平洋资产管理有限责任公司', '国泰基金管理有限公司', '雅戈尔集团股份有限公司', '61632550', '五矿投资发展有限责任公司', '刘益谦', '59965000', '中国人寿资产管理有限公司', '336560000', '12'}"
83,"{'439170', '254409', '张俊峰', '14994', '马珍', '周天宁', '1356084', '深圳市创新投资集团有限公司', '侯曙光', '李宗香', '7996', '王国忠', '陈玉敏', '王智', '4998', '24990', '徐洪涛', '郎福志', '271216', '128701', '83037', '774899', '62974', '杨文华', '王勋周', '宁波东蓝商贸有限公司', '定价', '1431298', '陈卫国', '朱豪轲', '32986', '任飞澜', '杨英杰', '2840594', '866784', '9996', '3052568', '浙江信海创业投资合伙企业(有限合伙)', '高德喜', '326861', '陈超', '王猛', '宁波博润创业投资股份有限公司', '19992', '南昌红土创新资本创业投资有限公司', '于洪伟', '黄海占', '逄锦波', '浙江浙科汇丰创业投资有限公司', '李世雄', '1225732', '任杰', '姚纳新', '澜海(天津)股权投资基金合伙企业(有限合伙)', '李敬华', '上海敏政投资有限公司', '上海萨洛芬投资管理有限公司', '罗运波', '张慨', '919299', '宁波海宇投资管理有限公司', '马卫东', '黄延明', '1736454', '杨斌', '387449', '412589', '浙江海邦人才创业投资合伙企业(有限合伙)', '166047', '戚永君', '宁波桑德兹实业有限公司', '884120', '石权', '胡继文', '吴钧', '浙江红土创业投资有限公司', '刘孔泉', '宁波乾元文化传播有限公司', '192177', '张巧宁', '鄂俊超', '宁波海邦人才创业投资合伙企业(有限合伙)', '宁波众元投资管理有限公司'}",277192,27,"{'439170', '254409', '14994', '1356084', '7996', '4998', '24990', '271216', '128701', '83037', '62974', '774899', '1431298', '32986', '2840594', '866784', '3052568', '326861', '19992', '1225732', '919299', '1736454', '387449', '412589', '166047', '884120', '192177'}",6,"{'张俊峰', '宁波东蓝商贸有限公司', '定价', '罗运波', '马卫东', '郎福志'}",56,"{'张俊峰', '马珍', '周天宁', '深圳市创新投资集团有限公司', '侯曙光', '李宗香', '王国忠', '陈玉敏', '王智', '徐洪涛', '郎福志', '宁波众元投资管理有限公司', '杨文华', '王勋周', '宁波东蓝商贸有限公司', '陈卫国', '定价', '朱豪轲', '任飞澜', '杨英杰', '9996', '浙江信海创业投资合伙企业(有限合伙)', '高德喜', '陈超', '王猛', '宁波博润创业投资股份有限公司', '黄海占', '于洪伟', '逄锦波', '任杰', '浙江浙科汇丰创业投资有限公司', '李世雄', '姚纳新', '澜海(天津)股权投资基金合伙企业(有限合伙)', '李敬华', '上海敏政投资有限公司', '上海萨洛芬投资管理有限公司', '罗运波', '张慨', '黄延明', '宁波海宇投资管理有限公司', '马卫东', '杨斌', '浙江海邦人才创业投资合伙企业(有限合伙)', '戚永君', '宁波桑德兹实业有限公司', '石权', '胡继文', '吴钧', '浙江红土创业投资有限公司', '刘孔泉', '宁波乾元文化传播有限公司', '张巧宁', '鄂俊超', '宁波海邦人才创业投资合伙企业(有限合伙)', '南昌红土创新资本创业投资有限公司'}"
4,"{'广晟公司', '竞价', '现金', '36'}",578519,0,set(),4,"{'广晟公司', '竞价', '现金', '36'}",4,"{'广晟公司', '竞价', '现金', '36'}"
7,"{'广发证券资产管理(广东)有限公司', '现金', '101126159', '55658627', '定价', '袁志敏', '36'}",6100962,3,"{'广发证券资产管理(广东)有限公司', '101126159', '55658627'}",4,"{'袁志敏', '36', '定价', '现金'}",4,"{'袁志敏', '36', '定价', '现金'}"
11,"{'北京中商荣盛贸易有限公司', '深圳天风天成资产管理有限公司', '26478375', '199999992.5', '8826125', '竞价', '中植产业投资有限公司', '599999977.5', '12', '200000015.2', '8826126'}",1718292,2,"{'竞价', '200000015.2'}",4,"{'北京中商荣盛贸易有限公司', '中植产业投资有限公司', '12', '深圳天风天成资产管理有限公司'}",9,"{'北京中商荣盛贸易有限公司', '深圳天风天成资产管理有限公司', '26478375', '199999992.5', '8826125', '中植产业投资有限公司', '599999977.5', '12', '8826126'}"
6,"{'现金', '184782608', '1699999994', '定价', '均瑶集团', '36'}",19217629,1,{'1699999994'},4,"{'均瑶集团', '定价', '现金', '36'}",5,"{'现金', '184782608', '定价', '均瑶集团', '36'}"
4,"{'河南投资集团有限公司', '现金', '竞价', '36'}",1167696,0,set(),4,"{'河南投资集团有限公司', '现金', '竞价', '36'}",4,"{'河南投资集团有限公司', '现金', '竞价', '36'}"
16,"{'240000010.1', '深圳前海金迪投资合伙企业(有限合伙)', '152999998.9', '13496932', '创金合信基金管理有限公司', '76999977.5', '60000006.6', '9386503', '3680982', '鹏华基金管理有限公司', '4723925', '珠海横琴大一资产管理有限公司', '泰达宏利基金管理有限公司', '14723927', '12', '219999991.6'}",1861435,3,"{'9386503', '3680982', '13496932'}",5,"{'创金合信基金管理有限公司', '鹏华基金管理有限公司', '珠海横琴大一资产管理有限公司', '泰达宏利基金管理有限公司', '12'}",13,"{'240000010.1', '深圳前海金迪投资合伙企业(有限合伙)', '152999998.9', '创金合信基金管理有限公司', '76999977.5', '60000006.6', '鹏华基金管理有限公司', '4723925', '珠海横琴大一资产管理有限公司', '泰达宏利基金管理有限公司', '14723927', '12', '219999991.6'}"
5,"{'牛奶有限公司', '现金', '5691703276', '813100468', '36'}",388214,1,{'5691703276'},3,"{'现金', '36', '牛奶有限公司'}",4,"{'813100468', '牛奶有限公司', '现金', '36'}"
4,"{'当代科技', '现金', '竞价', '36'}",18845157,1,{'竞价'},2,"{'当代科技', '现金'}",3,"{'当代科技', '现金', '36'}"
21,"{'会稽山第一期员工持股计划', '20000000', '上海大丰', '32000000', '412500000', '41250000', '3000000', '北京合聚天建', '5000000', '现金', '定价', '440000000', '68750000', '30000000', '275000000', '103125000', '7500000', '宁波信达风盛', '精功集团', '中汇同创', '36'}",1864549,7,"{'5000000', '412500000', '275000000', '41250000', '103125000', '440000000', '68750000'}",9,"{'会稽山第一期员工持股计划', '现金', '上海大丰', '宁波信达风盛', '精功集团', '中汇同创', '定价', '36', '北京合聚天建'}",14,"{'会稽山第一期员工持股计划', '20000000', '现金', '上海大丰', '宁波信达风盛', '精功集团', '中汇同创', '定价', '32000000', '3000000', '30000000', '36', '北京合聚天建', '7500000'}"
5,"{'现金', '钟百胜', '160000000', '竞价', '12'}",4956761,1,{'160000000'},4,"{'竞价', '现金', '钟百胜', '12'}",4,"{'竞价', '现金', '钟百胜', '12'}"
28,"{'3800000', '4000000', '38988000', '南昌市政公用投资控股有限责任公司', '41040000', '5000000', '25650000', '国机财务有限责任公司', '27702000', '92340000', '11000000', '竞价', '112860000', '2700000', '9000000', '无锡市新宝联投资有限公司', '51300000', '2500000', '章小格', '王东力', '20520000', '邱梅芳', '江苏瑞华投资发展有限公司', '中建材投资有限公司', '2000000', '陈伟峰', '12', '江苏开元国际集团轻工业品进出口股份有限公司'}",1155860,11,"{'25650000', '38988000', '27702000', '92340000', '112860000', '41040000', '竞价', '2700000', '51300000', '20520000', '2500000'}",11,"{'邱梅芳', '江苏瑞华投资发展有限公司', '国机财务有限责任公司', '章小格', '王东力', '南昌市政公用投资控股有限责任公司', '中建材投资有限公司', '陈伟峰', '无锡市新宝联投资有限公司', '12', '江苏开元国际集团轻工业品进出口股份有限公司'}",17,"{'3800000', '5000000', '邱梅芳', '江苏瑞华投资发展有限公司', '国机财务有限责任公司', '4000000', '章小格', '王东力', '南昌市政公用投资控股有限责任公司', '中建材投资有限公司', '11000000', '2000000', '陈伟峰', '9000000', '无锡市新宝联投资有限公司', '12', '江苏开元国际集团轻工业品进出口股份有限公司'}"
5,"{'现金', '定价', '齐心共赢计划', '石化集团', '36'}",19213144,0,set(),5,"{'现金', '定价', '齐心共赢计划', '石化集团', '36'}",5,"{'现金', '定价', '齐心共赢计划', '石化集团', '36'}"
21,"{'35800000', '35000000', '西藏自治区投资有限公司', '50000000', '山东东欣投资有限公司', '46800000', '国元证券股份有限公司', '40000000', '深圳市君益恒通投资有限公司', '41000000', '天津润丰达股权投资基金合伙企业(有限合伙)', '张凯', '重庆国际信托有限公司', '39827450', '51000000', '44000000', '长江证券股份有限公司', '朱勇', '35200000', '泰康资产管理有限责任公司', '12'}",203841,0,set(),1,{'12'},21,"{'35800000', '35000000', '西藏自治区投资有限公司', '50000000', '山东东欣投资有限公司', '46800000', '国元证券股份有限公司', '40000000', '深圳市君益恒通投资有限公司', '41000000', '天津润丰达股权投资基金合伙企业(有限合伙)', '张凯', '重庆国际信托有限公司', '39827450', '51000000', '44000000', '长江证券股份有限公司', '朱勇', '35200000', '泰康资产管理有限责任公司', '12'}"
15,"{'现金', '8456000', '15360983', '239999997.1', '55048560', '99999999.33', '金融信7号资产管理计划', '543599999', '南京紫金医药产业发展合伙企业(有限合伙)', '竞价', '南京新工投资集团有限责任公司', 'Alliance Healthcare Asia Pacific Limited', '83502304', '36866359', '36'}",19275238,3,"{'239999997.1', 'Alliance Healthcare Asia Pacific Limited', '竞价'}",2,"{'现金', '36'}",12,"{'现金', '8456000', '15360983', '55048560', '99999999.33', '金融信7号资产管理计划', '543599999', '南京紫金医药产业发展合伙企业(有限合伙)', '南京新工投资集团有限责任公司', '83502304', '36866359', '36'}"
24,"{'222575516', '110492845', '国寿安保基金管理有限公司', '申万菱信(上海)资产管理有限公司', '610000023.4', '中信建投基金管理有限公司', '现金', '前海股权投资基金(有限合伙)', '兴业全球基金管理有限公司', '699999997.8', '654999998.1', '竞价', '鹏华基金管理有限公司', '111287758', '诺安基金管理有限公司', '694999995.1', '794999993.8', '1399999996', '中欧盛世资产管理(上海)有限公司', '96979336', '126391096', '104133545', '深圳泰安尔信息技术有限公司', '12'}",14109785,4,"{'654999998.1', '1399999996', '竞价', '694999995.1'}",8,"{'现金', '兴业全球基金管理有限公司', '国寿安保基金管理有限公司', '诺安基金管理有限公司', '中信建投基金管理有限公司', '鹏华基金管理有限公司', '深圳泰安尔信息技术有限公司', '12'}",20,"{'222575516', '110492845', '现金', '前海股权投资基金(有限合伙)', '兴业全球基金管理有限公司', '699999997.8', '国寿安保基金管理有限公司', '诺安基金管理有限公司', '申万菱信(上海)资产管理有限公司', '96979336', '610000023.4', '中信建投基金管理有限公司', '126391096', '794999993.8', '鹏华基金管理有限公司', '104133545', '中欧盛世资产管理(上海)有限公司', '111287758', '深圳泰安尔信息技术有限公司', '12'}"
5,"{'现金', '中农发集团', '60000000', '竞价', '36'}",1453554,2,"{'竞价', '60000000'}",3,"{'现金', '中农发集团', '36'}",3,"{'现金', '中农发集团', '36'}"
5,"{'124740125', '现金', '定价', '宁夏宝塔石化集团有限公司', '36'}",79758,0,set(),4,"{'现金', '定价', '宁夏宝塔石化集团有限公司', '36'}",5,"{'124740125', '现金', '定价', '宁夏宝塔石化集团有限公司', '36'}"
14,"{'20000000', '陈亮', '现金', '滇中集团', '中瑞物流', '国鼎投资', '九天工贸', '49933994', '工投集团', '禾溪投资', '30000000', '36', '406033003', '330033003'}",350357,0,set(),9,"{'陈亮', '现金', '滇中集团', '中瑞物流', '国鼎投资', '九天工贸', '工投集团', '禾溪投资', '36'}",14,"{'20000000', '陈亮', '现金', '滇中集团', '中瑞物流', '国鼎投资', '九天工贸', '49933994', '工投集团', '禾溪投资', '30000000', '36', '406033003', '330033003'}"
7,"{'富贵千金', '现金', '17271157', '定价', '25906736', '株洲国投', '36'}",359875,2,"{'25906736', '17271157'}",5,"{'富贵千金', '现金', '定价', '株洲国投', '36'}",5,"{'富贵千金', '现金', '定价', '株洲国投', '36'}"
18,"{'光大证券股份有限公司', '现金', '北京中亿邦经贸有限公司', '上海灵器工贸有限公司', '8000000', '5000000', '杭州清雅网络科技有限公司', '长盛基金管理有限公司', '长江证券有限责任公司', '9000000', '中信基金管理有限责任公司', '3000000', '揭阳市鸿凯贸易发展公司', '6000000', '10000000', '北京格林沃德营养保健品有限公司', '12', '深圳市银信宝投资发展有限公司'}",1373223,0,set(),11,"{'光大证券股份有限公司', '北京中亿邦经贸有限公司', '现金', '上海灵器工贸有限公司', '杭州清雅网络科技有限公司', '长盛基金管理有限公司', '长江证券有限责任公司', '中信基金管理有限责任公司', '揭阳市鸿凯贸易发展公司', '北京格林沃德营养保健品有限公司', '12'}",18,"{'光大证券股份有限公司', '现金', '北京中亿邦经贸有限公司', '上海灵器工贸有限公司', '8000000', '5000000', '杭州清雅网络科技有限公司', '长盛基金管理有限公司', '长江证券有限责任公司', '9000000', '中信基金管理有限责任公司', '3000000', '揭阳市鸿凯贸易发展公司', '6000000', '10000000', '北京格林沃德营养保健品有限公司', '12', '深圳市银信宝投资发展有限公司'}"
31,"{'江苏彩浩投资有限公司', '16000000', '659785800', '229020000', '124711800', '6500000', '140639100', '现金', '达孜县恒隆股权投资合伙企业(有限合伙)', '216632100', '定价', '11980000', '20790000', '南通琦艺投资有限公司', '759930000', '达孜县恒盛股权投资合伙企业(有限合伙)', '南通泓翔股权投资合伙企业(有限合伙)', '13510000', '67665000', '216423900', '商赢控股有限公司', '旭森国际控股(集团)有限公司', '20810000', '青岛盈和投资合伙企业(有限合伙)', '63380000', '江苏隆明投资有限公司', '22000000', '166560000', '73000000', '旭源投资有限公司', '36'}",14878362,10,"{'759930000', '659785800', '216632100', '229020000', '124711800', '166560000', '6500000', '140639100', '67665000', '216423900'}",8,"{'江苏彩浩投资有限公司', '现金', '南通琦艺投资有限公司', '商赢控股有限公司', '定价', '江苏隆明投资有限公司', '旭源投资有限公司', '36'}",21,"{'江苏彩浩投资有限公司', '16000000', '现金', '达孜县恒隆股权投资合伙企业(有限合伙)', '定价', '11980000', '20790000', '南通琦艺投资有限公司', '达孜县恒盛股权投资合伙企业(有限合伙)', '南通泓翔股权投资合伙企业(有限合伙)', '13510000', '旭森国际控股(集团)有限公司', '商赢控股有限公司', '20810000', '青岛盈和投资合伙企业(有限合伙)', '63380000', '江苏隆明投资有限公司', '22000000', '73000000', '旭源投资有限公司', '36'}"
12,"{'上海兴富创业投资管理中心(有限合伙)', '35460775', '现金', '黄文乐', '定价', '黄文喜', '24930748', '4155125', '256026800', '180000000', '30000000', '36'}",1815666,7,"{'上海兴富创业投资管理中心(有限合伙)', '35460775', '4155125', '24930748', '256026800', '180000000', '30000000'}",5,"{'现金', '黄文乐', '定价', '黄文喜', '36'}",5,"{'现金', '黄文乐', '定价', '黄文喜', '36'}"
4,"{'36', '贵州乌江水电开发有限责任公司', '现金', '74626865'}",1369157,0,set(),3,"{'贵州乌江水电开发有限责任公司', '现金', '36'}",4,"{'36', '现金', '74626865', '贵州乌江水电开发有限责任公司'}"
19,"{'12000000', '现金', '370290200', '上海紫澜门投资有限公司', '宏源证券股份有限公司', '中邮创业基金管理有限公司', '西安飞机工业(集团)有限责任公司', '12', '定价', '25500000', '长盛基金管理有限公司', '上海大正投资有限公司', '深圳兴创业投资(集团)有限公司', '25000000', '上海民晟投资有限公司', '10000000', '股权', '36', '海富通基金管理有限公司'}",815588,0,set(),4,"{'定价', '现金', '股权', '12'}",19,"{'12000000', '现金', '370290200', '上海紫澜门投资有限公司', '宏源证券股份有限公司', '中邮创业基金管理有限公司', '西安飞机工业(集团)有限责任公司', '12', '长盛基金管理有限公司', '25500000', '定价', '上海大正投资有限公司', '深圳兴创业投资(集团)有限公司', '25000000', '上海民晟投资有限公司', '10000000', '股权', '36', '海富通基金管理有限公司'}"
21,"{'申万菱信(上海)资产管理有限公司', '120000086', '南方基金管理有限公司', '45699925.75', '119999995.8', '现金', '103052631', '168299995.5', '兴业全球基金管理有限公司', '定价', '财通基金管理有限公司', '239999996.3', '景顺长城基金管理有限公司', '25263176', '50526315', '9621037', '35431578', '489499997.3', '华宝信托有限责任公司', '25263157', '12'}",286979,4,"{'119999995.8', '45699925.75', '239999996.3', '489499997.3'}",8,"{'景顺长城基金管理有限公司', '现金', '兴业全球基金管理有限公司', '定价', '财通基金管理有限公司', '华宝信托有限责任公司', '南方基金管理有限公司', '12'}",17,"{'景顺长城基金管理有限公司', '现金', '9621037', '103052631', '168299995.5', '25263176', '兴业全球基金管理有限公司', '35431578', '申万菱信(上海)资产管理有限公司', '定价', '财通基金管理有限公司', '50526315', '华宝信托有限责任公司', '120000086', '南方基金管理有限公司', '25263157', '12'}"
13,"{'平安大华基金管理有限公司', '8620689', '79999993.92', '定价', '财通基金管理有限公司', '85999996.48', '东吴证券股份有限公司', '申万菱信基金管理有限公司', '9267241', '7974140', '74000019.2', '12', '泓德基金管理有限公司'}",14663598,2,"{'79999993.92', '85999996.48'}",2,"{'定价', '12'}",11,"{'平安大华基金管理有限公司', '8620689', '定价', '财通基金管理有限公司', '东吴证券股份有限公司', '申万菱信基金管理有限公司', '9267241', '7974140', '74000019.2', '12', '泓德基金管理有限公司'}"
4,"{'竞价', '股权', '36', '广州发展集团有限公司'}",505992,1,{'竞价'},2,"{'股权', '广州发展集团有限公司'}",3,"{'股权', '36', '广州发展集团有限公司'}"
11,"{'平安大华基金管理有限公司', '现金', '第一创业证券股份有限公司', '富国资产管理(上海)有限公司', '国机财务有限责任公司', '29号法定代表人', '财通基金管理有限公司', '竞价', '常州投资集团有限公司', '民生通惠资产管理有限公司', '12'}",10789463,3,"{'竞价', '29号法定代表人', '富国资产管理(上海)有限公司'}",8,"{'平安大华基金管理有限公司', '现金', '第一创业证券股份有限公司', '国机财务有限责任公司', '财通基金管理有限公司', '常州投资集团有限公司', '民生通惠资产管理有限公司', '12'}",8,"{'平安大华基金管理有限公司', '现金', '第一创业证券股份有限公司', '国机财务有限责任公司', '财通基金管理有限公司', '常州投资集团有限公司', '民生通惠资产管理有限公司', '12'}"
4,"{'36', '竞价', '现金', '刘梦龙'}",14663062,0,set(),4,"{'36', '竞价', '现金', '刘梦龙'}",4,"{'36', '竞价', '现金', '刘梦龙'}"
8,"{'45260726', '邯矿集团', '峰峰集团', '93558477', '竞价', '张矿集团', '229670366', '36'}",51048,1,{'竞价'},4,"{'峰峰集团', '张矿集团', '36', '邯矿集团'}",7,"{'45260726', '邯矿集团', '峰峰集团', '93558477', '张矿集团', '229670366', '36'}"
5,"{'现金', '丹化集团', '250000000', '竞价', '36'}",277829,1,{'250000000'},4,"{'36', '竞价', '现金', '丹化集团'}",4,"{'36', '竞价', '现金', '丹化集团'}"
10,"{'现金', '江信基金管理有限公司', '6394707', '251999991.1', '北京赛德特资产管理有限责任公司', '国美控股集团有限公司', '57999992.49', '竞价', '27783902', '36'}",15710390,2,"{'竞价', '57999992.49'}",5,"{'现金', '江信基金管理有限公司', '国美控股集团有限公司', '北京赛德特资产管理有限责任公司', '36'}",8,"{'现金', '江信基金管理有限公司', '6394707', '251999991.1', '北京赛德特资产管理有限责任公司', '国美控股集团有限公司', '27783902', '36'}"
17,"{'广州市国资委', '5499999991', '现金', '广州交投', '广州国发', '585106382', '2499999992', '249999993.6', '265957446', '万力集团', '广州城投', '广州地铁', '999999993.2', '广州电气装备', '26595744', '106382978', '36'}",302348,1,{'5499999991'},9,"{'广州市国资委', '现金', '广州交投', '广州国发', '万力集团', '广州城投', '广州地铁', '广州电气装备', '36'}",16,"{'广州市国资委', '现金', '广州交投', '广州国发', '585106382', '2499999992', '249999993.6', '265957446', '万力集团', '广州城投', '广州地铁', '999999993.2', '广州电气装备', '26595744', '106382978', '36'}"
20,"{'12000000', '87360000', '现金', '深圳市创新资本投资有限公司', '大成基金管理有限公司', '74880000', '国华人寿保险股份有限公司', '99840000', '东海基金管理有限责任公司', '长江证券股份有限公司', '124800000', '21000000', '18000000', '195520000', '49920000', '47000000', '30000000', '12', '24000000', '东海证券有限责任公司'}",1183086,8,"{'12000000', '87360000', '74880000', '99840000', '49920000', '124800000', '195520000', '24000000'}",8,"{'现金', '深圳市创新资本投资有限公司', '大成基金管理有限公司', '国华人寿保险股份有限公司', '东海基金管理有限责任公司', '长江证券股份有限公司', '12', '东海证券有限责任公司'}",12,"{'现金', '深圳市创新资本投资有限公司', '大成基金管理有限公司', '国华人寿保险股份有限公司', '18000000', '东海基金管理有限责任公司', '长江证券股份有限公司', '21000000', '47000000', '30000000', '12', '东海证券有限责任公司'}"
5,"{'定价', '中材股份', '债权、现金', '1135130000', '36'}",5232577,2,"{'1135130000', '债权、现金'}",3,"{'定价', '中材股份', '36'}",3,"{'定价', '中材股份', '36'}"
17,"{'开源投资', '现金', '众禄金融控股', '先盛投资', '长城国融', '债权、现金', '299999997.4', '64216867', '499999992.9', '铁路基金', '竞价', '332999992.3', '36144578', '40120481', '532999996.1', '36', '60240963'}",1872872,2,"{'竞价', '债权、现金'}",7,"{'开源投资', '现金', '众禄金融控股', '先盛投资', '长城国融', '铁路基金', '36'}",15,"{'开源投资', '现金', '众禄金融控股', '先盛投资', '长城国融', '299999997.4', '64216867', '499999992.9', '铁路基金', '332999992.3', '36144578', '40120481', '532999996.1', '36', '60240963'}"
4,"{'竞价', '现金', '36', '海南筑华科工贸有限公司'}",887699,0,set(),4,"{'竞价', '现金', '36', '海南筑华科工贸有限公司'}",4,"{'竞价', '现金', '36', '海南筑华科工贸有限公司'}"
26,"{'红土创新基金管理有限公司', '84999992.88', '11822059', '现金', '7921998', '129999987.2', '兴业全球基金管理有限公司', '财通基金管理有限公司', '竞价', '85038146.13', '东吴证券股份有限公司', '5182093', '88499999.73', '193999988.2', '5179768', '36', '5971968', '5170225', '诺安基金管理有限公司', '东海基金管理有限责任公司', '上海沪瑞实业有限公司', '5393053', '84843392.25', '12', '97999994.88', '汇安基金管理有限责任公司'}",14663218,3,"{'竞价', '129999987.2', '193999988.2'}",6,"{'现金', '12', '诺安基金管理有限公司', '财通基金管理有限公司', '上海沪瑞实业有限公司', '36'}",23,"{'红土创新基金管理有限公司', '84999992.88', '11822059', '现金', '7921998', '兴业全球基金管理有限公司', '财通基金管理有限公司', '85038146.13', '东吴证券股份有限公司', '5182093', '88499999.73', '5179768', '36', '5971968', '5170225', '诺安基金管理有限公司', '东海基金管理有限责任公司', '上海沪瑞实业有限公司', '5393053', '84843392.25', '12', '97999994.88', '汇安基金管理有限责任公司'}"
30,"{'20000000', '166600000', '16340000', '305794300', '2400000', '36710000', '济南沃达投资合伙企业(有限合伙)', '现金', '36000000', '216580000', '73304000', '南通中南工业投资有限责任公司', '136112200', '上海宝聿股权投资合伙企业(有限合伙)', '150000000', '上海福天投资有限公司', '231157500', '东营广进投资合伙企业(有限合伙)', '1249500000', '长沙泓泽资产管理有限公司', '8800000', '东海基金资产管理计划', '湖南深泰虹科技有限公司', '湖南郑可投资管理合伙企业(有限合伙)', '27750000', '299880000', '湖南高新创投太白投资企业(有限合伙)', '26000000', '19992000', '36'}",1027578,18,"{'20000000', '150000000', '27750000', '36000000', '216580000', '299880000', '73304000', '231157500', '16340000', '166600000', '1249500000', '305794300', '2400000', '26000000', '19992000', '8800000', '136112200', '36710000'}",4,"{'东海基金资产管理计划', '现金', '36', '长沙泓泽资产管理有限公司'}",12,"{'湖南郑可投资管理合伙企业(有限合伙)', '上海福天投资有限公司', '济南沃达投资合伙企业(有限合伙)', '现金', '东营广进投资合伙企业(有限合伙)', '湖南高新创投太白投资企业(有限合伙)', '南通中南工业投资有限责任公司', '长沙泓泽资产管理有限公司', '上海宝聿股权投资合伙企业(有限合伙)', '东海基金资产管理计划', '湖南深泰虹科技有限公司', '36'}"
12,"{'1188287360', '现金', '296891078.6', '前海新旺兆', '定价', '30356961', '43821558.96', '汇通正源', '121501775', '4480732', '陈永弟', '36'}",4923227,3,"{'1188287360', '296891078.6', '43821558.96'}",6,"{'现金', '前海新旺兆', '定价', '汇通正源', '陈永弟', '36'}",9,"{'现金', '前海新旺兆', '定价', '30356961', '汇通正源', '121501775', '4480732', '陈永弟', '36'}"
8,"{'信宏融金', '现金', '40000000', '100000000', '684000000', '大唐盈泰', '36', '273600000'}",680040,4,"{'100000000', '40000000', '273600000', '684000000'}",4,"{'信宏融金', '大唐盈泰', '现金', '36'}",4,"{'信宏融金', '大唐盈泰', '现金', '36'}"
14,"{'10162601', '现金', '大连高金科技发展有限公司', '中合中小企业融资担保股份有限公司', '宣家鑫', '100000000', '3048780', '定价', '上海猜特投资管理中心(有限合伙)', '250000000', '西藏世纪融通投资管理合伙企业(有限合伙)', '30000000', '36', '25406504'}",4936863,0,set(),6,"{'现金', '大连高金科技发展有限公司', '宣家鑫', '中合中小企业融资担保股份有限公司', '定价', '36'}",14,"{'10162601', '现金', '大连高金科技发展有限公司', '中合中小企业融资担保股份有限公司', '宣家鑫', '100000000', '3048780', '定价', '上海猜特投资管理中心(有限合伙)', '250000000', '西藏世纪融通投资管理合伙企业(有限合伙)', '30000000', '36', '25406504'}"
5,"{'150000000', '现金', '竞价', '叶林富', '36'}",580853,1,{'150000000'},4,"{'竞价', '现金', '叶林富', '36'}",4,"{'竞价', '现金', '叶林富', '36'}"
4,"{'36', '竞价', '现金', '浙江围海控股集团有限公司'}",1756715,0,set(),4,"{'36', '竞价', '现金', '浙江围海控股集团有限公司'}",4,"{'竞价', '现金', '浙江围海控股集团有限公司', '36'}"
14,"{'30999988.24', '2464228', '泰达宏利基金管理有限公司', '财通基金管理有限公司', '361999979.1', '竞价', '77503974', '974999992.9', '28775833', '3179650', '建信基金管理有限责任公司', '12', '39999997', '红塔红土基金管理有限公司'}",15372792,2,"{'30999988.24', '竞价'}",5,"{'财通基金管理有限公司', '泰达宏利基金管理有限公司', '建信基金管理有限责任公司', '12', '红塔红土基金管理有限公司'}",12,"{'2464228', '泰达宏利基金管理有限公司', '财通基金管理有限公司', '361999979.1', '77503974', '974999992.9', '28775833', '3179650', '建信基金管理有限责任公司', '12', '39999997', '红塔红土基金管理有限公司'}"
20,"{'平安大华基金管理有限公司', '218999997.9', '35901639', '36065573', '北信瑞丰基金管理有限公司', '现代种业发展基金有限公司', '554999996.6', '90983606', '30983606', '信诚基金管理有限公司', '九泰基金管理有限公司', '26617904', '财通基金管理有限公司', '219999995.3', '162369214.4', '27868852', '广西铁路发展投资基金(有限合伙)', '12', '169999997.2', '188999996.6'}",15626990,0,set(),7,"{'平安大华基金管理有限公司', '北信瑞丰基金管理有限公司', '现代种业发展基金有限公司', '九泰基金管理有限公司', '信诚基金管理有限公司', '财通基金管理有限公司', '12'}",20,"{'平安大华基金管理有限公司', '218999997.9', '35901639', '36065573', '北信瑞丰基金管理有限公司', '现代种业发展基金有限公司', '554999996.6', '90983606', '30983606', '信诚基金管理有限公司', '九泰基金管理有限公司', '26617904', '财通基金管理有限公司', '219999995.3', '162369214.4', '27868852', '广西铁路发展投资基金(有限合伙)', '12', '169999997.2', '188999996.6'}"
18,"{'平安大华基金管理有限公司', '559999991.1', '金鹰基金管理有限公司', '13579049', '224999996.3', '兴业全球基金管理有限公司', '兴证证券资产管理有限公司', '139999995.2', '东海基金管理有限责任公司', '财通基金管理有限公司', '5043650', '140999993', '山东省农村经济开发投资公司', '13676042', '52000031.5', '12', '54316197', '21823472'}",389014,2,"{'559999991.1', '139999995.2'}",8,"{'平安大华基金管理有限公司', '金鹰基金管理有限公司', '兴证证券资产管理有限公司', '兴业全球基金管理有限公司', '东海基金管理有限责任公司', '财通基金管理有限公司', '山东省农村经济开发投资公司', '12'}",16,"{'平安大华基金管理有限公司', '金鹰基金管理有限公司', '13579049', '224999996.3', '兴业全球基金管理有限公司', '兴证证券资产管理有限公司', '东海基金管理有限责任公司', '财通基金管理有限公司', '5043650', '140999993', '山东省农村经济开发投资公司', '13676042', '52000031.5', '12', '54316197', '21823472'}"
5,"{'329670000', '现金', '定价', '四川国栋建设集团有限公司', '36'}",1554389,2,"{'329670000', '定价'}",3,"{'四川国栋建设集团有限公司', '现金', '36'}",3,"{'四川国栋建设集团有限公司', '现金', '36'}"
5,"{'现金', '250000000', '竞价', '中航科工', '36'}",574081,1,{'250000000'},4,"{'36', '竞价', '现金', '中航科工'}",4,"{'36', '竞价', '现金', '中航科工'}"
7,"{'现金', '中国恒天', '中国纺机', '债权', '竞价', '300000000', '36'}",1235808,1,{'300000000'},6,"{'现金', '中国恒天', '中国纺机', '债权', '竞价', '36'}",6,"{'现金', '中国恒天', '中国纺机', '债权', '竞价', '36'}"
17,"{'6000000', '现金', '3300000', '定价', '中国东方资产管理有限公司', '4400000', '上海昊益实业有限公司', '比尔及梅林达—盖茨基金会( Bill& Melinda Gates Foundation Trust)', '易方达基金管理有限公司', '国泰基金管理有限公司', '林淑芳', '3000000', '6500000', '3100000', '2121327', '张建斌', '12'}",1503602,1,{'比尔及梅林达—盖茨基金会( Bill& Melinda Gates Foundation Trust)'},5,"{'现金', '定价', '林淑芳', '张建斌', '12'}",16,"{'6000000', '现金', '3300000', '4400000', '中国东方资产管理有限公司', '定价', '上海昊益实业有限公司', '林淑芳', '易方达基金管理有限公司', '国泰基金管理有限公司', '3000000', '6500000', '3100000', '2121327', '张建斌', '12'}"
4,"{'现金', '148167590', '36', '吴宏亮'}",15557869,1,{'148167590'},3,"{'现金', '36', '吴宏亮'}",3,"{'现金', '36', '吴宏亮'}"
18,"{'烽火科技集团有限公司', '36', '现金', '北信瑞丰基金管理有限公司', '九泰基金管理有限公司', '17163334', '信诚基金管理有限公司', '6797435', '定价', '8977744', '嘉实基金管理有限公司', '财通基金管理有限公司', '14711429', '4481330', '中信证券股份有限公司', '6789890', '12', '9053187'}",16725116,0,set(),5,"{'烽火科技集团有限公司', '现金', '12', '定价', '36'}",18,"{'烽火科技集团有限公司', '36', '现金', '北信瑞丰基金管理有限公司', '九泰基金管理有限公司', '17163334', '信诚基金管理有限公司', '6797435', '8977744', '定价', '嘉实基金管理有限公司', '财通基金管理有限公司', '14711429', '4481330', '中信证券股份有限公司', '6789890', '12', '9053187'}"
16,"{'44879940', '5898200', '现金', '兴全睿众定增3号特定多客户专项资产管理计划', '4130000', '李建林', '定价', '东方证券股份有限公司', '1860000', '5859000', '三川股份第1期员工持股计划', '770000', '14247600', '31635800', '江西三川集团有限公司', '36'}",1732815,4,"{'14247600', '44879940', '5898200', '31635800'}",6,"{'现金', '李建林', '定价', '东方证券股份有限公司', '江西三川集团有限公司', '36'}",12,"{'现金', '兴全睿众定增3号特定多客户专项资产管理计划', '4130000', '李建林', '定价', '东方证券股份有限公司', '1860000', '5859000', '三川股份第1期员工持股计划', '770000', '江西三川集团有限公司', '36'}"
6,"{'现金', '天通高新集团有限公司', '50000000', '10000000', '36', '杜海利'}",409057,1,{'10000000'},4,"{'现金', '36', '杜海利', '天通高新集团有限公司'}",5,"{'现金', '天通高新集团有限公司', '50000000', '36', '杜海利'}"
17,"{'252000', '36', '周叙元', '216000', '30600000', '朱弘', '1800000', '常州高新技术产业开发区常能电器有限公司', '竞价', '朱明', '胡金花', '范沛菁', '2052000', '周康直', '金源苏', '朱峰', '常州市泓丰投资管理有限公司'}",1258745,6,"{'252000', '216000', '30600000', '1800000', '竞价', '2052000'}",11,"{'36', '周叙元', '朱弘', '朱明', '常州高新技术产业开发区常能电器有限公司', '胡金花', '范沛菁', '周康直', '金源苏', '朱峰', '常州市泓丰投资管理有限公司'}",11,"{'36', '周叙元', '朱弘', '朱明', '常州高新技术产业开发区常能电器有限公司', '胡金花', '范沛菁', '周康直', '金源苏', '朱峰', '常州市泓丰投资管理有限公司'}"
8,"{'现金', '99798300', '深圳秋石资产管理有限公司拟筹建和管理的股权投资基金', '499121700', '76670000', '15330000', '黄作庆', '36'}",344210,4,"{'15330000', '99798300', '499121700', '76670000'}",4,"{'36', '深圳秋石资产管理有限公司拟筹建和管理的股权投资基金', '黄作庆', '现金'}",4,"{'现金', '深圳秋石资产管理有限公司拟筹建和管理的股权投资基金', '黄作庆', '36'}"
5,"{'现金', '钟百胜', '160000000', '竞价', '12'}",1657724,1,{'160000000'},4,"{'竞价', '现金', '钟百胜', '12'}",4,"{'竞价', '现金', '钟百胜', '12'}"
16,"{'150000000', '何东翰', '现金', '600000000', '48275862', '350000000', '27586206', '新华联控股', '海慧科技', '竞价', '延万华', '20689655', '200000000', '36', '杜玉岱', '82758620'}",2048282,4,"{'350000000', '竞价', '200000000', '600000000'}",7,"{'何东翰', '现金', '海慧科技', '新华联控股', '延万华', '36', '杜玉岱'}",12,"{'150000000', '何东翰', '现金', '27586206', '48275862', '新华联控股', '海慧科技', '延万华', '20689655', '36', '杜玉岱', '82758620'}"
6,"{'现金', '定价', '250800000', '11000000', '颜军', '36'}",1578462,2,"{'11000000', '250800000'}",4,"{'定价', '颜军', '现金', '36'}",4,"{'36', '颜军', '定价', '现金'}"
5,"{'华宸未来基金管理有限公司', '18018018', '36036036', '北京千石创富资本管理有限公司', '36'}",1130188,0,set(),3,"{'华宸未来基金管理有限公司', '北京千石创富资本管理有限公司', '36'}",5,"{'华宸未来基金管理有限公司', '18018018', '36036036', '北京千石创富资本管理有限公司', '36'}"
18,"{'151760193.9', '深圳市和星信息投资管理中心(有限合伙)', '现金', '18885726', '151160195.2', '744561115.2', '定价', '申万菱信(上海)资产管理有限公司', '东海基金管理有限责任公司', '财通基金管理有限公司', '9388832', '304060188.6', '160060194.7', '46246032', '9426099', '9941627', '12', '西藏泓涵股权投资管理有限公司'}",14671272,0,set(),5,"{'现金', '定价', '财通基金管理有限公司', '12', '西藏泓涵股权投资管理有限公司'}",18,"{'151760193.9', '深圳市和星信息投资管理中心(有限合伙)', '现金', '18885726', '151160195.2', '744561115.2', '定价', '申万菱信(上海)资产管理有限公司', '东海基金管理有限责任公司', '财通基金管理有限公司', '9388832', '304060188.6', '160060194.7', '46246032', '9426099', '9941627', '12', '西藏泓涵股权投资管理有限公司'}"
7,"{'杭州阿里创业投资有限公司', '上海光线投资控股有限公司', '16515277', '2399999981', '99091659', '400000008.9', '12'}",101887,1,{'2399999981'},1,{'12'},6,"{'杭州阿里创业投资有限公司', '上海光线投资控股有限公司', '16515277', '99091659', '400000008.9', '12'}"
27,"{'深圳君佑', '令西普', '300000', '7000000', '新疆协和', '中航产投', '200000000', '17820000', '现金', '2430000', '中航机电', '400000000', '300000000', '56700000', '陈根龙', '3750000', '30375000', '李明斌', '东莞中科', '500000', '37037037', '49382716', '2200000', '广东融易', '24691358', '4050000', '36'}",307737,7,"{'2430000', '400000000', '30375000', '4050000', '300000000', '56700000', '17820000'}",12,"{'现金', '中航机电', '深圳君佑', '广东融易', '李明斌', '令西普', '东莞中科', '500000', '新疆协和', '中航产投', '陈根龙', '36'}",20,"{'49382716', '现金', '3750000', '中航机电', '深圳君佑', '广东融易', '2200000', '李明斌', '24691358', '东莞中科', '令西普', '7000000', '37037037', '中航产投', '新疆协和', '300000', '500000', '200000000', '陈根龙', '36'}"
4,"{'现金', '定价', '36', '中国平安人寿保险股份有限公司'}",1082388,1,{'36'},3,"{'定价', '现金', '中国平安人寿保险股份有限公司'}",3,"{'定价', '现金', '中国平安人寿保险股份有限公司'}"
22,"{'中车金证投资有限公司', '江苏一带一路投资基金(有限合伙)', '99999984', '87999942', '易方达基金管理有限公司', '泰达宏利基金管理有限公司', '现金', '中融基金管理有限公司', '2377049', '定价', '1442622', '中广核财务有限责任公司', '鹏华基金管理有限公司', '442627', '144999989', '143999955', '2360655', '1639344', '27000247', '泓德基金管理有限公司', '四川三新创业投资有限责任公司', '12'}",16919470,0,set(),3,"{'定价', '现金', '12'}",22,"{'中车金证投资有限公司', '江苏一带一路投资基金(有限合伙)', '99999984', '87999942', '易方达基金管理有限公司', '泰达宏利基金管理有限公司', '现金', '中融基金管理有限公司', '2377049', '定价', '1442622', '中广核财务有限责任公司', '鹏华基金管理有限公司', '442627', '144999989', '143999955', '2360655', '1639344', '27000247', '泓德基金管理有限公司', '四川三新创业投资有限责任公司', '12'}"
23,"{'12000000', '中国物资储运总公司', '浙江中大集团股份有限公司', '南方基金管理有限公司', '现金', '247500000', '天津信托有限责任公司', '11000000', '10000000', '96000000', '36', '88000000', '15000000', '中信证券股份有限公司', '120000000', '国联证券股份有限公司', '30937500', '25500000', '东吴证券有限责任公司', '3187500', '80000000', '12', '丁坚'}",1448420,6,"{'96000000', '88000000', '247500000', '25500000', '3187500', '80000000'}",7,"{'12000000', '现金', '中国物资储运总公司', '12', '120000000', '南方基金管理有限公司', '36'}",17,"{'12000000', '现金', '中国物资储运总公司', '天津信托有限责任公司', '12', '30937500', '浙江中大集团股份有限公司', '15000000', '11000000', '中信证券股份有限公司', '120000000', '东吴证券有限责任公司', '南方基金管理有限公司', '10000000', '36', '国联证券股份有限公司', '丁坚'}"
15,"{'49018186', '现金', '1989601.92', '定价', '3774656', '99480002.88', '570571694', '蒋亨福', '深圳市方德智联投资管理有限公司', '吴美莉', '43936995.84', '8546392', '170928', '吴国仕', '36'}",1934648,4,"{'1989601.92', '99480002.88', '43936995.84', '570571694'}",7,"{'现金', '定价', '蒋亨福', '深圳市方德智联投资管理有限公司', '吴美莉', '吴国仕', '36'}",11,"{'49018186', '现金', '定价', '3774656', '蒋亨福', '深圳市方德智联投资管理有限公司', '吴美莉', '8546392', '170928', '吴国仕', '36'}"
8,"{'现金', '福建建工集团总公司', '泰禾金控(平潭)集团有限公司', '27112000', '440841100', '110210300', '6778000', '36'}",15624850,5,"{'泰禾金控(平潭)集团有限公司', '27112000', '440841100', '110210300', '6778000'}",3,"{'现金', '福建建工集团总公司', '36'}",3,"{'现金', '福建建工集团总公司', '36'}"
9,"{'云南省工业投资控股集团有限责任公司', '5000000', '现金', '81800000', '南天电子信息产业集团公司', '竞价', '40900000', '10000000', '36'}",676051,3,"{'竞价', '40900000', '81800000'}",4,"{'云南省工业投资控股集团有限责任公司', '南天电子信息产业集团公司', '现金', '36'}",6,"{'云南省工业投资控股集团有限责任公司', '5000000', '现金', '南天电子信息产业集团公司', '10000000', '36'}"
17,"{'12000000', '5000000', '8000000', '华夏基金管理有限公司', '三一集团有限责任公司', '杭州恒富通实业有限公司', '7000000', '北京环球银证投资顾问有限公司', '红塔证券股份有限公司', '常州投资集团有限公司', '常熟万兴化工有限公司', '中银国际基金管理有限公司', '中融国际信托投资有限公司', '江西国际信托投资股份有限公司', '10000000', '12', '7500000'}",1534199,0,set(),1,{'12'},17,"{'12000000', '5000000', '8000000', '华夏基金管理有限公司', '三一集团有限责任公司', '杭州恒富通实业有限公司', '7000000', '北京环球银证投资顾问有限公司', '红塔证券股份有限公司', '常州投资集团有限公司', '常熟万兴化工有限公司', '中银国际基金管理有限公司', '中融国际信托投资有限公司', '江西国际信托投资股份有限公司', '10000000', '12', '7500000'}"
21,"{'1104649991', '39269300', '87719298', '上海汽车工业(集团)总公司', '上汽集团核心员工持股计划', '广东恒健投资控股有限公司', '华融汇通资产管理有限公司', '现金', '131578947', '36', '2999999992', '平安资产管理有限责任公司', '87719736', '48449561', '河北港口集团有限公司', '895340040', '中原股权投资管理有限公司', '1999999994', '2000009981', '民生通惠资产管理有限公司', '12'}",15663122,3,"{'1104649991', '2999999992', '2000009981'}",10,"{'华融汇通资产管理有限公司', '36', '现金', '上汽集团核心员工持股计划', '河北港口集团有限公司', '平安资产管理有限责任公司', '中原股权投资管理有限公司', '广东恒健投资控股有限公司', '民生通惠资产管理有限公司', '12'}",18,"{'华融汇通资产管理有限公司', '131578947', '48449561', '39269300', '现金', '上汽集团核心员工持股计划', '河北港口集团有限公司', '87719298', '12', '895340040', '平安资产管理有限责任公司', '上海汽车工业(集团)总公司', '中原股权投资管理有限公司', '87719736', '广东恒健投资控股有限公司', '1999999994', '民生通惠资产管理有限公司', '36'}"
7,"{'20000000', '贾虹', '现金', '定价', '刘磅', '27000000', '36'}",908099,2,"{'20000000', '27000000'}",5,"{'贾虹', '现金', '定价', '刘磅', '36'}",5,"{'36', '现金', '定价', '刘磅', '贾虹'}"
9,"{'金花投资控股集团有限公司', '现金', '4516472', '定价', '920775000', '42500000', '金花1号定向资产管理计划', '97850690', '36'}",4952919,2,"{'920775000', '42500000'}",5,"{'金花投资控股集团有限公司', '现金', '定价', '金花1号定向资产管理计划', '36'}",7,"{'金花投资控股集团有限公司', '现金', '4516472', '定价', '金花1号定向资产管理计划', '97850690', '36'}"
3,"{'中国东方航空集团公司', '现金', '36'}",311876,0,set(),3,"{'中国东方航空集团公司', '现金', '36'}",3,"{'中国东方航空集团公司', '现金', '36'}"
3,"{'现金', '36', '无锡产业发展集团有限公司'}",1209463,0,set(),3,"{'现金', '36', '无锡产业发展集团有限公司'}",3,"{'现金', '36', '无锡产业发展集团有限公司'}"
6,"{'现金', '12', '竞价', '其他特定发行对象', '东方电气集团', '36'}",1262087,1,{'竞价'},5,"{'现金', '12', '其他特定发行对象', '东方电气集团', '36'}",5,"{'36', '现金', '其他特定发行对象', '东方电气集团', '12'}"
8,"{'现金', '4500000', '赵小强', '11800000', '郭瑞', '比因美特', '1000000', '36'}",342844,3,"{'11800000', '4500000', '1000000'}",5,"{'现金', '赵小强', '郭瑞', '比因美特', '36'}",5,"{'现金', '赵小强', '郭瑞', '比因美特', '36'}"
16,"{'现金', '工银瑞信基金管理有限公司', '华泰资产管理有限公司受托管理前海人寿保险股份有限公司-自有资金华泰组合', '12', '174855528.2', '15700000', '丹东东方新能源有限公司', '竞价', '26300000', '164638000', '长信基金管理有限责任公司', '23800000', '27932193', '98282000', '148988000', '36'}",992487,1,{'174855528.2'},4,"{'竞价', '现金', '12', '丹东东方新能源有限公司'}",15,"{'现金', '工银瑞信基金管理有限公司', '华泰资产管理有限公司受托管理前海人寿保险股份有限公司-自有资金华泰组合', '12', '15700000', '丹东东方新能源有限公司', '竞价', '26300000', '164638000', '长信基金管理有限责任公司', '23800000', '27932193', '98282000', '148988000', '36'}"
21,"{'上海金桥(集团)有限公司', '5338078', '西藏自治区投资有限公司', '中信建投基金管理有限公司', '3219248', '现金', '定价', '财通基金管理有限公司', '36', '太平洋资产管理有限责任公司', '上海自贸试验区一期股权投资基金合伙企业(有限合伙)', '5255487', '10676156', '光大保德信基金管理有限公司', '股权', '上银基金管理有限公司', '北京基业华商投资管理中心(有限合伙)', '6298932', '147070416', '5195729', '12'}",1729920,0,set(),11,"{'36', '太平洋资产管理有限责任公司', '现金', '定价', '财通基金管理有限公司', '西藏自治区投资有限公司', '中信建投基金管理有限公司', '光大保德信基金管理有限公司', '股权', '12', '上银基金管理有限公司'}",21,"{'上海金桥(集团)有限公司', '5338078', '西藏自治区投资有限公司', '中信建投基金管理有限公司', '3219248', '现金', '定价', '财通基金管理有限公司', '36', '太平洋资产管理有限责任公司', '上海自贸试验区一期股权投资基金合伙企业(有限合伙)', '5255487', '10676156', '光大保德信基金管理有限公司', '股权', '上银基金管理有限公司', '北京基业华商投资管理中心(有限合伙)', '6298932', '147070416', '5195729', '12'}"
4,"{'新兴际华集团', '竞价', '现金', '36'}",2020363,0,set(),4,"{'新兴际华集团', '竞价', '现金', '36'}",4,"{'新兴际华集团', '竞价', '现金', '36'}"
9,"{'现金', '1638000000', '37571400', '国管中心', '定价', '234000000', '263000000', '北汽集团', '36'}",169120,4,"{'1638000000', '37571400', '234000000', '263000000'}",5,"{'现金', '国管中心', '定价', '北汽集团', '36'}",5,"{'现金', '国管中心', '定价', '北汽集团', '36'}"
19,"{'6008065', '36', '现金', '北信瑞丰基金管理有限公司', '4032258', '深圳福星资本管理有限公司', '5685483', '定价', '申万菱信(上海)资产管理有限公司', '天弘基金管理有限公司', '140999978.4', '浙商汇融投资管理有限公司', '安信基金管理有限责任公司', '12500000', '99999998.4', '朱国锭', '149000012', '310000000', '12'}",14704769,0,set(),10,"{'36', '现金', '北信瑞丰基金管理有限公司', '深圳福星资本管理有限公司', '定价', '天弘基金管理有限公司', '浙商汇融投资管理有限公司', '安信基金管理有限责任公司', '朱国锭', '12'}",19,"{'6008065', '36', '现金', '北信瑞丰基金管理有限公司', '4032258', '深圳福星资本管理有限公司', '5685483', '定价', '申万菱信(上海)资产管理有限公司', '天弘基金管理有限公司', '140999978.4', '浙商汇融投资管理有限公司', '安信基金管理有限责任公司', '12500000', '99999998.4', '朱国锭', '149000012', '310000000', '12'}"
28,"{'134019292', '999999998.9', '416799998.1', '144694533', '398878010.5', '499999999.4', '现金', '财通基金管理有限公司', '竞价', '闽西兴杭国有资产投资经营有限公司', '182636655', '160771704', '401699999.6', '36', '128256595', '321543408', '567999997.1', '289389067', '员工持股计划', '中信证券股份有限公司', '橄榄木投资(北京)有限公司', '华融瑞通股权投资管理有限公司', '兴证证券资产管理有限公司', '899999998.4', '中非发展基金有限公司', '129163987', '12', '449999997.6'}",16270358,6,"{'567999997.1', '999999998.9', '竞价', '899999998.4', '398878010.5', '401699999.6'}",10,"{'36', '现金', '兴证证券资产管理有限公司', '员工持股计划', '财通基金管理有限公司', '中信证券股份有限公司', '闽西兴杭国有资产投资经营有限公司', '中非发展基金有限公司', '华融瑞通股权投资管理有限公司', '12'}",22,"{'134019292', '416799998.1', '144694533', '499999999.4', '现金', '财通基金管理有限公司', '闽西兴杭国有资产投资经营有限公司', '182636655', '160771704', '36', '128256595', '321543408', '员工持股计划', '289389067', '中信证券股份有限公司', '橄榄木投资(北京)有限公司', '华融瑞通股权投资管理有限公司', '兴证证券资产管理有限公司', '中非发展基金有限公司', '129163987', '12', '449999997.6'}"
22,"{'7454000', '湖北新海天投资有限公司', '9690000', '200000000', '长沙琛远财务咨询有限公司', '现金', '581400000', '定价', '36', '90000000', '中国纸业投资有限公司', '中信证券岳阳林纸员工持股计划1期定向资产管理计划', '刘建国', '1500000', '25000000', '48152840', '国联证券股份有限公司', '36305200', '山东省国有资产投资控股有限公司', '1292000000', '5620000', '161500000'}",16193775,0,set(),9,"{'36', '现金', '定价', '中国纸业投资有限公司', '刘建国', '湖北新海天投资有限公司', '长沙琛远财务咨询有限公司', '山东省国有资产投资控股有限公司', '国联证券股份有限公司'}",22,"{'7454000', '湖北新海天投资有限公司', '9690000', '200000000', '长沙琛远财务咨询有限公司', '现金', '581400000', '定价', '36', '90000000', '中国纸业投资有限公司', '中信证券岳阳林纸员工持股计划1期定向资产管理计划', '刘建国', '1500000', '25000000', '48152840', '国联证券股份有限公司', '36305200', '山东省国有资产投资控股有限公司', '1292000000', '5620000', '161500000'}"
18,"{'山东晨德', '现金', '赛石控股出资', '99999993.69', '7636502', '潍坊美晨', '定价', '16463225', '431171862.8', '4009164', '京治资本', '363828127.7', '3818251', '199999987.4', '13891872', '36', '杭州晨德', '105000005.2'}",280177,5,"{'99999993.69', '431171862.8', '363828127.7', '199999987.4', '105000005.2'}",8,"{'山东晨德', '现金', '赛石控股出资', '潍坊美晨', '定价', '京治资本', '36', '杭州晨德'}",13,"{'山东晨德', '现金', '7636502', '赛石控股出资', '潍坊美晨', '定价', '16463225', '4009164', '京治资本', '3818251', '13891872', '36', '杭州晨德'}"
12,"{'泰达宏利基金管理有限公司—泰达宏利价值成长定向增发516号资产管理计划', '建信基金管理有限责任公司—建信—华润信托—增利10号资产管理计划', '现金', '杭州滨创股权投资有限公司', '31268439', '定价', '广州市玄元投资管理有限公司—玄元投资元宝1号私募投资基金', '102654867', '铜陵发展投资集团有限公司', '广州金融控股集团有限公司', '12', '51622418'}",12001016,0,set(),6,"{'现金', '杭州滨创股权投资有限公司', '定价', '铜陵发展投资集团有限公司', '广州金融控股集团有限公司', '12'}",12,"{'泰达宏利基金管理有限公司—泰达宏利价值成长定向增发516号资产管理计划', '建信基金管理有限责任公司—建信—华润信托—增利10号资产管理计划', '现金', '杭州滨创股权投资有限公司', '31268439', '定价', '广州市玄元投资管理有限公司—玄元投资元宝1号私募投资基金', '102654867', '铜陵发展投资集团有限公司', '广州金融控股集团有限公司', '12', '51622418'}"
12,"{'现金', '1000000000', '21720243', '竞价', '43440486', '北京京国瑞国企改革发展基金(有限合伙)', '65160729', '1500000000', '500000000', '三胞集团南京投资管理有限公司', '上海懿兆实业投资有限公司', '36'}",1857970,3,"{'1000000000', '竞价', '1500000000'}",4,"{'三胞集团南京投资管理有限公司', '现金', '上海懿兆实业投资有限公司', '36'}",9,"{'现金', '21720243', '43440486', '北京京国瑞国企改革发展基金(有限合伙)', '65160729', '500000000', '三胞集团南京投资管理有限公司', '上海懿兆实业投资有限公司', '36'}"
18,"{'平安大华基金管理有限公司', '159960000', '韩玉山', '49800000', '金鹰基金管理有限公司', '上海泽熙增煦投资中心(有限合伙)', '18600000', '17600000', '凌祖群', '90816000', '定价', '财通基金管理有限公司', '95976000', '144480000', '256968000', '31000000', '28000000', '12'}",1103559,5,"{'韩玉山', '159960000', '95976000', '144480000', '256968000'}",6,"{'平安大华基金管理有限公司', '金鹰基金管理有限公司', '凌祖群', '定价', '财通基金管理有限公司', '12'}",13,"{'平安大华基金管理有限公司', '金鹰基金管理有限公司', '17600000', '49800000', '上海泽熙增煦投资中心(有限合伙)', '18600000', '凌祖群', '90816000', '定价', '财通基金管理有限公司', '31000000', '28000000', '12'}"
15,"{'兵工财务有限责任公司', '深圳市前海欣诺投资合伙企业(有限合伙)', '549999995.9', '财通基金管理有限公司', '16491754', '天治基金管理有限公司', '130000000.9', '竞价', '5397301', '5097451', '169999990.9', '3898051', '179999988.4', '易方达资产管理有限公司', '12'}",15320892,4,"{'169999990.9', '竞价', '179999988.4', '130000000.9'}",1,{'12'},11,"{'兵工财务有限责任公司', '深圳市前海欣诺投资合伙企业(有限合伙)', '549999995.9', '财通基金管理有限公司', '16491754', '5397301', '5097451', '3898051', '天治基金管理有限公司', '易方达资产管理有限公司', '12'}"
5,"{'现金', '1570000000', '竞价', '36', '云南煤化工集团有限公司'}",1119857,1,{'1570000000'},4,"{'竞价', '现金', '36', '云南煤化工集团有限公司'}",4,"{'竞价', '现金', '36', '云南煤化工集团有限公司'}"
13,"{'谢瑾琨', '现金', '北京云冶汇金投资有限公司', '3200000', '宏源证券股份有限公司', '4002903', '财通基金管理有限公司', '华宝信托有限责任公司', '12500000', '3100000', '3600000', '12', '重庆市渝商实业投资有限公'}",1043475,3,"{'3100000', '4002903', '3200000'}",8,"{'谢瑾琨', '现金', '北京云冶汇金投资有限公司', '宏源证券股份有限公司', '财通基金管理有限公司', '华宝信托有限责任公司', '12', '重庆市渝商实业投资有限公'}",10,"{'谢瑾琨', '现金', '北京云冶汇金投资有限公司', '宏源证券股份有限公司', '财通基金管理有限公司', '华宝信托有限责任公司', '12500000', '3600000', '12', '重庆市渝商实业投资有限公'}"
17,"{'江苏新动力风险投资有限公司', '乌鲁木齐市楠悦工贸有限公司', '现金', '8000000', '8500000', '江苏瑞华投资发展有限公司', '新疆生产建设兵团投资有限责任公司', '4000000', '12', '浙江物通实业有限公司', '烟台明华投资有限公司', '2000000', '无锡灵山实业有限责任公司', '10000000', '浙江樱花集团有限公司', '36', '上海迅昌科技实业有限公司'}",956314,3,"{'无锡灵山实业有限责任公司', '8500000', '2000000'}",5,"{'江苏新动力风险投资有限公司', '36', '现金', '新疆生产建设兵团投资有限责任公司', '12'}",14,"{'江苏新动力风险投资有限公司', '乌鲁木齐市楠悦工贸有限公司', '现金', '8000000', '江苏瑞华投资发展有限公司', '新疆生产建设兵团投资有限责任公司', '4000000', '12', '浙江物通实业有限公司', '烟台明华投资有限公司', '10000000', '浙江樱花集团有限公司', '36', '上海迅昌科技实业有限公司'}"
12,"{'5000000', '现金', '4000000', '上海兖矿投资有限公司', '3000000', '社保基金112组合', '交银施罗德成长基金', '兴业可转债混合型证券投资基金', '10000000', '国泰君安投资管理股份有限公司', '中国通用技术(集团)控股有限责任公司', '12'}",532784,1,{'4000000'},2,"{'现金', '12'}",11,"{'5000000', '现金', '上海兖矿投资有限公司', '3000000', '社保基金112组合', '交银施罗德成长基金', '兴业可转债混合型证券投资基金', '10000000', '国泰君安投资管理股份有限公司', '中国通用技术(集团)控股有限责任公司', '12'}"
4,"{'36', '定价', '万向资源有限公司', '736344195'}",1059582,0,set(),2,"{'万向资源有限公司', '36'}",4,"{'36', '定价', '万向资源有限公司', '736344195'}"
4,"{'36', '竞价', '现金', '创越集团'}",572460,1,{'竞价'},3,"{'36', '现金', '创越集团'}",3,"{'36', '现金', '创越集团'}"
29,"{'228999998.5', '192999995.5', '15627530', '30769230', '199999987.9', '泰达宏利基金管理有限公司', '19708502', '15384615', '现金', '379999990.5', '18542510', '定价', '财通基金管理有限公司', '鹏华基金管理有限公司', '华夏人寿保险股份有限公司', '36', '财富证券股份有限公司', '湖北德润投资发展有限公司', '国泰基金管理有限公司', '243399999.7', '64392713', '湘电集团有限公司', '69350029.45', '189999995.3', '16194331', '兴证证券资产管理有限公司', '795250005.6', '5615387', '12'}",14762527,4,"{'189999995.3', '定价', '199999987.9', '795250005.6'}",4,"{'36', '现金', '湘电集团有限公司', '12'}",25,"{'228999998.5', '192999995.5', '15627530', '30769230', '泰达宏利基金管理有限公司', '19708502', '15384615', '现金', '379999990.5', '18542510', '财通基金管理有限公司', '鹏华基金管理有限公司', '华夏人寿保险股份有限公司', '36', '财富证券股份有限公司', '湖北德润投资发展有限公司', '国泰基金管理有限公司', '243399999.7', '64392713', '湘电集团有限公司', '69350029.45', '16194331', '兴证证券资产管理有限公司', '5615387', '12'}"
4,"{'市北集团', '竞价', '现金', '36'}",2041892,0,set(),4,"{'市北集团', '竞价', '现金', '36'}",4,"{'市北集团', '竞价', '现金', '36'}"
8,"{'289999997.1', '7055961', '9999999.9', '243309', '竞价', '上海大正投资有限公司', '北京鑫富恒通科技有限公司', '12'}",604933,0,set(),4,"{'北京鑫富恒通科技有限公司', '上海大正投资有限公司', '竞价', '12'}",8,"{'289999997.1', '7055961', '9999999.9', '243309', '上海大正投资有限公司', '竞价', '北京鑫富恒通科技有限公司', '12'}"
28,"{'478468900', '95693779', '854599998.9', '国开装备', '946059999.8', '东兴华瑞', '现金', '99999998.01', '191387559', '199999998.1', '中信资本(天津)', '408899521', '399999998.3', '36', '382775119', '国开创新', '天津诚柏', '299999998.2', '国开精诚', '1000000001', '九天联成', '上银基金财富10号资产管理计划', '47846889', '452660287', '143540669', '惠州投控', '紫光通信', '799999998.7'}",78939,3,"{'47846889', '95693779', '854599998.9'}",10,"{'现金', '国开创新', '九天联成', '天津诚柏', '惠州投控', '国开装备', '东兴华瑞', '36', '紫光通信', '国开精诚'}",25,"{'478468900', '946059999.8', '东兴华瑞', '现金', '99999998.01', '191387559', '199999998.1', '中信资本(天津)', '408899521', '399999998.3', '36', '382775119', '国开创新', '天津诚柏', '299999998.2', '国开精诚', '1000000001', '九天联成', '上银基金财富10号资产管理计划', '国开装备', '452660287', '143540669', '惠州投控', '紫光通信', '799999998.7'}"
22,"{'27633300', '35000000', '天弘天方1号', '160000000', '31800000', '许素英', '现金', '300000000', '许建成', '105000000', '泰达宏利11号', '165800000', '天弘天方2号', '62400000', '240000000', '西南证券轩辕计划', '东方汇智管理计划', '225000000', '泰达宏利10号', '210000000', '泰达宏利9号', '36'}",579943,11,"{'225000000', '62400000', '240000000', '27633300', '35000000', '210000000', '160000000', '31800000', '300000000', '105000000', '165800000'}",10,"{'泰达宏利10号', '东方汇智管理计划', '天弘天方2号', '现金', '36', '西南证券轩辕计划', '天弘天方1号', '许建成', '泰达宏利11号', '许素英'}",11,"{'泰达宏利10号', '东方汇智管理计划', '天弘天方2号', '现金', '西南证券轩辕计划', '天弘天方1号', '许素英', '泰达宏利9号', '许建成', '泰达宏利11号', '36'}"
5,"{'现金', '江西省电子集团有限公司', '130000000', '竞价', '36'}",1218985,1,{'130000000'},4,"{'竞价', '现金', '江西省电子集团有限公司', '36'}",4,"{'36', '竞价', '现金', '江西省电子集团有限公司'}"
17,"{'招商财富资产管理有限公司', '金鹰基金管理有限公司', '36', '现金', '4932433', '刘水', '299999996', '6554054', '169999992.8', '10135135', '深圳市嘉豪盛实业有限公司', '竞价', '193999998.4', '146000016.8', '5743243', '深圳市融通资本财富管理有限公司', '12'}",1665622,1,{'竞价'},8,"{'招商财富资产管理有限公司', '36', '金鹰基金管理有限公司', '刘水', '现金', '深圳市嘉豪盛实业有限公司', '深圳市融通资本财富管理有限公司', '12'}",16,"{'招商财富资产管理有限公司', '金鹰基金管理有限公司', '36', '现金', '4932433', '刘水', '299999996', '6554054', '169999992.8', '10135135', '深圳市嘉豪盛实业有限公司', '193999998.4', '146000016.8', '5743243', '深圳市融通资本财富管理有限公司', '12'}"
9,"{'现金', '李永明', '方东红', '400000', '竞价', '800000', '蒋灿明', '蓝思远', '36'}",1212171,3,"{'竞价', '800000', '400000'}",6,"{'现金', '李永明', '方东红', '蒋灿明', '蓝思远', '36'}",6,"{'现金', '李永明', '方东红', '蒋灿明', '蓝思远', '36'}"
19,"{'东方证券', '现金', '江苏慧德', '常州产投', '4574600', '6192550', '定价', '江苏武进国经', '华泰柏瑞基金管理的华泰柏瑞-视觉中国特定多客户资产管理计划', '112074456', '华泰柏瑞基金管理的华泰柏瑞—东方证券—视觉中国特定多客户资产管理计划', '33777240', '5911100', '112592064', '86734416', '1781500', '5938400', '36', '117410748'}",1709231,5,"{'112074456', '33777240', '112592064', '86734416', '117410748'}",6,"{'东方证券', '江苏慧德', '现金', '常州产投', '江苏武进国经', '36'}",14,"{'东方证券', '现金', '江苏慧德', '常州产投', '4574600', '6192550', '定价', '江苏武进国经', '华泰柏瑞基金管理的华泰柏瑞-视觉中国特定多客户资产管理计划', '华泰柏瑞基金管理的华泰柏瑞—东方证券—视觉中国特定多客户资产管理计划', '5911100', '5938400', '36', '1781500'}"
4,"{'竞价', '现金', '36', '南方同正'}",51029,1,{'竞价'},3,"{'现金', '36', '南方同正'}",3,"{'现金', '36', '南方同正'}"
23,"{'70000000', '199999999.6', '朱朝阳', '宁波光辉嘉耀投资管理合伙企业(有限合伙)', '5426917', '200000000', '2713458', '1266280', '现金', '5969609', '定价', '7235890', '300000000', '上海六禾芳甸投资中心(有限合伙)', '3617945', '柳州医药第一期员工持股计划', '150000000', '399999999.2', '330000000', '九泰基金管理有限公司', '重庆程奉盈森投资合伙企业(有限合伙)', '中国人寿资产管理有限公司', '36'}",1898026,4,"{'2713458', '1266280', '7235890', '5969609'}",7,"{'现金', '九泰基金管理有限公司', '定价', '朱朝阳', '中国人寿资产管理有限公司', '柳州医药第一期员工持股计划', '36'}",19,"{'150000000', '现金', '330000000', '九泰基金管理有限公司', '70000000', '199999999.6', '200000000', '定价', '5426917', '重庆程奉盈森投资合伙企业(有限合伙)', '300000000', '朱朝阳', '宁波光辉嘉耀投资管理合伙企业(有限合伙)', '中国人寿资产管理有限公司', '上海六禾芳甸投资中心(有限合伙)', '3617945', '柳州医药第一期员工持股计划', '36', '399999999.2'}"
6,"{'178432449.5', '现金', '定价', '宝塔石化', '36', '30870666'}",912908,2,"{'178432449.5', '30870666'}",4,"{'定价', '现金', '宝塔石化', '36'}",4,"{'定价', '现金', '宝塔石化', '36'}"
11,"{'现金', '深圳市中电东方投资管理企业(有限合伙)', '重庆昊海汇嘉投资中心(有限合伙)', '90000000', '526500000', '中植资本管理有限公司', '175500000', '80000000', '30000000', '36', '468000000'}",1104674,6,"{'90000000', '526500000', '175500000', '80000000', '30000000', '468000000'}",3,"{'36', '现金', '中植资本管理有限公司'}",5,"{'36', '现金', '重庆昊海汇嘉投资中心(有限合伙)', '中植资本管理有限公司', '深圳市中电东方投资管理企业(有限合伙)'}"
15,"{'5000000', '现金', '武汉荣盛投资有限公司', '3500000', '天津凯石益利股权投资基金合伙企业(有限合伙)', '傅见林', '定价', '沈振国', '3700000', '西藏自治区投资有限公司', '常州投资集团有限公司', '3000000', '中国建设银行-工银瑞信稳健成长股票型证券投资基金', '上海天誉投资有限公司', '12'}",1496643,0,set(),5,"{'现金', '傅见林', '定价', '沈振国', '12'}",15,"{'5000000', '武汉荣盛投资有限公司', '现金', '3500000', '天津凯石益利股权投资基金合伙企业(有限合伙)', '傅见林', '沈振国', '定价', '3700000', '西藏自治区投资有限公司', '常州投资集团有限公司', '3000000', '中国建设银行-工银瑞信稳健成长股票型证券投资基金', '上海天誉投资有限公司', '12'}"
3,"{'京能集团', '现金', '36'}",1242411,0,set(),3,"{'京能集团', '现金', '36'}",3,"{'京能集团', '现金', '36'}"
21,"{'95000003.42', '上海灏颂实业有限公司', '迪瑞资产管理(杭州)有限公司', '杭州羽南实业有限公司', '现金', '54511278', '财通基金-玉泉108号资产管理计划', '26315788', '135000000.8', '144999999.5', '东海基金-鑫龙14号资产管理计划', '33834586', '69999996.08', '89999998.76', '汇添富-盛世成长双喜六号集合资产管理计划', '深圳创亿宏业科技有限公司', '35714287', '合肥市尚诚塑业有限公司', '深圳东升峥嵘科技有限公司', '36', '50751880'}",307081,4,"{'144999999.5', '89999998.76', '95000003.42', '69999996.08'}",7,"{'现金', '深圳创亿宏业科技有限公司', '上海灏颂实业有限公司', '合肥市尚诚塑业有限公司', '深圳东升峥嵘科技有限公司', '杭州羽南实业有限公司', '36'}",17,"{'现金', '54511278', '财通基金-玉泉108号资产管理计划', '合肥市尚诚塑业有限公司', '26315788', '汇添富-盛世成长双喜六号集合资产管理计划', '135000000.8', '深圳创亿宏业科技有限公司', '35714287', '上海灏颂实业有限公司', '迪瑞资产管理(杭州)有限公司', '东海基金-鑫龙14号资产管理计划', '33834586', '深圳东升峥嵘科技有限公司', '杭州羽南实业有限公司', '36', '50751880'}"
4,"{'郑钟南', '竞价', '现金', '36'}",592663,0,set(),4,"{'郑钟南', '竞价', '现金', '36'}",4,"{'郑钟南', '竞价', '现金', '36'}"
21,"{'40001379', '4574100', '2287100', '80001009', '李伟军', '深圳市明道中鑫投资企业(有限合伙)', '台州润熙投资合伙企业(有限合伙)', '现金', '5741869', '3406000', '竞价', '30000597', '深圳市北极星光资产管理有限公司', '100425289', '许敏田', '59570940', '571800', '1715300', '10000782', '36', '宁波正友润和投资合伙企业(有限合伙)'}",1679969,10,"{'台州润熙投资合伙企业(有限合伙)', '40001379', '59570940', '竞价', '30000597', '80001009', '10000782', '深圳市明道中鑫投资企业(有限合伙)', '100425289', '宁波正友润和投资合伙企业(有限合伙)'}",5,"{'现金', '许敏田', '李伟军', '深圳市北极星光资产管理有限公司', '36'}",11,"{'现金', '5741869', '4574100', '许敏田', '3406000', '2287100', '1715300', '571800', '李伟军', '深圳市北极星光资产管理有限公司', '36'}"
26,"{'建信基金管理的建信昆仑资产管理计划', '民生证券', '200000000', '财通资产拟设立的资产管理计划', '现金', '11469158', '泓信资本', '定价', '37251655', '300000000', '41390728', '124172185', '西证渝富成长', '450000000', '力扬实业', '1511452560', '1500000000', '138547440', '国联证券拟设立的资产管理计划', '16556291', '125120245', '陈卫', '500000000', '24834437', '36', '力帆控股'}",1648737,3,"{'450000000', '300000000', '1511452560'}",12,"{'建信基金管理的建信昆仑资产管理计划', '现金', '西证渝富成长', '泓信资本', '定价', '陈卫', '力扬实业', '民生证券', '国联证券拟设立的资产管理计划', '36', '财通资产拟设立的资产管理计划', '力帆控股'}",23,"{'建信基金管理的建信昆仑资产管理计划', '民生证券', '200000000', '财通资产拟设立的资产管理计划', '现金', '11469158', '泓信资本', '定价', '37251655', '41390728', '124172185', '西证渝富成长', '力扬实业', '1500000000', '国联证券拟设立的资产管理计划', '138547440', '16556291', '125120245', '陈卫', '500000000', '24834437', '36', '力帆控股'}"
11,"{'富国通达', '521250', '现金', '巩新民', '竞价', '曹积生', '29148368', '4329005', '17316018', '东方邦信', '36'}",1881342,4,"{'竞价', '521250', '29148368', '4329005'}",6,"{'富国通达', '现金', '巩新民', '曹积生', '东方邦信', '36'}",7,"{'富国通达', '现金', '巩新民', '曹积生', '17316018', '东方邦信', '36'}"
15,"{'15500000', '现金', '252756000', '新疆鼎丰展金股权投资合伙企业(有限合伙)', '16050000', '343791000', '13045891', '天弘基金管理有限公司', '竞价', '新疆同和平裕股权投资合伙企业(有限合伙)', '11800000', '279442985', '12', '新疆盛世发金股权投资合伙企业(有限合伙)', '332010000'}",1225193,5,"{'252756000', '343791000', '竞价', '279442985', '332010000'}",3,"{'天弘基金管理有限公司', '现金', '12'}",10,"{'15500000', '现金', '新疆鼎丰展金股权投资合伙企业(有限合伙)', '16050000', '13045891', '天弘基金管理有限公司', '新疆同和平裕股权投资合伙企业(有限合伙)', '11800000', '12', '新疆盛世发金股权投资合伙企业(有限合伙)'}"
5,"{'现金', '汇添富基金专户-盛世资产管理计划', '竞价', '姚雄杰', '36'}",1137952,0,set(),4,"{'36', '竞价', '姚雄杰', '现金'}",5,"{'现金', '汇添富基金专户-盛世资产管理计划', '竞价', '姚雄杰', '36'}"
5,"{'20000000', '现金', '竞价', '任健', '36'}",15303425,1,{'20000000'},4,"{'36', '竞价', '任健', '现金'}",4,"{'任健', '竞价', '现金', '36'}"
15,"{'现金', '249984000', '10080000', '长石投资有限公司', '5040000', '鑫元基金管理有限公司', '东海基金管理有限责任公司', '竞价', '深圳市方德智联投资管理有限公司', '4360000', '129753600', '149990400', '299980800', '36', '8400000'}",2324569,2,"{'149990400', '竞价'}",6,"{'现金', '长石投资有限公司', '鑫元基金管理有限公司', '东海基金管理有限责任公司', '深圳市方德智联投资管理有限公司', '36'}",13,"{'现金', '249984000', '10080000', '长石投资有限公司', '5040000', '鑫元基金管理有限公司', '东海基金管理有限责任公司', '深圳市方德智联投资管理有限公司', '4360000', '129753600', '299980800', '36', '8400000'}"
8,"{'北京经济技术投资开发总公司', '现金', '201096892', '127970749', '成都工业投资集团有限公司', '82266911', '成都高新投资集团有限公司', '12'}",810991,0,set(),5,"{'北京经济技术投资开发总公司', '现金', '成都工业投资集团有限公司', '成都高新投资集团有限公司', '12'}",8,"{'北京经济技术投资开发总公司', '现金', '201096892', '127970749', '成都工业投资集团有限公司', '82266911', '成都高新投资集团有限公司', '12'}"
22,"{'9259993.6', '4000000', '723437', '新疆新玺股权投资有限合伙企业', '76800000', '6000000', '60160000', '现金', '天津六禾碧云股权投资基金合伙企业(有限合伙)', '97280000', '4700000', '竞价', '上海戴德拉投资管理合伙企业(有限合伙)', '华宝投资有限公司', '西安长咸投资管理有限合伙企业', '友成企业家扶贫基金会', '51200000', '华宝信托有限责任公司', '7600000', '西安长国投资管理有限合伙企业', '上海证券有限责任公司', '12'}",1262674,1,{'竞价'},6,"{'现金', '华宝信托有限责任公司', '西安长国投资管理有限合伙企业', '华宝投资有限公司', '12', '西安长咸投资管理有限合伙企业'}",21,"{'9259993.6', '4000000', '723437', '新疆新玺股权投资有限合伙企业', '76800000', '6000000', '60160000', '现金', '天津六禾碧云股权投资基金合伙企业(有限合伙)', '97280000', '4700000', '上海戴德拉投资管理合伙企业(有限合伙)', '华宝投资有限公司', '西安长咸投资管理有限合伙企业', '友成企业家扶贫基金会', '51200000', '华宝信托有限责任公司', '7600000', '西安长国投资管理有限合伙企业', '上海证券有限责任公司', '12'}"
22,"{'7000000', '方正证券有限责任公司', '8000000', '王毅', '11000000', '竞价', '16103896', '123999999.2', '26299996.8', '江苏弘业股份有限公司', '上海天誉投资有限公司', '36', '53900000', '南通产业控股集团有限公司', '华夏基金管理有限公司', '3415584', '华宝信托有限责任公司', '郝昌兰', '江苏苏豪国际集团股份有限公司', '李绍君', '12', '61600000'}",493486,4,"{'53900000', '123999999.2', '26299996.8', '61600000'}",12,"{'华夏基金管理有限公司', '王毅', '12', '李绍君', '华宝信托有限责任公司', '竞价', '郝昌兰', '方正证券有限责任公司', '江苏弘业股份有限公司', '上海天誉投资有限公司', '36', '南通产业控股集团有限公司'}",18,"{'36', '华夏基金管理有限公司', '王毅', '7000000', '3415584', '华宝信托有限责任公司', '11000000', '江苏苏豪国际集团股份有限公司', '郝昌兰', '李绍君', '方正证券有限责任公司', '16103896', '竞价', '8000000', '江苏弘业股份有限公司', '上海天誉投资有限公司', '12', '南通产业控股集团有限公司'}"
15,"{'山东运金股权投资有限公司', '11351351', '10302702', '12', '21621621', '财通基金管理有限公司', '鲁资创业投资有限公司', '6054054', '竞价', '济南国惠兴鲁股权投资基金合伙企业(有限合伙)', '华鲁投资发展有限公司', '14270270', '山东发展投资控股集团有限公司', '36', '济南文景投资合伙企业(有限合伙)'}",20275260,0,set(),8,"{'山东运金股权投资有限公司', '12', '财通基金管理有限公司', '鲁资创业投资有限公司', '竞价', '华鲁投资发展有限公司', '山东发展投资控股集团有限公司', '36'}",15,"{'36', '山东运金股权投资有限公司', '11351351', '10302702', '21621621', '财通基金管理有限公司', '鲁资创业投资有限公司', '6054054', '竞价', '济南国惠兴鲁股权投资基金合伙企业(有限合伙)', '华鲁投资发展有限公司', '14270270', '山东发展投资控股集团有限公司', '12', '济南文景投资合伙企业(有限合伙)'}"
23,"{'恒越投资', '谷欣投资', '512040000', '32000000', '68000000', '301200000', '朝阳投资', '浩然明达', '川宏燃料', '40000000', '浩泽嘉业', '定价', '474603596', '594870000', '79000000', '京马投资', '63028366', '137946879', '1038739999', '240960000', '132880000', '1000586400', '36'}",2185540,2,"{'1038739999', '474603596'}",9,"{'恒越投资', '川宏燃料', '谷欣投资', '浩泽嘉业', '定价', '朝阳投资', '浩然明达', '京马投资', '36'}",21,"{'恒越投资', '谷欣投资', '512040000', '32000000', '68000000', '301200000', '朝阳投资', '浩然明达', '川宏燃料', '40000000', '浩泽嘉业', '定价', '594870000', '79000000', '京马投资', '63028366', '137946879', '240960000', '132880000', '1000586400', '36'}"
8,"{'华映纳闽', '定价', '福日电子', '30040422', '500312295', '华映百慕大', '25480000', '36'}",1077311,0,set(),5,"{'36', '华映纳闽', '定价', '华映百慕大', '福日电子'}",8,"{'华映纳闽', '定价', '福日电子', '30040422', '500312295', '华映百慕大', '25480000', '36'}"
13,"{'蓝巨投资', '43153049', '宁波久元', '现金', '28768699', '金泰众和', '乐视控股', '1000000000', '中信证券', '500000000', '1500000000', '14384349', '36'}",390254,3,"{'1000000000', '1500000000', '500000000'}",7,"{'蓝巨投资', '宁波久元', '现金', '金泰众和', '乐视控股', '中信证券', '36'}",10,"{'蓝巨投资', '43153049', '宁波久元', '28768699', '现金', '金泰众和', '乐视控股', '中信证券', '14384349', '36'}"
3,"{'36000000', '12', '宝发1号'}",12046925,0,set(),1,{'12'},3,"{'36000000', '12', '宝发1号'}"
4,"{'70000000', '定价', '36', '常州京控泰丰投资中心'}",1613266,0,set(),2,"{'36', '常州京控泰丰投资中心'}",4,"{'70000000', '定价', '36', '常州京控泰丰投资中心'}"
17,"{'12285012', '现金', '德威德佳', '100000000', '员工持股计划', '刘以林', '6142506', '李家权', '湘投高科', '9828009', '50000000', '唐人神控股', '温氏投资', '陈枝', '大生行', '80000000', '36'}",308362,0,set(),11,"{'36', '现金', '员工持股计划', '刘以林', '李家权', '陈枝', '温氏投资', '唐人神控股', '大生行', '湘投高科', '德威德佳'}",17,"{'12285012', '现金', '德威德佳', '100000000', '员工持股计划', '刘以林', '6142506', '李家权', '湘投高科', '9828009', '50000000', '唐人神控股', '温氏投资', '陈枝', '大生行', '80000000', '36'}"
21,"{'郭江', '中信建投基金(定增35号资产管理计划,代表“神州数码2016年第一期员工持股计划”)', '50000000', '18887476', '现金', '1684678', '郭为', '26500000', '竞价', '3178639', '10000000', '30000000', '635727', '5500000', '帅勇', '张广佳', '1907183', '297100000', '349650', '蔡忠', '36'}",14212387,11,"{'1907183', '1684678', '26500000', '5500000', '297100000', '竞价', '3178639', '349650', '635727', '10000000', '18887476'}",7,"{'张广佳', '现金', '郭江', '郭为', '帅勇', '蔡忠', '36'}",10,"{'张广佳', '现金', '郭江', '郭为', '中信建投基金(定增35号资产管理计划,代表“神州数码2016年第一期员工持股计划”)', '帅勇', '50000000', '蔡忠', '30000000', '36'}"
4,"{'竞价', '现金', '36', '南方同正'}",169546,0,set(),4,"{'竞价', '现金', '36', '南方同正'}",4,"{'竞价', '现金', '36', '南方同正'}"
27,"{'41497750', '安徽省铁路建设投资基金有限公司', '12197425', '泰达宏利基金管理有限公司', '现金', '新疆凯迪投资有限责任公司', '97579400', '方文艳', '财通基金管理有限公司', '20679750', '竞价', '40250000', '168630000', '太平资产管理有限公司', '平安大华基金管理有限公司', '21078750', '331982000', '322000000', '165980696', '200820800', '21250000', '20747587', '165438000', '英大基金管理有限公司', '170000000', '25102600', '12'}",1105970,0,set(),11,"{'平安大华基金管理有限公司', '现金', '安徽省铁路建设投资基金有限公司', '新疆凯迪投资有限责任公司', '英大基金管理有限公司', '方文艳', '财通基金管理有限公司', '竞价', '泰达宏利基金管理有限公司', '12', '太平资产管理有限公司'}",27,"{'41497750', '安徽省铁路建设投资基金有限公司', '12197425', '泰达宏利基金管理有限公司', '现金', '新疆凯迪投资有限责任公司', '97579400', '方文艳', '财通基金管理有限公司', '20679750', '竞价', '40250000', '168630000', '太平资产管理有限公司', '平安大华基金管理有限公司', '21078750', '331982000', '322000000', '165980696', '200820800', '21250000', '20747587', '165438000', '英大基金管理有限公司', '170000000', '25102600', '12'}"
24,"{'27856736', '名正信融', '68561682', '灿翔实业', '28425241', '天晟泰合', '现金', '1206000000', '仰添投资', '19897669', '490000000', '150000000', '智度五云', '8527572', '450000000', '通映投资', '修敬资产', '骏丰投资', '25582717', '350000000', '德符投资', '500000000', '36', '成嘉投资'}",1923441,6,"{'490000000', '150000000', '1206000000', '450000000', '350000000', '500000000'}",12,"{'天晟泰合', '现金', '名正信融', '智度五云', '德符投资', '通映投资', '仰添投资', '修敬资产', '灿翔实业', '成嘉投资', '36', '骏丰投资'}",18,"{'27856736', '天晟泰合', '现金', '名正信融', '智度五云', '8527572', '德符投资', '68561682', '通映投资', '28425241', '修敬资产', '19897669', '灿翔实业', '仰添投资', '成嘉投资', '36', '骏丰投资', '25582717'}"
5,"{'现金', '电信院', '100000000', '竞价', '36'}",208515,1,{'100000000'},4,"{'电信院', '竞价', '现金', '36'}",4,"{'36', '竞价', '电信院', '现金'}"
17,"{'兵器财务有限责任公司', '江苏瑞华投资发展有限公司', '新华人寿保险股份有限公司', '中国航空救生研究所', '12', '1333300', '266900', '上海励诚投资发展有限公司', '竞价', '3000000', '1266600', '上海银沙创业投资有限公司', '1200000', '2666600', '1666600', '36', '海富通基金管理有限公司'}",1372296,3,"{'2666600', '竞价', '266900'}",4,"{'12', '海富通基金管理有限公司', '36', '中国航空救生研究所'}",14,"{'36', '兵器财务有限责任公司', '江苏瑞华投资发展有限公司', '新华人寿保险股份有限公司', '中国航空救生研究所', '1333300', '上海励诚投资发展有限公司', '1266600', '3000000', '上海银沙创业投资有限公司', '1200000', '1666600', '12', '海富通基金管理有限公司'}"
18,"{'303750', '2227500', '东莞市中科松山湖创业投资有限公司', '李明斌', '令西普', '7087500', '中航新兴产业投资有限公司', '新疆协和股权投资合伙企业(有限合伙)', '3796875', '506250', '25000000', '中航机电系统有限公司', '深圳潇湘君佑投资企业(有限合伙)', '50000000', '广东融易创业投资有限公司', '陈根龙', '36', '37500000'}",1881587,1,{'东莞市中科松山湖创业投资有限公司'},4,"{'中航新兴产业投资有限公司', '广东融易创业投资有限公司', '中航机电系统有限公司', '36'}",17,"{'303750', '2227500', '李明斌', '令西普', '7087500', '中航新兴产业投资有限公司', '新疆协和股权投资合伙企业(有限合伙)', '3796875', '506250', '25000000', '中航机电系统有限公司', '深圳潇湘君佑投资企业(有限合伙)', '50000000', '广东融易创业投资有限公司', '陈根龙', '36', '37500000'}"
33,"{'3528581', '254999991', '上银基金财富64号资产管理计划', '10585744', '49999993', '现金', '尹洪卫', '定价', '7057163', '239999997', '恒奉投资', '1058574', '36', '69999999', '17995765', '149999993', '94999988', '44999995', '16937191', '龙柯旭', '29999988', '14999994', '3175723', '100000000', '4940014', '前海瓴建', '彭外生', '6704304', '宏升恒通', '2117148', '何立新', '前海业远', '刘军'}",1900008,4,"{'2117148', '3175723', '17995765', '3528581'}",12,"{'36', '何立新', '现金', '尹洪卫', '前海瓴建', '彭外生', '定价', '宏升恒通', '恒奉投资', '龙柯旭', '前海业远', '刘军'}",29,"{'254999991', '上银基金财富64号资产管理计划', '10585744', '49999993', '现金', '尹洪卫', '定价', '7057163', '239999997', '恒奉投资', '1058574', '36', '69999999', '149999993', '94999988', '44999995', '16937191', '龙柯旭', '29999988', '14999994', '100000000', '4940014', '前海瓴建', '彭外生', '6704304', '宏升恒通', '何立新', '前海业远', '刘军'}"
12,"{'现金', '华安基金管理有限公司', '34000000', '18000000', '15000000', '国泰君安员工持股1号-宜宾五粮液第1期员工持股计划定向资产管理计划', '22000000', '11000000', '泰康资产管理有限责任公司', '凯联(北京)投资基金管理有限公司拟筹建和管理的私募投资基金', '国泰君安君享五粮液1号集合资产管理计划', '36'}",1803116,6,"{'34000000', '18000000', '15000000', '22000000', '11000000', '凯联(北京)投资基金管理有限公司拟筹建和管理的私募投资基金'}",4,"{'泰康资产管理有限责任公司', '36', '现金', '华安基金管理有限公司'}",6,"{'现金', '华安基金管理有限公司', '国泰君安员工持股1号-宜宾五粮液第1期员工持股计划定向资产管理计划', '泰康资产管理有限责任公司', '国泰君安君享五粮液1号集合资产管理计划', '36'}"
18,"{'金鹰基金管理有限公司', '29000000', '现金', '450000', '于洪涛', '何建锋', '定价', '500000', '李刚', '300000', '200000', '刘海金', '180380000', '李礼', '180000', '赵洪武', '李景相', '36'}",1583109,5,"{'450000', '300000', '200000', '180380000', '180000'}",11,"{'金鹰基金管理有限公司', '现金', '于洪涛', '何建锋', '李刚', '刘海金', '定价', '李礼', '赵洪武', '李景相', '36'}",13,"{'29000000', '金鹰基金管理有限公司', '现金', '于洪涛', '何建锋', '李刚', '500000', '刘海金', '定价', '李礼', '赵洪武', '李景相', '36'}"
5,"{'现金', '210000000', '竞价', '辽宁曙光集团有限责任公司', '36'}",1151012,1,{'210000000'},4,"{'36', '竞价', '现金', '辽宁曙光集团有限责任公司'}",4,"{'辽宁曙光集团有限责任公司', '现金', '竞价', '36'}"
12,"{'20000000', '北京中亿邦经贸有限公司', '北京鼎龙博远科技有限公司', '宁波金球投资有限公司', '12', '东海证券有限责任公司', '维维集团股份有限公司', '竞价', '大冢(中国)投资有限公司', '10000000', '36', '吉林省通化振国药业有限公司'}",1123792,0,set(),9,"{'北京中亿邦经贸有限公司', '北京鼎龙博远科技有限公司', '宁波金球投资有限公司', '12', '维维集团股份有限公司', '竞价', '吉林省通化振国药业有限公司', '36', '东海证券有限责任公司'}",12,"{'20000000', '北京中亿邦经贸有限公司', '北京鼎龙博远科技有限公司', '宁波金球投资有限公司', '12', '东海证券有限责任公司', '维维集团股份有限公司', '竞价', '大冢(中国)投资有限公司', '10000000', '36', '吉林省通化振国药业有限公司'}"
10,"{'广发证券资产管理(广东)有限公司', '现金', '中融基金管理有限公司', '定价', '华鑫证券有限责任公司', '中国长城资产管理公司', '青岛城投金融控股集团有限公司', '安徽中安资本投资基金有限公司', '常州产业投资集团有限公司', '12'}",12051560,1,{'广发证券资产管理(广东)有限公司'},9,"{'现金', '中融基金管理有限公司', '12', '定价', '中国长城资产管理公司', '青岛城投金融控股集团有限公司', '安徽中安资本投资基金有限公司', '常州产业投资集团有限公司', '华鑫证券有限责任公司'}",9,"{'现金', '中融基金管理有限公司', '定价', '华鑫证券有限责任公司', '中国长城资产管理公司', '青岛城投金融控股集团有限公司', '安徽中安资本投资基金有限公司', '常州产业投资集团有限公司', '12'}"
18,"{'现金', '李涛', '常州翔嘉中舟投资中心(有限合伙)', '中意资产管理有限责任公司', '4061302', '11448275', '4597701', '149399988.8', '60999993.45', '59999998.05', '199999993.5', '竞价', '上海擎达投资中心(有限合伙)', '4674329', '52999991.1', '12', '15325670', '太平资产管理有限公司'}",16887379,4,"{'149399988.8', '60999993.45', '竞价', '59999998.05'}",5,"{'现金', '李涛', '中意资产管理有限责任公司', '12', '太平资产管理有限公司'}",14,"{'现金', '李涛', '常州翔嘉中舟投资中心(有限合伙)', '中意资产管理有限责任公司', '4061302', '11448275', '4597701', '199999993.5', '上海擎达投资中心(有限合伙)', '4674329', '52999991.1', '12', '15325670', '太平资产管理有限公司'}"
13,"{'现金', '450000000', '定价', '经怡实业', '49342100', '1000000000', '700000000', '汇银投资', '109649200', '大新华投资', '76754300', '上海国际集团', '36'}",1224901,6,"{'450000000', '49342100', '1000000000', '700000000', '109649200', '76754300'}",7,"{'现金', '定价', '经怡实业', '大新华投资', '汇银投资', '上海国际集团', '36'}",7,"{'现金', '定价', '经怡实业', '大新华投资', '汇银投资', '上海国际集团', '36'}"
9,"{'现金', '定价', '17964628', '143896670.3', '杨学平', '161681649', '1295070008', '36', '深圳盛屯集团有限公司'}",19229921,1,{'143896670.3'},5,"{'现金', '定价', '杨学平', '36', '深圳盛屯集团有限公司'}",8,"{'现金', '定价', '17964628', '杨学平', '161681649', '1295070008', '36', '深圳盛屯集团有限公司'}"
14,"{'现金', '66000000', '27077409', '35000000', '博时基金管理有限公司', '平安资产管理有限责任公司', '75134766', '27500000', '鹏华基金管理有限公司', 'Yale University(耶鲁大学)', '华商基金管理有限公司', '国元证券股份有限公司', '12', '33370199'}",884484,1,{'Yale University(耶鲁大学)'},7,"{'现金', '博时基金管理有限公司', '平安资产管理有限责任公司', '鹏华基金管理有限公司', '华商基金管理有限公司', '国元证券股份有限公司', '12'}",13,"{'现金', '66000000', '27077409', '35000000', '博时基金管理有限公司', '平安资产管理有限责任公司', '75134766', '27500000', '鹏华基金管理有限公司', '华商基金管理有限公司', '国元证券股份有限公司', '12', '33370199'}"
5,"{'54800000', '现金', '竞价', '36', '吴建新'}",9885766,1,{'54800000'},4,"{'竞价', '现金', '36', '吴建新'}",4,"{'竞价', '现金', '36', '吴建新'}"
9,"{'20000000', '现金', '定价', '甘肃星利达投资管理有限责任公司', '60000000', '120000000', '江苏融卓投资有限公司', '360000000', '36'}",1788537,0,set(),6,"{'20000000', '现金', '定价', '甘肃星利达投资管理有限责任公司', '江苏融卓投资有限公司', '36'}",9,"{'20000000', '现金', '定价', '甘肃星利达投资管理有限责任公司', '60000000', '120000000', '江苏融卓投资有限公司', '360000000', '36'}"
4,"{'中节能资本', '竞价', '现金', '36'}",1787338,0,set(),4,"{'中节能资本', '竞价', '现金', '36'}",4,"{'中节能资本', '竞价', '现金', '36'}"
6,"{'现金', '3122307682', '定价', '253846153', '上海国之杰投资发展有限公司', '36'}",1685319,1,{'3122307682'},4,"{'定价', '现金', '36', '上海国之杰投资发展有限公司'}",5,"{'现金', '定价', '253846153', '上海国之杰投资发展有限公司', '36'}"
6,"{'现金', '定价', '302992994', 'KKR(卢森堡)', '3281414125', '36'}",441561,1,{'3281414125'},3,"{'定价', '现金', '36'}",5,"{'现金', '定价', '302992994', 'KKR(卢森堡)', '36'}"
22,"{'305550000', '388000000', '华泰资产管理有限公司', '申万菱信基金管理有限公司', '易方达资产管理有限公司', '现金', '新华基金管理有限公司', '63000000', '定价', '20320400', '鹏华基金管理有限公司', '98553910.9', '东海基金管理有限责任公司', '264545456.8', '153061200', '742346936.4', '54545500', '184629600', '895453695.8', '嘉实基金管理有限公司', '80000000', '12'}",313980,6,"{'54545500', '184629600', '153061200', '264545456.8', '20320400', '80000000'}",10,"{'新华基金管理有限公司', '现金', '定价', '东海基金管理有限责任公司', '嘉实基金管理有限公司', '华泰资产管理有限公司', '鹏华基金管理有限公司', '申万菱信基金管理有限公司', '易方达资产管理有限公司', '12'}",16,"{'新华基金管理有限公司', '现金', '63000000', '305550000', '388000000', '定价', '东海基金管理有限责任公司', '华泰资产管理有限公司', '嘉实基金管理有限公司', '742346936.4', '895453695.8', '鹏华基金管理有限公司', '申万菱信基金管理有限公司', '98553910.9', '易方达资产管理有限公司', '12'}"
19,"{'5820000', '现金', '17853233', '96793200', '昆明盈鑫肆贰投资中心(有限合伙)', '8600000', '昆明盈鑫柒投资中心(有限合伙)', '5800000', '章小格', '38877600', '兴业全球基金管理有限公司(注)', '57448000', '竞价', '38744000', '119259596.4', '泰康资产管理有限责任公司', '14490000', '12', '汇添富基金管理有限公司'}",726059,8,"{'96793200', '5800000', '57448000', '38744000', '竞价', '119259596.4', '14490000', '38877600'}",5,"{'现金', '章小格', '泰康资产管理有限责任公司', '12', '汇添富基金管理有限公司'}",11,"{'5820000', '现金', '17853233', '昆明盈鑫柒投资中心(有限合伙)', '昆明盈鑫肆贰投资中心(有限合伙)', '8600000', '章小格', '兴业全球基金管理有限公司(注)', '泰康资产管理有限责任公司', '12', '汇添富基金管理有限公司'}"
4,"{'庄敏', '现金', '841482488', '36'}",1772440,1,{'841482488'},3,"{'庄敏', '现金', '36'}",3,"{'庄敏', '现金', '36'}"
11,"{'现金', '山东诺德', '761421320', '定价', '西藏泰能', '2538071064', '南京汇恒', '507614214', '永泰控股', '36', '襄银投资'}",583526,3,"{'761421320', '2538071064', '507614214'}",8,"{'现金', '山东诺德', '定价', '西藏泰能', '南京汇恒', '永泰控股', '36', '襄银投资'}",8,"{'现金', '山东诺德', '定价', '西藏泰能', '南京汇恒', '永泰控股', '36', '襄银投资'}"
10,"{'现金', '上海综艺控股有限公司', '77639751', '常高新集团有限公司', '昝圣达', '31055900', '杨廷栋', '500000000', '200000000', '36'}",301051,0,set(),6,"{'现金', '上海综艺控股有限公司', '常高新集团有限公司', '昝圣达', '杨廷栋', '36'}",10,"{'现金', '上海综艺控股有限公司', '77639751', '常高新集团有限公司', '昝圣达', '31055900', '杨廷栋', '500000000', '200000000', '36'}"
4,"{'现金', '竞价', '铜陵有色金属集团控股有限公司', '36'}",1127010,1,{'竞价'},3,"{'现金', '铜陵有色金属集团控股有限公司', '36'}",3,"{'现金', '铜陵有色金属集团控股有限公司', '36'}"
19,"{'兴发龙元定增1号', '现金', '11500000', '34000000', '兴发新价值2号', '兴发新价值1号', '定价', '兴发龙元定增2号', '赖晔鋆', '7000000', '13000000', '122500000', '11000000', '赖朝辉', '兴发新价值3号', '93500000', '兴发新价值4号', '赖振元', '36'}",1894382,1,{'定价'},11,"{'兴发龙元定增1号', '现金', '兴发新价值2号', '兴发新价值1号', '兴发龙元定增2号', '赖晔鋆', '赖朝辉', '兴发新价值3号', '兴发新价值4号', '赖振元', '36'}",18,"{'兴发龙元定增1号', '11500000', '现金', '34000000', '兴发新价值2号', '兴发新价值1号', '13000000', '兴发龙元定增2号', '赖晔鋆', '7000000', '122500000', '11000000', '赖朝辉', '兴发新价值3号', '93500000', '兴发新价值4号', '赖振元', '36'}"
16,"{'2300000000', '保定风帆集团有限责任公司', '上海申能资产管理有限公司', '46400000000', '12', '20000000000', '上海衡信市场营销策划有限公司', '14000000000', '上海中静四海实业有限公司', '易方达基金管理有限公司', '中国银河证券股份有限公司', '大同市南郊区顺成投资有限责任公司', '中信证券股份有限公司', '15000000000', '10000000000', '36'}",547041,5,"{'2300000000', '14000000000', '15000000000', '10000000000', '46400000000'}",7,"{'上海申能资产管理有限公司', '上海中静四海实业有限公司', '上海衡信市场营销策划有限公司', '易方达基金管理有限公司', '中国银河证券股份有限公司', '大同市南郊区顺成投资有限责任公司', '12'}",11,"{'36', '保定风帆集团有限责任公司', '上海申能资产管理有限公司', '上海中静四海实业有限公司', '20000000000', '上海衡信市场营销策划有限公司', '易方达基金管理有限公司', '中国银河证券股份有限公司', '大同市南郊区顺成投资有限责任公司', '中信证券股份有限公司', '12'}"
13,"{'5100000', '现金', '34000000', '上海诚鼎德同股权投资基金有限公司', '4420000', '平安资产管理有限责任公司', '25500000', '竞价', '中华联合财产保险股份有限公司', '上海诚鼎扬子投资合伙企业(有限合伙)', '上海德同诚鼎股权投资基金中心(有限合伙)', '36', '7480000'}",1828641,1,{'竞价'},5,"{'现金', '上海诚鼎德同股权投资基金有限公司', '平安资产管理有限责任公司', '中华联合财产保险股份有限公司', '36'}",12,"{'5100000', '现金', '34000000', '上海诚鼎德同股权投资基金有限公司', '4420000', '平安资产管理有限责任公司', '25500000', '中华联合财产保险股份有限公司', '上海诚鼎扬子投资合伙企业(有限合伙)', '上海德同诚鼎股权投资基金中心(有限合伙)', '36', '7480000'}"
6,"{'现金', '97003000', '海亮金属', '竞价', '300000000', '36'}",903067,3,"{'97003000', '竞价', '300000000'}",3,"{'36', '现金', '海亮金属'}",3,"{'36', '现金', '海亮金属'}"
12,"{'民生加银鑫牛定向增发67号资产管理计划', '现金', '17122929', '8709677', '50399994.37', '定价', '196399995.6', '民生加银华鑫信托智选9号资产管理计划', '4394071', '泰达宏利价值成长定向增发641号资产管理计划', '99899995.19', '12'}",16932311,0,set(),3,"{'定价', '现金', '12'}",12,"{'民生加银鑫牛定向增发67号资产管理计划', '现金', '17122929', '8709677', '50399994.37', '定价', '196399995.6', '民生加银华鑫信托智选9号资产管理计划', '4394071', '泰达宏利价值成长定向增发641号资产管理计划', '99899995.19', '12'}"
21,"{'850000000', '合恩伟业', '62972292', '蓝巨投资', '现金', '400000000', '定价', '吉铉投资', '50377834', '36', '900000000', '12594458', '华泰紫金定增4号', '107052897', '113350126', '南通卓联', '绒承投资', '100000000', '500000000', '旭恭投资', '领毅投资'}",1681835,9,"{'113350126', '900000000', '12594458', '400000000', '100000000', '107052897', '850000000', '500000000', '50377834'}",11,"{'蓝巨投资', '36', '南通卓联', '现金', '绒承投资', '定价', '吉铉投资', '华泰紫金定增4号', '旭恭投资', '领毅投资', '合恩伟业'}",12,"{'蓝巨投资', '南通卓联', '现金', '绒承投资', '定价', '华泰紫金定增4号', '领毅投资', '吉铉投资', '旭恭投资', '36', '合恩伟业', '62972292'}"
28,"{'600000000', '180505415', '499999999.6', '920000000', '324909747', '200000000', '72202166', '现金', '332129963', '中国铁建', '定价', '北方工业', '上海彤关', '180000000', '900000000', '员工持股计划', '64981949', '南京璇玑', '216606498', '北京韬蕴', '100000000', '有色控股', '180505000', '36101083', '499998850', '国华人寿', '申万菱信', '36'}",5951490,9,"{'72202166', '332129963', '216606498', '180505415', '499999999.6', '64981949', '180505000', '36101083', '324909747'}",12,"{'现金', '北京韬蕴', '中国铁建', '有色控股', '定价', '员工持股计划', '北方工业', '上海彤关', '国华人寿', '申万菱信', '36', '南京璇玑'}",19,"{'现金', '900000000', '600000000', '100000000', '中国铁建', '北京韬蕴', '有色控股', '定价', '员工持股计划', '920000000', '北方工业', '上海彤关', '499998850', '180000000', '申万菱信', '200000000', '36', '南京璇玑', '国华人寿'}"
5,"{'现金', '60000000', '竞价', '九龙江建设', '36'}",168479,2,"{'竞价', '60000000'}",3,"{'现金', '36', '九龙江建设'}",3,"{'现金', '36', '九龙江建设'}"
20,"{'吴斌', '北信瑞丰基金管理有限公司', '深圳天风天成资产管理有限公司', '15462525', '38860240.39', '博时基金管理有限公司', '深圳市前海梧桐广证定增投资基金企业(有限合伙)', '财通基金管理有限公司', '339999997.4', '228999995.3', '竞价', '209999994.5', '富国基金管理有限公司', '14179608', '韦慧陆', '华福证券有限责任公司', '22957461', '12', '2623919', '银河资本资产管理有限公司'}",14705230,3,"{'228999995.3', '竞价', '209999994.5'}",10,"{'吴斌', '北信瑞丰基金管理有限公司', '深圳天风天成资产管理有限公司', '博时基金管理有限公司', '财通基金管理有限公司', '富国基金管理有限公司', '韦慧陆', '华福证券有限责任公司', '12', '银河资本资产管理有限公司'}",17,"{'吴斌', '北信瑞丰基金管理有限公司', '深圳天风天成资产管理有限公司', '15462525', '38860240.39', '博时基金管理有限公司', '深圳市前海梧桐广证定增投资基金企业(有限合伙)', '财通基金管理有限公司', '339999997.4', '富国基金管理有限公司', '14179608', '韦慧陆', '华福证券有限责任公司', '22957461', '12', '2623919', '银河资本资产管理有限公司'}"
19,"{'霍山衡胜投资管理中心(有限合伙)', '现金', '17530190', '3126000', '霍山衡义投资管理中心(有限合伙)', '2726000', '安徽省铁路建设投资基金有限公司', '博时基金管理有限公司', '7791195', '中广核财务有限责任公司', '7588000', '霍山衡顺投资管理中心(有限合伙)', '竞价', '7800000', '杜应流', '6219310', '国开金融有限责任公司', '36', '6219305'}",1670066,4,"{'霍山衡胜投资管理中心(有限合伙)', '霍山衡顺投资管理中心(有限合伙)', '霍山衡义投资管理中心(有限合伙)', '竞价'}",7,"{'现金', '安徽省铁路建设投资基金有限公司', '博时基金管理有限公司', '中广核财务有限责任公司', '杜应流', '国开金融有限责任公司', '36'}",15,"{'现金', '17530190', '3126000', '2726000', '安徽省铁路建设投资基金有限公司', '博时基金管理有限公司', '7791195', '中广核财务有限责任公司', '7588000', '7800000', '杜应流', '6219310', '国开金融有限责任公司', '36', '6219305'}"
11,"{'20000000', '5000000', '现金', '85000000', '新海天', '上银30号资管计划', '竞价', '上银29号资管计划', '10000000', '36', '上银28号资管计划'}",286471,5,"{'20000000', '5000000', '85000000', '竞价', '10000000'}",6,"{'现金', '新海天', '上银30号资管计划', '上银29号资管计划', '36', '上银28号资管计划'}",6,"{'现金', '新海天', '上银30号资管计划', '上银29号资管计划', '36', '上银28号资管计划'}"
5,"{'股权、现金', '竞价', '30000000', '36', '东药集团'}",1132793,3,"{'竞价', '股权、现金', '30000000'}",1,{'东药集团'},2,"{'36', '东药集团'}"
5,"{'现金', '上海祺禧投资管理合伙企业(有限合伙)', '浙报控股', '竞价', '36'}",173022,1,{'上海祺禧投资管理合伙企业(有限合伙)'},4,"{'竞价', '现金', '浙报控股', '36'}",4,"{'竞价', '现金', '浙报控股', '36'}"
6,"{'现金', '635169600', '连云港港口集团有限公司', '定价', '203580000', '36'}",1044277,1,{'635169600'},4,"{'定价', '现金', '36', '连云港港口集团有限公司'}",5,"{'现金', '连云港港口集团有限公司', '定价', '203580000', '36'}"
16,"{'32637155', '中国中信集团公司', '5000000', '40000000', '宝钢集团有限公司', '中国船舶工业集团公司', '37637155', '中船财务有限责任公司', '264725690', '定价', '上海电气(集团)总公司', '中国人寿保险(集团)公司', '全国社会保障基金理事会', '中国海洋石油总公司', '10000000', '36'}",1358201,0,set(),9,"{'中国中信集团公司', '宝钢集团有限公司', '中国船舶工业集团公司', '中船财务有限责任公司', '全国社会保障基金理事会', '上海电气(集团)总公司', '定价', '中国海洋石油总公司', '36'}",16,"{'32637155', '中国中信集团公司', '5000000', '40000000', '宝钢集团有限公司', '中国船舶工业集团公司', '37637155', '中船财务有限责任公司', '264725690', '定价', '上海电气(集团)总公司', '中国人寿保险(集团)公司', '全国社会保障基金理事会', '中国海洋石油总公司', '10000000', '36'}"
24,"{'179999999.8', '易方达基金管理有限公司', '周雪钦', '17267267', '现金', '12', '149999996.5', '财通基金管理有限公司', '289999996.4', '竞价', '199999999.8', '36', '北信瑞丰基金管理有限公司', '189999996.5', '22522522', '方正证券股份有限公司', '唐山三友碱业(集团)有限公司', '27027027', '28528528', '中欧基金管理有限公司', '30030030', '43543543', '114999998.2', '厦门象屿集团有限公司'}",16303129,2,"{'189999996.5', '289999996.4'}",10,"{'中欧基金管理有限公司', '现金', '北信瑞丰基金管理有限公司', '12', '厦门象屿集团有限公司', '财通基金管理有限公司', '易方达基金管理有限公司', '方正证券股份有限公司', '竞价', '36'}",22,"{'179999999.8', '易方达基金管理有限公司', '周雪钦', '17267267', '现金', '12', '厦门象屿集团有限公司', '149999996.5', '财通基金管理有限公司', '竞价', '199999999.8', '北信瑞丰基金管理有限公司', '22522522', '方正证券股份有限公司', '唐山三友碱业(集团)有限公司', '27027027', '28528528', '中欧基金管理有限公司', '30030030', '43543543', '114999998.2', '36'}"
23,"{'77070000', '56151000', '7000000', '易方达基金管理有限公司', '12164949', '欧海鹰', '5000000', '19073500', '工银瑞信基金管理有限公司', '定价', '邹瀚枢', '财通基金管理有限公司', '69363000', '中国中投证券有限责任公司', '深圳市南方同正投资有限公司', '上海证大投资管理有限公司', '6300000', '国联证券股份有限公司', '1104900', '209999235', '5100000', '上海东方证券资产管理有限公司', '55050000'}",222097,9,"{'209999235', '19073500', '77070000', '56151000', '6300000', '12164949', '69363000', '55050000', '1104900'}",4,"{'邹瀚枢', '定价', '中国中投证券有限责任公司', '欧海鹰'}",14,"{'欧海鹰', '5000000', '5100000', '工银瑞信基金管理有限公司', '邹瀚枢', '中国中投证券有限责任公司', '定价', '财通基金管理有限公司', '7000000', '上海证大投资管理有限公司', '易方达基金管理有限公司', '上海东方证券资产管理有限公司', '深圳市南方同正投资有限公司', '国联证券股份有限公司'}"
5,"{'150000000', '现金', '60', '竞价', '北京华信六合投资有限公司'}",146679,1,{'150000000'},4,"{'北京华信六合投资有限公司', '竞价', '60', '现金'}",4,"{'北京华信六合投资有限公司', '60', '现金', '竞价'}"
4,"{'现金', '竞价', '张近东', '36'}",1071705,1,{'竞价'},3,"{'36', '张近东', '现金'}",3,"{'现金', '张近东', '36'}"
22,"{'1526930', '5552470', '138189973.6', '13569994.7', '华富基金管理有限公司', '现金', '3836479', '竞价', '2165463', '汇添富基金管理股份有限公司', '36', '55000018.6', '1811215', '诺安基金管理有限公司', '65239964.3', '199999969.4', '华宝信托有限责任公司', '创金合信基金管理有限公司', '376735', '12', '河南省宛西控股股份有限公司', '77999977.26'}",1654811,1,{'138189973.6'},10,"{'36', '现金', '诺安基金管理有限公司', '华宝信托有限责任公司', '竞价', '创金合信基金管理有限公司', '华富基金管理有限公司', '汇添富基金管理股份有限公司', '12', '河南省宛西控股股份有限公司'}",21,"{'1526930', '5552470', '13569994.7', '华富基金管理有限公司', '现金', '3836479', '竞价', '2165463', '汇添富基金管理股份有限公司', '36', '55000018.6', '1811215', '诺安基金管理有限公司', '65239964.3', '199999969.4', '华宝信托有限责任公司', '创金合信基金管理有限公司', '376735', '12', '河南省宛西控股股份有限公司', '77999977.26'}"
9,"{'现金', '西藏益升投资合伙企业(有限合伙)', '999999995.1', '72098053', '定价', '199999990.7', '深圳前海复星瑞哲恒嘉投资管理企业(有限合伙)', '36', '14419610'}",1794168,0,set(),3,"{'定价', '现金', '36'}",9,"{'现金', '西藏益升投资合伙企业(有限合伙)', '999999995.1', '72098053', '定价', '199999990.7', '深圳前海复星瑞哲恒嘉投资管理企业(有限合伙)', '36', '14419610'}"
6,"{'现金', '55000000', '定价', '1210550000', '36', '小米科技'}",1676599,1,{'1210550000'},4,"{'36', '定价', '现金', '小米科技'}",5,"{'现金', '55000000', '定价', '36', '小米科技'}"
16,"{'沈利红', '现金', '900000000', '刘首轼', '福建轻纺控股', '100000000', '华夏绿色', '崔中兴', '300000000', '中信建投基金', '方怀月', '福建能源集团', '500000000', '华夏兴邦', '200000000', '36'}",1558867,5,"{'900000000', '100000000', '300000000', '500000000', '200000000'}",11,"{'沈利红', '现金', '刘首轼', '福建轻纺控股', '华夏绿色', '崔中兴', '中信建投基金', '方怀月', '福建能源集团', '华夏兴邦', '36'}",11,"{'沈利红', '现金', '刘首轼', '福建轻纺控股', '华夏绿色', '崔中兴', '中信建投基金', '方怀月', '福建能源集团', '华夏兴邦', '36'}"
10,"{'12000000', '上海恒岚', '现金', '清华控股', '定价', '富国-诚志集合资产管理计划', '25000000', '28000000', '36', '重庆昊海'}",477701,3,"{'12000000', '28000000', '25000000'}",7,"{'上海恒岚', '现金', '清华控股', '定价', '富国-诚志集合资产管理计划', '36', '重庆昊海'}",7,"{'上海恒岚', '现金', '清华控股', '定价', '富国-诚志集合资产管理计划', '36', '重庆昊海'}"
21,"{'20000000', '7000000', '3000000', '9888800', '现金', '浙江省兴合集团公司', '定价', '兴业基金管理有限公司', '10000000', '葛静静', '王益平', '许国锋', '36', '宁波安百利印刷有限公司', '3400000', '4250000', '泰康资产管理有限责任公司', '7100000', '宁波海运集团有限公司', '12', '天津港(集团)有限公司'}",551414,5,"{'20000000', '3000000', '3400000', '7100000', '9888800'}",5,"{'36', '现金', '定价', '宁波海运集团有限公司', '12'}",16,"{'36', '许国锋', '现金', '宁波安百利印刷有限公司', '浙江省兴合集团公司', '定价', '7000000', '兴业基金管理有限公司', '葛静静', '4250000', '泰康资产管理有限责任公司', '10000000', '宁波海运集团有限公司', '王益平', '12', '天津港(集团)有限公司'}"
5,"{'航天科工', '现金', '竞价', '航天资产', '36'}",1424432,0,set(),5,"{'航天科工', '现金', '竞价', '航天资产', '36'}",5,"{'航天科工', '现金', '竞价', '航天资产', '36'}"
4,"{'竞价', '现金', '36', '泰格林纸'}",505619,0,set(),3,"{'竞价', '现金', '泰格林纸'}",4,"{'竞价', '现金', '36', '泰格林纸'}"
28,"{'易方达基金管理有限公司', '898150000', '12500000', '现金', '40000000', '55000000', '380489000', '364159000', '竞价', '34500000', '36', '新疆维吾尔自治区国有资产监督管理委员会', '22300000', '359260000', '国泰基金管理有限公司', '563385000', '377223000', '江苏瑞华投资发展有限公司', '23100000', '653200000', '23300000', '204125000', '嘉实基金管理有限公司', '22000000', '北京鑫天融域投资咨询有限公司', '郑海若', '浙江英维特投资有限公司', '12'}",1319577,12,"{'23100000', '653200000', '380489000', '204125000', '563385000', '359260000', '364159000', '22000000', '898150000', '12500000', '34500000', '377223000'}",12,"{'36', '现金', '江苏瑞华投资发展有限公司', '新疆维吾尔自治区国有资产监督管理委员会', '嘉实基金管理有限公司', '易方达基金管理有限公司', '国泰基金管理有限公司', '竞价', '北京鑫天融域投资咨询有限公司', '郑海若', '浙江英维特投资有限公司', '12'}",16,"{'现金', '40000000', '江苏瑞华投资发展有限公司', '12', '55000000', '新疆维吾尔自治区国有资产监督管理委员会', '23300000', '嘉实基金管理有限公司', '22300000', '国泰基金管理有限公司', '易方达基金管理有限公司', '北京鑫天融域投资咨询有限公司', '竞价', '郑海若', '浙江英维特投资有限公司', '36'}"
6,"{'现金', '大唐集团', '竞价', '8334000000', '36', '2662007515'}",16707991,2,"{'竞价', '8334000000'}",3,"{'现金', '36', '大唐集团'}",4,"{'现金', '36', '2662007515', '大唐集团'}"
16,"{'5447117', '3086702', '现金', '第一创业证券股份有限公司', '36', '兴业全球基金管理有限公司', '博时基金管理有限公司', '财通基金管理有限公司', '竞价', '安徽安益大通股权投资合伙企业(有限合伙)', '18701770', '申万菱信基金管理有限公司', '五都投资有限公司', '4539265', '12', '4539264'}",1842565,3,"{'3086702', '竞价', '5447117'}",9,"{'现金', '第一创业证券股份有限公司', '兴业全球基金管理有限公司', '12', '博时基金管理有限公司', '财通基金管理有限公司', '申万菱信基金管理有限公司', '五都投资有限公司', '36'}",13,"{'36', '现金', '第一创业证券股份有限公司', '兴业全球基金管理有限公司', '博时基金管理有限公司', '财通基金管理有限公司', '安徽安益大通股权投资合伙企业(有限合伙)', '18701770', '申万菱信基金管理有限公司', '五都投资有限公司', '4539265', '12', '4539264'}"
7,"{'现金', '长安平安富贵千金净雅资产管理计划', '定价', '26362039', '17574692', '株洲市国有资产投资控股集团有限公司', '36'}",1749383,0,set(),5,"{'现金', '株洲市国有资产投资控股集团有限公司', '定价', '长安平安富贵千金净雅资产管理计划', '36'}",7,"{'现金', '株洲市国有资产投资控股集团有限公司', '定价', '26362039', '17574692', '长安平安富贵千金净雅资产管理计划', '36'}"
6,"{'现金', '定价', '599970600', '广东南海控股投资有限公司', '60420000', '36'}",1125451,2,"{'60420000', '599970600'}",4,"{'广东南海控股投资有限公司', '现金', '定价', '36'}",4,"{'广东南海控股投资有限公司', '现金', '定价', '36'}"
7,"{'乌鲁木齐国有资产经营有限公司', '现金', '领翔投资有限公司', '定价', '37000000', '20500000', '36'}",1192224,2,"{'37000000', '20500000'}",5,"{'乌鲁木齐国有资产经营有限公司', '现金', '领翔投资有限公司', '定价', '36'}",5,"{'乌鲁木齐国有资产经营有限公司', '现金', '领翔投资有限公司', '定价', '36'}"
4,"{'金港资产', '竞价', '现金', '36'}",1102722,0,set(),4,"{'金港资产', '竞价', '现金', '36'}",4,"{'金港资产', '竞价', '现金', '36'}"
18,"{'150000000', '现金', '225820000', '双星集团', '新润泰', '星业二号', '平安汇通金橙401号', '竞价', '113180000', '平安汇通金橙400号', '平安汇通金橙402号', '青岛国投', '15660000', '16790000', '368750000', '59800000', '36', '星业一号'}",9881498,8,"{'150000000', '225820000', '16790000', '竞价', '15660000', '113180000', '368750000', '59800000'}",7,"{'现金', '双星集团', '新润泰', '星业二号', '青岛国投', '36', '星业一号'}",10,"{'36', '现金', '双星集团', '新润泰', '星业二号', '平安汇通金橙400号', '青岛国投', '平安汇通金橙402号', '平安汇通金橙401号', '星业一号'}"
25,"{'27856736', '名正信融', '165000000', '68561682', '15065378', '灿翔实业', '28425241', '9380329', '天晟泰合', '现金', '3604150', '1206000000', '63397000', '竞价', '仰添投资', '490000000', '智度五云', '通映投资', '修敬资产', '265000000', '骏丰投资', '德符投资', '500000000', '36', '成嘉投资'}",12039803,7,"{'490000000', '1206000000', '165000000', '63397000', '竞价', '500000000', '265000000'}",12,"{'天晟泰合', '现金', '名正信融', '智度五云', '德符投资', '通映投资', '仰添投资', '修敬资产', '灿翔实业', '成嘉投资', '36', '骏丰投资'}",18,"{'27856736', '9380329', '天晟泰合', '现金', '名正信融', '智度五云', '3604150', '德符投资', '68561682', '通映投资', '仰添投资', '15065378', '修敬资产', '灿翔实业', '成嘉投资', '36', '骏丰投资', '28425241'}"
19,"{'渤海证券有限责任公司', '现金、股权', '现金', '中诚信托投资有限公司', '18008816', '江苏瑞华投资发展有限公司', '12', '4000000', '中建材投资有限公司', '2000000', '易方达基金管理有限公司', '竞价', '北京医药集团有限责任公司', '3000000', '信达澳银基金管理有限公司', '泰康资产管理有限公司', '36', '1828774', '2500000'}",1394478,2,"{'现金、股权', '竞价'}",10,"{'36', '渤海证券有限责任公司', '现金', '江苏瑞华投资发展有限公司', '中建材投资有限公司', '易方达基金管理有限公司', '北京医药集团有限责任公司', '信达澳银基金管理有限公司', '泰康资产管理有限公司', '12'}",17,"{'渤海证券有限责任公司', '现金', '中诚信托投资有限公司', '18008816', '江苏瑞华投资发展有限公司', '12', '4000000', '中建材投资有限公司', '2000000', '易方达基金管理有限公司', '北京医药集团有限责任公司', '3000000', '信达澳银基金管理有限公司', '泰康资产管理有限公司', '36', '1828774', '2500000'}"
11,"{'现金', '股权、现金', '38280000', '华君电力', '股权', '保华兴资产', '111111111', '定价', '瑞尔德', '591349629', '36'}",1871897,4,"{'股权、现金', '38280000', '591349629', '111111111'}",7,"{'现金', '华君电力', '保华兴资产', '定价', '瑞尔德', '股权', '36'}",7,"{'现金', '华君电力', '保华兴资产', '定价', '瑞尔德', '股权', '36'}"
7,"{'金鹰基金管理有限公司', '现金', '定价', '高树华', '36', '16064257', '48192771'}",1779670,2,"{'16064257', '48192771'}",5,"{'金鹰基金管理有限公司', '现金', '定价', '高树华', '36'}",5,"{'金鹰基金管理有限公司', '现金', '定价', '高树华', '36'}"
18,"{'39760000', '金鹰基金管理有限公司', '39740000', '现金', '40000000', '华安基金管理有限公司', '博时资本管理有限公司', '39750000', '东兴证券股份有限公司', '诺安基金管理有限公司', '财通基金管理有限公司', '竞价', '广州国寿城市发展产业投资企业(有限合伙)', '广州新华城市发展产业投资企业(有限合伙)', '中国人寿资产管理有限公司', '42920000', '26546307', '12'}",1841871,3,"{'26546307', '39740000', '42920000'}",11,"{'金鹰基金管理有限公司', '现金', '博时资本管理有限公司', '华安基金管理有限公司', '东兴证券股份有限公司', '诺安基金管理有限公司', '财通基金管理有限公司', '竞价', '广州国寿城市发展产业投资企业(有限合伙)', '中国人寿资产管理有限公司', '12'}",15,"{'39760000', '金鹰基金管理有限公司', '现金', '40000000', '华安基金管理有限公司', '博时资本管理有限公司', '39750000', '东兴证券股份有限公司', '诺安基金管理有限公司', '财通基金管理有限公司', '广州国寿城市发展产业投资企业(有限合伙)', '广州新华城市发展产业投资企业(有限合伙)', '竞价', '中国人寿资产管理有限公司', '12'}"
20,"{'平安大华基金管理有限公司', '12000000', '现金', '浙江浙商证券资产管理有限公司', '兴业全球基金管理有限公司', '12', '招商基金管理有限公司', '149024993.6', '114900000', '天弘基金管理有限公司', '7781984', '11070496', '211999998.4', '124475000', '成都博瑞投资控股集团有限公司', '6500000', '6000000', '36', '229800000', '太平资产管理有限公司'}",1097578,0,set(),4,"{'12', '现金', '36', '成都博瑞投资控股集团有限公司'}",20,"{'平安大华基金管理有限公司', '12000000', '现金', '浙江浙商证券资产管理有限公司', '兴业全球基金管理有限公司', '12', '招商基金管理有限公司', '149024993.6', '114900000', '天弘基金管理有限公司', '7781984', '11070496', '211999998.4', '124475000', '成都博瑞投资控股集团有限公司', '6500000', '6000000', '36', '229800000', '太平资产管理有限公司'}"
22,"{'8957219', '新长城基金', '重庆广电认购', '10784314', '17825312', '上峰控股', '现金', '竞价', '华锐投资', '39215686', '204991087', '浙江富润', '新湖中宝认购', '39197861', '35650624', '太子龙控股', '长城集团', '祥生实业认购', '7664884', '7219251', '36', '天津一诺'}",132646,1,{'竞价'},12,"{'上峰控股', '现金', '太子龙控股', '长城集团', '祥生实业认购', '新长城基金', '重庆广电认购', '浙江富润', '华锐投资', '新湖中宝认购', '36', '天津一诺'}",21,"{'8957219', '新长城基金', '重庆广电认购', '10784314', '17825312', '上峰控股', '现金', '华锐投资', '39215686', '204991087', '浙江富润', '新湖中宝认购', '39197861', '35650624', '太子龙控股', '长城集团', '祥生实业认购', '7664884', '7219251', '36', '天津一诺'}"
18,"{'100690011.6', '北京信弘天禾资产管理中心(有限合伙)', '25380710', '滨州市国有资产经营有限公司', '36', '114999995', '12', '定价', '华信期货股份有限公司', '149999996.1', '19458544', '中诚资本管理(北京)有限公司', '济南国惠兴鲁股权投资基金合伙企业(有限合伙)', '天津盛林投资合伙企业(有限合伙)', '武君麒', '59999998.44', '10152284', '17037227'}",16941756,1,{'100690011.6'},6,"{'36', '滨州市国有资产经营有限公司', '定价', '华信期货股份有限公司', '武君麒', '12'}",17,"{'25380710', '北京信弘天禾资产管理中心(有限合伙)', '滨州市国有资产经营有限公司', '36', '114999995', '10152284', '定价', '华信期货股份有限公司', '149999996.1', '19458544', '中诚资本管理(北京)有限公司', '济南国惠兴鲁股权投资基金合伙企业(有限合伙)', '天津盛林投资合伙企业(有限合伙)', '武君麒', '59999998.44', '12', '17037227'}"
5,"{'现金', '350000000', '定价', '冀中能源集团有限责任公司', '36'}",1193659,1,{'350000000'},4,"{'定价', '冀中能源集团有限责任公司', '现金', '36'}",4,"{'定价', '冀中能源集团有限责任公司', '现金', '36'}"
6,"{'大连中以太和投资管理中心(有限合伙)', '上海登君资产管理有限公司与上海阿卯网络科技有限公司拟设立的有限合伙企业', '平安大华沃盈2号资产管理计划', '杭州艮恒投资管理合伙企业(有限合伙)', '长海县獐子岛投资发展中心', '平安大华增利17号资产管理计划'}",1823534,4,"{'平安大华沃盈2号资产管理计划', '大连中以太和投资管理中心(有限合伙)', '杭州艮恒投资管理合伙企业(有限合伙)', '平安大华增利17号资产管理计划'}",2,"{'上海登君资产管理有限公司与上海阿卯网络科技有限公司拟设立的有限合伙企业', '长海县獐子岛投资发展中心'}",2,"{'上海登君资产管理有限公司与上海阿卯网络科技有限公司拟设立的有限合伙企业', '长海县獐子岛投资发展中心'}"
16,"{'京能集团', '三峡集团', '现金', '联东集团', '212389380', '阳光产险', '265486726', '定价', '398230088', '国资公司', 'ING Bank N.V', '889380530', '720000000', '阳光人寿', '144000000', '36'}",18856777,0,set(),10,"{'京能集团', '三峡集团', '现金', '联东集团', '阳光产险', '定价', '国资公司', 'ING Bank N.V', '阳光人寿', '36'}",16,"{'京能集团', '三峡集团', '联东集团', '现金', '212389380', '阳光产险', '265486726', '定价', '398230088', '国资公司', '889380530', '720000000', 'ING Bank N.V', '阳光人寿', '144000000', '36'}"
4,"{'竞价', '现金', '36', '华仪集团'}",495883,1,{'竞价'},3,"{'现金', '36', '华仪集团'}",3,"{'现金', '36', '华仪集团'}"
25,"{'15714285', '129999996', '深圳天风天成资产管理有限公司', '申万菱信(上海)资产管理有限公司', '华泰资产管理有限公司', '北京千石创富资本管理有限公司', '18571428', '现金', '40000000', '定价', '财通基金管理有限公司', '信达澳银基金管理有限公司', '何慧清', '国华人寿保险股份有限公司', '109999995', '164999996', '1378660', '280000000', '138999994', '17142857', '23571428', '19857142', '12', '9650620', '119999999'}",1763011,0,set(),9,"{'现金', '何慧清', '深圳天风天成资产管理有限公司', '定价', '国华人寿保险股份有限公司', '财通基金管理有限公司', '华泰资产管理有限公司', '信达澳银基金管理有限公司', '12'}",25,"{'15714285', '129999996', '深圳天风天成资产管理有限公司', '申万菱信(上海)资产管理有限公司', '华泰资产管理有限公司', '北京千石创富资本管理有限公司', '18571428', '现金', '40000000', '定价', '财通基金管理有限公司', '信达澳银基金管理有限公司', '何慧清', '国华人寿保险股份有限公司', '109999995', '164999996', '1378660', '280000000', '138999994', '17142857', '23571428', '19857142', '12', '9650620', '119999999'}"
21,"{'1200000000', '9096422', '保利久联集团', '72771377', '太平洋资产', '现金', '汇添富基金', '定价', '150000000', '900000000', '6064281', '泰康资产', '保利投资', '国寿资产', '100000000', '光大保德信', '中信证券', '54578532', '南方资本', '36', '新华保险'}",1617931,6,"{'150000000', '6064281', '1200000000', '54578532', '9096422', '72771377'}",13,"{'国寿资产', '现金', '汇添富基金', '定价', '光大保德信', '泰康资产', '中信证券', '南方资本', '保利投资', '保利久联集团', '太平洋资产', '36', '新华保险'}",15,"{'国寿资产', '现金', '900000000', '汇添富基金', '100000000', '定价', '光大保德信', '泰康资产', '中信证券', '南方资本', '保利投资', '保利久联集团', '太平洋资产', '36', '新华保险'}"
13,"{'现金', '上海国药圣礼股权投资基金合伙企业(有限合伙)', '13033100', '黄伟波', '3388606', '平安资产管理有限责任公司', '11028007', '竞价', '320815', '6316041', '嘉兴品松投资合伙企业(有限合伙)', '36', '陈彪'}",1755820,3,"{'竞价', '320815', '3388606'}",5,"{'现金', '黄伟波', '平安资产管理有限责任公司', '36', '陈彪'}",10,"{'现金', '上海国药圣礼股权投资基金合伙企业(有限合伙)', '13033100', '黄伟波', '平安资产管理有限责任公司', '11028007', '6316041', '嘉兴品松投资合伙企业(有限合伙)', '36', '陈彪'}"
19,"{'现金', '葛卫东', '2855511', '100000000', '国金香港', '康哲医药', '1000000000', '6282125', '竞价', '张勇', '1427756', '50000000', '上海混沌道然资产管理有限公司', '屈向军', '220000000', '856653', '30000000', '36', '28555111'}",12003841,7,"{'100000000', '1000000000', '竞价', '50000000', '220000000', '30000000', '28555111'}",8,"{'现金', '葛卫东', '国金香港', '康哲医药', '张勇', '上海混沌道然资产管理有限公司', '屈向军', '36'}",12,"{'现金', '葛卫东', '2855511', '国金香港', '康哲医药', '6282125', '张勇', '1427756', '上海混沌道然资产管理有限公司', '屈向军', '856653', '36'}"
13,"{'现金', '294811', '16115566', '589623', '前海大宇资管计划', '定价', '瀚信资管计划', '周雯', '3000000', '孙红霞', '10000000', '36', '林洺锋'}",1657840,5,"{'294811', '589623', '3000000', '10000000', '16115566'}",8,"{'现金', '前海大宇资管计划', '瀚信资管计划', '定价', '周雯', '孙红霞', '36', '林洺锋'}",8,"{'现金', '前海大宇资管计划', '瀚信资管计划', '定价', '周雯', '孙红霞', '36', '林洺锋'}"
12,"{'36', '林海峰', '649999986.4', '红土创新基金管理有限公司', '12', '46230440', '600000011.2', '1300000015', '深圳市红塔资产管理有限公司', '42674254', '92460883', '李宗松'}",15918649,1,{'1300000015'},6,"{'林海峰', '红土创新基金管理有限公司', '12', '深圳市红塔资产管理有限公司', '李宗松', '36'}",11,"{'36', '林海峰', '649999986.4', '红土创新基金管理有限公司', '12', '46230440', '600000011.2', '深圳市红塔资产管理有限公司', '42674254', '92460883', '李宗松'}"
18,"{'滨州市国有资产经营有限公司', '现金', '民生加银基金管理有限公司', '295799992.8', '7441860', '2303840', '63999996', '250389989', '369996991.6', '英大基金管理有限公司', '19813024', '竞价', '34395348', '天津硅谷天堂盈盛股权投资基金合伙企业(有限合伙)', '长信基金管理有限责任公司', '29115115', '43022906', '12'}",656845,1,{'竞价'},6,"{'滨州市国有资产经营有限公司', '现金', '民生加银基金管理有限公司', '英大基金管理有限公司', '长信基金管理有限责任公司', '12'}",17,"{'滨州市国有资产经营有限公司', '现金', '民生加银基金管理有限公司', '295799992.8', '7441860', '2303840', '63999996', '250389989', '369996991.6', '英大基金管理有限公司', '19813024', '34395348', '天津硅谷天堂盈盛股权投资基金合伙企业(有限合伙)', '长信基金管理有限责任公司', '29115115', '43022906', '12'}"
14,"{'359999997.4', '75434782', '294487', '78260869', '346999997.2', '财通基金管理有限公司', '74347826', '竞价', '341999999.6', '1354640.2', '泰达宏利基金管理有限公司', '建信基金管理有限责任公司', '北京千石创富资本管理有限公司', '12'}",282023,1,{'竞价'},5,"{'财通基金管理有限公司', '泰达宏利基金管理有限公司', '建信基金管理有限责任公司', '北京千石创富资本管理有限公司', '12'}",13,"{'359999997.4', '75434782', '294487', '78260869', '346999997.2', '财通基金管理有限公司', '74347826', '341999999.6', '1354640.2', '泰达宏利基金管理有限公司', '建信基金管理有限责任公司', '北京千石创富资本管理有限公司', '12'}"
10,"{'泰达宏利', '23282887', '彭杏妮', '定价', '399999998.7', '帅放文', '799999997.3', '夏哲', '36', '46565774'}",1834967,1,{'399999998.7'},5,"{'泰达宏利', '彭杏妮', '定价', '帅放文', '夏哲'}",9,"{'泰达宏利', '23282887', '彭杏妮', '定价', '帅放文', '799999997.3', '夏哲', '36', '46565774'}"
18,"{'现金', '华安基金管理有限公司', '4032258', '149999979', '定价', '深圳菁英时代资本管理有限公司', '中国华融资产管理股份有限公司', '4838709', '124999998', '安信基金管理有限责任公司', '申万菱信基金管理有限公司', '249999996', '方正富邦基金管理有限公司', '3225807', '8064516', '富荣基金管理有限公司', '100000017', '12'}",14761798,0,set(),10,"{'现金', '华安基金管理有限公司', '定价', '深圳菁英时代资本管理有限公司', '中国华融资产管理股份有限公司', '安信基金管理有限责任公司', '申万菱信基金管理有限公司', '方正富邦基金管理有限公司', '富荣基金管理有限公司', '12'}",18,"{'现金', '华安基金管理有限公司', '4032258', '149999979', '定价', '深圳菁英时代资本管理有限公司', '中国华融资产管理股份有限公司', '4838709', '124999998', '安信基金管理有限责任公司', '申万菱信基金管理有限公司', '249999996', '方正富邦基金管理有限公司', '3225807', '8064516', '富荣基金管理有限公司', '100000017', '12'}"
21,"{'华宝兴业基金管理有限公司', '5700000', '16000000', '易方达基金管理有限公司', '6000000', '4149444', '郑州宇通集团有限公司', '79800000', '现金', '上投摩根基金管理有限公司', '140980000', '财通基金管理有限公司', '212800000', '太平洋资产管理有限责任公司', '10600000', '75466195', '75810000', '金鹰基金管理有限公司', '5674150', '55187605.2', '12'}",1106262,0,set(),5,"{'金鹰基金管理有限公司', '现金', '郑州宇通集团有限公司', '财通基金管理有限公司', '12'}",21,"{'华宝兴业基金管理有限公司', '5700000', '16000000', '易方达基金管理有限公司', '6000000', '4149444', '郑州宇通集团有限公司', '79800000', '现金', '上投摩根基金管理有限公司', '140980000', '财通基金管理有限公司', '212800000', '太平洋资产管理有限责任公司', '10600000', '75466195', '75810000', '金鹰基金管理有限公司', '5674150', '55187605.2', '12'}"
20,"{'48960000', '邦信资产管理有限公司', '2200000', '54400000', '40800000', '12', '4000000', '定价', '李刚', '3600000', '1540000', '厦门海翼投资有限公司', '上海凯思依投资管理合伙企业(有限合伙)', '常州投资集团有限公司', '3000000', '20944000', '西安长国投资管理有限合伙企业', '五矿国际信托有限公司', '29920000', '西安长咸投资管理有限合伙企业'}",1317744,6,"{'29920000', '54400000', '40800000', '1540000', '20944000', '48960000'}",8,"{'邦信资产管理有限公司', '定价', '厦门海翼投资有限公司', '常州投资集团有限公司', '西安长国投资管理有限合伙企业', '五矿国际信托有限公司', '12', '西安长咸投资管理有限合伙企业'}",14,"{'邦信资产管理有限公司', '2200000', '4000000', '李刚', '定价', '3600000', '厦门海翼投资有限公司', '上海凯思依投资管理合伙企业(有限合伙)', '常州投资集团有限公司', '3000000', '西安长国投资管理有限合伙企业', '五矿国际信托有限公司', '12', '西安长咸投资管理有限合伙企业'}"
7,"{'现金', '锦江酒店集团', '100000000', '定价', '101277000', '弘毅投资基金', '36'}",580330,0,set(),5,"{'现金', '锦江酒店集团', '定价', '弘毅投资基金', '36'}",7,"{'现金', '锦江酒店集团', '100000000', '定价', '101277000', '弘毅投资基金', '36'}"
13,"{'5000000', '现金', '理成全球视野3期投资基金', '理成南都资产管理计划', '定价', '23000000', '64000000', '41000000', '杭州九纳投资合伙企业(有限合伙)', '42000000', '海通定增1号定向资产管理计划', '宁波中金富盈股权投资合伙企业(有限合伙)', '36'}",1657006,8,"{'5000000', '23000000', '杭州九纳投资合伙企业(有限合伙)', '41000000', '64000000', '42000000', '海通定增1号定向资产管理计划', '宁波中金富盈股权投资合伙企业(有限合伙)'}",5,"{'现金', '理成全球视野3期投资基金', '理成南都资产管理计划', '定价', '36'}",5,"{'现金', '理成全球视野3期投资基金', '理成南都资产管理计划', '定价', '36'}"
6,"{'现金', '定价', '一重集团', '1550947196', '319782927', '36'}",16827477,1,{'1550947196'},4,"{'一重集团', '定价', '现金', '36'}",5,"{'现金', '定价', '一重集团', '319782927', '36'}"
9,"{'现金', '907029478', '102040816', '11337869', '定价', '天津聚金物业管理有限公司', '重庆国际信托股份有限公司', '华宝信托有限责任公司', '12'}",15343186,0,set(),3,"{'定价', '现金', '12'}",9,"{'现金', '907029478', '102040816', '11337869', '定价', '天津聚金物业管理有限公司', '重庆国际信托股份有限公司', '华宝信托有限责任公司', '12'}"
9,"{'10390000', '现金', '100000000', '20770000', '方海江', '竞价', '200000000', '四方达第1期员工持股计划', '36'}",292536,5,"{'10390000', '100000000', '20770000', '竞价', '200000000'}",2,"{'方海江', '现金'}",4,"{'方海江', '现金', '四方达第1期员工持股计划', '36'}"
6,"{'现金', '其他特定投资者', '12', '竞价', '中化股份', '36'}",411715,0,set(),6,"{'现金', '其他特定投资者', '12', '竞价', '中化股份', '36'}",6,"{'36', '现金', '其他特定投资者', '竞价', '中化股份', '12'}"
17,"{'金鹰基金管理有限公司', '32442396', '戚亮', '富国资产管理(上海)有限公司', '长安基金管理有限公司', '27649769', '132000025.9', '351999996.6', '299999993.7', '12165901', '财通基金管理有限公司', '147999989.2', '金元顺安基金管理有限公司', '13640552', '399999995.2', '36866359', '12'}",15804334,3,"{'399999995.2', '299999993.7', '132000025.9'}",6,"{'金鹰基金管理有限公司', '长安基金管理有限公司', '戚亮', '财通基金管理有限公司', '金元顺安基金管理有限公司', '12'}",14,"{'金鹰基金管理有限公司', '32442396', '戚亮', '富国资产管理(上海)有限公司', '长安基金管理有限公司', '27649769', '351999996.6', '12165901', '财通基金管理有限公司', '147999989.2', '金元顺安基金管理有限公司', '13640552', '36866359', '12'}"
21,"{'兴业全球基金资产管理有限公司', '11412351', '申万菱信(上海)资产管理有限公司', '现金', '71089200', '天安财产保险股份有限公司', '竞价', '宝盈基金管理有限公司', '华夏人寿保险股份有限公司', '71052000', '3848970', '71000000', '3892394', '210671999.5', '71853600', '3850985', '3656839', '213000000', '11538461', '安信证券股份有限公司', '12'}",291199,1,{'210671999.5'},14,"{'华夏人寿保险股份有限公司', '现金', '兴业全球基金资产管理有限公司', '11412351', '3848970', '安信证券股份有限公司', '3850985', '天安财产保险股份有限公司', '3656839', '竞价', '3892394', '11538461', '宝盈基金管理有限公司', '12'}",20,"{'华夏人寿保险股份有限公司', '现金', '71052000', '71089200', '兴业全球基金资产管理有限公司', '11412351', '3848970', '宝盈基金管理有限公司', '申万菱信(上海)资产管理有限公司', '71853600', '天安财产保险股份有限公司', '3850985', '3656839', '71000000', '竞价', '213000000', '3892394', '11538461', '安信证券股份有限公司', '12'}"
24,"{'君证(上海)股权投资基金合伙企业(有限合伙)', '421994143', '673394875.3', '448929920.8', '上海上投资产经营有限公司', '525248004.4', '现金', '51468033', '598573223.8', '45163199', '定价', '85984522', '57901537', '北京中融鼎新投资管理有限公司', '中国长城资产管理公司', '36284965', '中信证券股份有限公司', '38601025', '20120378', '上银基金管理有限公司', '999999990.9', '233999996.1', '曹文龙', '36'}",1878570,5,"{'421994143', '598573223.8', '999999990.9', '448929920.8', '525248004.4'}",9,"{'现金', '定价', '北京中融鼎新投资管理有限公司', '中国长城资产管理公司', '中信证券股份有限公司', '上海上投资产经营有限公司', '曹文龙', '36', '上银基金管理有限公司'}",19,"{'君证(上海)股权投资基金合伙企业(有限合伙)', '20120378', '现金', '51468033', '45163199', '57901537', '定价', '673394875.3', '85984522', '中国长城资产管理公司', '中信证券股份有限公司', '上海上投资产经营有限公司', '北京中融鼎新投资管理有限公司', '36284965', '233999996.1', '曹文龙', '36', '上银基金管理有限公司', '38601025'}"
4,"{'现金', '竞价', '星星集团有限公司', '36'}",401596,0,set(),4,"{'36', '竞价', '星星集团有限公司', '现金'}",4,"{'36', '竞价', '星星集团有限公司', '现金'}"
4,"{'36', '定价', '现金', '东证资管-东港股份定向资产管理计划'}",1724830,0,set(),3,"{'36', '定价', '现金'}",4,"{'36', '定价', '现金', '东证资管-东港股份定向资产管理计划'}"
8,"{'20000000', '现金', '银基金管理有限公司拟设立的资产管理计划', '呼和浩特昌福兴投资管理企业', '6000000', '10000000', '36', '内蒙古金河建筑安装有限责任公司'}",322567,3,"{'20000000', '6000000', '10000000'}",5,"{'现金', '银基金管理有限公司拟设立的资产管理计划', '呼和浩特昌福兴投资管理企业', '36', '内蒙古金河建筑安装有限责任公司'}",5,"{'现金', '银基金管理有限公司拟设立的资产管理计划', '呼和浩特昌福兴投资管理企业', '36', '内蒙古金河建筑安装有限责任公司'}"
11,"{'华宸未来基金管理有限公司', '现金', '华夏资本管理有限公司', '长安基金管理有限公司', '649952000', '14000000', '18700000', '60800000', '149660000', '199903000', '36'}",717417,3,"{'14000000', '18700000', '60800000'}",5,"{'现金', '华宸未来基金管理有限公司', '长安基金管理有限公司', '华夏资本管理有限公司', '36'}",8,"{'华宸未来基金管理有限公司', '现金', '华夏资本管理有限公司', '长安基金管理有限公司', '649952000', '149660000', '199903000', '36'}"
17,"{'现金', '50652000', '吴宏亮', '2309700', '99856800', '1050000', '定价', '林海音', '长江资管', '75978000', '1380000', '马斌', '3540000', '700000', '苏宁文化', '36', '256154400'}",1856588,1,{'2309700'},8,"{'现金', '吴宏亮', '林海音', '定价', '长江资管', '马斌', '苏宁文化', '36'}",16,"{'现金', '50652000', '吴宏亮', '99856800', '1050000', '林海音', '定价', '长江资管', '75978000', '1380000', '马斌', '3540000', '700000', '苏宁文化', '36', '256154400'}"
19,"{'51729141', '712999985.2', '日照岚桥港务有限公司', '现金', '60350665', '43107617', '855599992.1', '60', '1140799990', '瀚博汇鑫(天津)投资有限公司', '998199999.1', '77593712', '1283399996', '竞价', '68972188', '湘财证券股份有限公司', '上海国之杰投资发展有限公司', '上海公信实业有限公司', '36'}",15593544,3,"{'712999985.2', '竞价', '1140799990'}",7,"{'日照岚桥港务有限公司', '现金', '60', '湘财证券股份有限公司', '上海国之杰投资发展有限公司', '上海公信实业有限公司', '36'}",16,"{'51729141', '日照岚桥港务有限公司', '60350665', '43107617', '现金', '855599992.1', '60', '瀚博汇鑫(天津)投资有限公司', '998199999.1', '77593712', '1283399996', '68972188', '湘财证券股份有限公司', '上海国之杰投资发展有限公司', '上海公信实业有限公司', '36'}"
8,"{'20000000', '5000000', '上银基金财富28号资产管理计划', '5532000', '竞价', '湖北新海天投资有限公司', '上银基金财富29号资产管理计划', '36'}",9894819,3,"{'5532000', '5000000', '竞价'}",2,"{'湖北新海天投资有限公司', '36'}",5,"{'20000000', '上银基金财富28号资产管理计划', '湖北新海天投资有限公司', '上银基金财富29号资产管理计划', '36'}"
18,"{'109999997.6', '现金', '185999997.3', '52252200.78', '银华基金管理股份有限公司', '5153077', '定价', '博时基金管理有限公司', '上海并购股权投资基金合伙企业', '财通基金管理有限公司', '424577993.6', '18343195', '41871597', '常州投资集团有限公司', '119999994.7', '12', '10848126', '11834319'}",15706527,2,"{'119999994.7', '424577993.6'}",8,"{'现金', '银华基金管理股份有限公司', '博时基金管理有限公司', '上海并购股权投资基金合伙企业', '定价', '财通基金管理有限公司', '常州投资集团有限公司', '12'}",16,"{'109999997.6', '185999997.3', '52252200.78', '现金', '银华基金管理股份有限公司', '5153077', '定价', '博时基金管理有限公司', '上海并购股权投资基金合伙企业', '财通基金管理有限公司', '18343195', '41871597', '常州投资集团有限公司', '12', '10848126', '11834319'}"
28,"{'97984395.6', '长安基金管理有限公司', '99999995.55', '国联安基金管理有限公司', '21535032', '122195996.7', '100391996.3', '现金', '兴业全球基金管理有限公司', '26856263', '89996998', '澜华投资', '32967033', '财通基金管理有限公司', '150000000.2', '竞价', '21978021', '太平洋资产管理有限公司', '36', '535432', '136994398.5', '2436215.6', '上银基金管理有限公司', '22064175', '19779560', '30108659', '上海东源添东投资中心(有限合伙)', '12'}",319288,6,"{'136994398.5', '99999995.55', '150000000.2', '竞价', '122195996.7', '100391996.3'}",10,"{'36', '现金', '长安基金管理有限公司', '兴业全球基金管理有限公司', '澜华投资', '国联安基金管理有限公司', '财通基金管理有限公司', '太平洋资产管理有限公司', '12', '上银基金管理有限公司'}",22,"{'97984395.6', '长安基金管理有限公司', '国联安基金管理有限公司', '21535032', '现金', '兴业全球基金管理有限公司', '26856263', '89996998', '澜华投资', '32967033', '财通基金管理有限公司', '21978021', '太平洋资产管理有限公司', '36', '535432', '2436215.6', '上银基金管理有限公司', '22064175', '19779560', '30108659', '上海东源添东投资中心(有限合伙)', '12'}"
6,"{'现金', '竞价', '300000000', '中国南方工业集团公司', '36', '37500000'}",852760,2,"{'竞价', '37500000'}",3,"{'中国南方工业集团公司', '现金', '36'}",4,"{'现金', '中国南方工业集团公司', '300000000', '36'}"
10,"{'李洪国', '国投瑞银基金管理有限公司', '博时基金管理有限公司', '财通基金管理有限公司', '国泰基金管理有限公司', '竞价', '4743887', '4900000', '4800000', '12'}",15446383,0,set(),7,"{'李洪国', '博时基金管理有限公司', '财通基金管理有限公司', '国泰基金管理有限公司', '竞价', '国投瑞银基金管理有限公司', '12'}",10,"{'李洪国', '国投瑞银基金管理有限公司', '博时基金管理有限公司', '财通基金管理有限公司', '国泰基金管理有限公司', '4743887', '竞价', '4900000', '4800000', '12'}"
4,"{'淮南矿业', '现金', '1019628878', '36'}",1087581,1,{'1019628878'},3,"{'淮南矿业', '现金', '36'}",3,"{'淮南矿业', '现金', '36'}"
15,"{'5000000', '现金', '华夏基金管理有限公司', '中国太平洋人寿保险股份有限公司', '35000000', '深圳市创新投资集团有限公司', '新创机电工程有限公司', '15000000', '博时基金管理有限公司', '华能资本服务有限公司', '3000000', '25000000', '南方基金管理有限公司', '10000000', '12'}",953643,2,"{'15000000', '25000000'}",2,"{'现金', '12'}",13,"{'5000000', '现金', '华夏基金管理有限公司', '中国太平洋人寿保险股份有限公司', '35000000', '深圳市创新投资集团有限公司', '新创机电工程有限公司', '博时基金管理有限公司', '华能资本服务有限公司', '3000000', '南方基金管理有限公司', '10000000', '12'}"
20,"{'平安大华基金管理有限公司', '招商财富资产管理有限公司', '79999980', '7084049', '2542911', '6993006', '219999969', '13986013', '15861411', '安徽省铁路建设投资基金有限公司', '222864181', '定价', '498999990', '财通基金管理有限公司', '嘉实基金管理有限公司', '中信证券股份有限公司', '银河基金管理有限公司', '439999969', '国投瑞银基金管理有限公司', '12'}",1733619,9,"{'7084049', '79999980', '2542911', '6993006', '219999969', '15861411', '222864181', '498999990', '439999969'}",10,"{'平安大华基金管理有限公司', '招商财富资产管理有限公司', '安徽省铁路建设投资基金有限公司', '定价', '财通基金管理有限公司', '嘉实基金管理有限公司', '中信证券股份有限公司', '银河基金管理有限公司', '国投瑞银基金管理有限公司', '12'}",11,"{'平安大华基金管理有限公司', '招商财富资产管理有限公司', '13986013', '安徽省铁路建设投资基金有限公司', '定价', '财通基金管理有限公司', '嘉实基金管理有限公司', '中信证券股份有限公司', '银河基金管理有限公司', '国投瑞银基金管理有限公司', '12'}"
4,"{'145189606', '太阳控股', '现金', '36'}",1201264,0,set(),3,"{'太阳控股', '现金', '36'}",4,"{'145189606', '太阳控股', '现金', '36'}"
18,"{'平安大华基金管理有限公司', '广发证券资产管理(广东)有限公司', '现金', '北信瑞丰基金管理有限公司', '华安基金管理有限公司', '国华人寿保险份有限公司', '12189616', '24379232', '12668174', '长安基金管理有限公司', '13950338', '财通基金管理有限公司', '12505643', '13363431', '竞价', '中国华电集团财务有限公司', '20650112', '12'}",1680033,9,"{'广发证券资产管理(广东)有限公司', '12189616', '24379232', '12668174', '13950338', '12505643', '13363431', '竞价', '20650112'}",9,"{'平安大华基金管理有限公司', '现金', '北信瑞丰基金管理有限公司', '华安基金管理有限公司', '长安基金管理有限公司', '国华人寿保险份有限公司', '财通基金管理有限公司', '中国华电集团财务有限公司', '12'}",9,"{'平安大华基金管理有限公司', '现金', '北信瑞丰基金管理有限公司', '华安基金管理有限公司', '长安基金管理有限公司', '国华人寿保险份有限公司', '财通基金管理有限公司', '中国华电集团财务有限公司', '12'}"
14,"{'现金', '重庆市城市建设投资公司', '100000000', '定价', '重庆润江基础设施投资有限公司', '重庆市江北嘴中央商务区开发投资有限公司', '18700000', '50000000', '重庆市水利投资(集团)有限公司', '云南省城市建设投资有限公司', '北京盛联投资有限公司', '重庆高速公路集团有限公司', '上海世兆投资管理有限公司', '12'}",1460500,0,set(),3,"{'定价', '现金', '12'}",14,"{'现金', '重庆市城市建设投资公司', '100000000', '定价', '重庆润江基础设施投资有限公司', '重庆市江北嘴中央商务区开发投资有限公司', '18700000', '50000000', '重庆市水利投资(集团)有限公司', '云南省城市建设投资有限公司', '北京盛联投资有限公司', '重庆高速公路集团有限公司', '上海世兆投资管理有限公司', '12'}"
14,"{'现金', '泰熙投资', '盈灿投资', '638977635', '159744408', '泰元投资', '449201277', '399361022', '1406000000', '2000000000', '500000000', '华信工业', '36', '1250000000'}",15536072,4,"{'1406000000', '2000000000', '500000000', '1250000000'}",6,"{'36', '现金', '泰元投资', '华信工业', '泰熙投资', '盈灿投资'}",10,"{'36', '现金', '泰熙投资', '638977635', '159744408', '泰元投资', '449201277', '399361022', '华信工业', '盈灿投资'}"
12,"{'现金', '宁波信达中建置业有限公司', '兴业证券股份有限公司', '2000000', '兴业基金管理有限公司', '竞价', '3000000', '杭州华宁投资管理咨询有限公司', '6000000', '10000000', '上海证券有限责任公司', '12'}",550585,1,{'竞价'},6,"{'现金', '宁波信达中建置业有限公司', '兴业证券股份有限公司', '杭州华宁投资管理咨询有限公司', '上海证券有限责任公司', '12'}",11,"{'现金', '宁波信达中建置业有限公司', '兴业证券股份有限公司', '2000000', '兴业基金管理有限公司', '3000000', '杭州华宁投资管理咨询有限公司', '6000000', '10000000', '上海证券有限责任公司', '12'}"
3,"{'成都市兴蓉投资有限公司', '36', '159559300'}",1065029,1,{'159559300'},2,"{'成都市兴蓉投资有限公司', '36'}",2,"{'成都市兴蓉投资有限公司', '36'}"
12,"{'150000000', '铁路投资', '现金', '650000000', '450000000', '齐鲁投资', '竞价', '300000000', '社保基金理事会', '云南通达', '高速集团', '36'}",6549553,4,"{'450000000', '150000000', '300000000', '650000000'}",8,"{'铁路投资', '现金', '齐鲁投资', '竞价', '社保基金理事会', '云南通达', '高速集团', '36'}",8,"{'铁路投资', '现金', '齐鲁投资', '竞价', '社保基金理事会', '云南通达', '高速集团', '36'}"
7,"{'现金', '定价', '东吴基金', '8382229', '建信基金', '10058675', '36'}",1692798,0,set(),5,"{'现金', '定价', '东吴基金', '建信基金', '36'}",7,"{'现金', '定价', '东吴基金', '8382229', '建信基金', '10058675', '36'}"
5,"{'现金', '427238106', '刘晓东', '竞价', '36'}",1870402,1,{'427238106'},4,"{'36', '竞价', '现金', '刘晓东'}",4,"{'36', '竞价', '现金', '刘晓东'}"
8,"{'上海磐厚投资管理有限公司', '邦信资产管理有限公司', '2900000', '竞价', '西安长顿投资管理有限合伙企业', '4200000', '6500000', '12'}",209017,2,"{'竞价', '2900000'}",1,{'12'},6,"{'上海磐厚投资管理有限公司', '邦信资产管理有限公司', '西安长顿投资管理有限合伙企业', '4200000', '6500000', '12'}"
5,"{'现金', '42330951', '国购投资有限公司', '竞价', '36'}",2235466,2,"{'竞价', '42330951'}",3,"{'国购投资有限公司', '现金', '36'}",3,"{'国购投资有限公司', '现金', '36'}"
5,"{'华夏基金管理有限公司', '竞价', '6000000', '华商基金管理有限公司', '12'}",493916,1,{'竞价'},3,"{'华商基金管理有限公司', '12', '华夏基金管理有限公司'}",4,"{'6000000', '华商基金管理有限公司', '12', '华夏基金管理有限公司'}"
23,"{'175999994.4', '153840026.9', '现金', '156299992.5', '定价', '239999991.3', '鹏华基金管理有限公司', '401999988.9', '13450946', '51635112', '北信瑞丰基金管理有限公司', '博时基金管理有限公司', '吕志炎', '23395869', '中信证券股份有限公司', '34595524', '600000001.4', '13239245', '15146299', '20654044', '271859997.8', '安信基金管理有限责任公司', '12'}",15943421,4,"{'271859997.8', '175999994.4', '239999991.3', '401999988.9'}",9,"{'现金', '北信瑞丰基金管理有限公司', '定价', '博时基金管理有限公司', '吕志炎', '中信证券股份有限公司', '鹏华基金管理有限公司', '安信基金管理有限责任公司', '12'}",19,"{'600000001.4', '现金', '156299992.5', '13239245', '北信瑞丰基金管理有限公司', '51635112', '15146299', '博时基金管理有限公司', '定价', '吕志炎', '23395869', '中信证券股份有限公司', '153840026.9', '鹏华基金管理有限公司', '20654044', '安信基金管理有限责任公司', '34595524', '12', '13450946'}"
4,"{'深圳市前海阳诚实业发展有限公司', '现金', '竞价', '36'}",10803536,0,set(),4,"{'深圳市前海阳诚实业发展有限公司', '现金', '竞价', '36'}",4,"{'深圳市前海阳诚实业发展有限公司', '现金', '竞价', '36'}"
18,"{'平安大华基金管理有限公司', '149999997.6', '7526881', '现金', '第一创业证券股份有限公司', '89999996.7', '大成基金管理有限公司', '信诚基金管理有限公司', '69999993.3', '定价', '31555227', '财通基金管理有限公司', '9677419', '9354838', '16129032', '293463611.1', '86999993.4', '12'}",16039353,0,set(),8,"{'平安大华基金管理有限公司', '现金', '第一创业证券股份有限公司', '大成基金管理有限公司', '信诚基金管理有限公司', '定价', '财通基金管理有限公司', '12'}",18,"{'平安大华基金管理有限公司', '149999997.6', '7526881', '现金', '第一创业证券股份有限公司', '89999996.7', '大成基金管理有限公司', '信诚基金管理有限公司', '69999993.3', '定价', '31555227', '财通基金管理有限公司', '9677419', '9354838', '16129032', '293463611.1', '86999993.4', '12'}"
14,"{'8032128', '招商财富资产管理有限公司', '239999994.6', '长安基金管理有限公司', '136000015.2', '5461848', '413999999.4', '199999987.2', '16626506', '安泰科技股份有限公司', '易方达基金管理有限公司', '竞价', '9638554', '12'}",1573389,1,{'竞价'},5,"{'招商财富资产管理有限公司', '长安基金管理有限公司', '安泰科技股份有限公司', '易方达基金管理有限公司', '12'}",13,"{'8032128', '招商财富资产管理有限公司', '239999994.6', '长安基金管理有限公司', '136000015.2', '5461848', '413999999.4', '199999987.2', '16626506', '安泰科技股份有限公司', '易方达基金管理有限公司', '9638554', '12'}"
19,"{'14400000', '现金', '6100000', '444000007', '158400000', '华安基金管理有限公司', '杭谷', '12', '67100000', '定价', '4500000', '国联安基金管理有限公司', '20999990', '广发基金管理有限公司', '40363637', '1909090', '36', '张家港保税区金港资产经营有限公司', '49500000'}",349090,0,set(),4,"{'定价', '现金', '12', '张家港保税区金港资产经营有限公司'}",19,"{'14400000', '现金', '6100000', '444000007', '158400000', '华安基金管理有限公司', '杭谷', '12', '67100000', '4500000', '定价', '国联安基金管理有限公司', '20999990', '广发基金管理有限公司', '40363637', '1909090', '36', '张家港保税区金港资产经营有限公司', '49500000'}"
14,"{'1027274008', '巨人投资有限公司', '科瑞集团有限公司', '34474008', '33702202', '北京长石投资有限公司', '43607048', '定价', '103679295', '资产', '北京合力同创投资有限公司', '泛海能源投资股份有限公司', '新华联控股有限公司', '36'}",883395,0,set(),9,"{'巨人投资有限公司', '科瑞集团有限公司', '北京长石投资有限公司', '定价', '资产', '北京合力同创投资有限公司', '泛海能源投资股份有限公司', '新华联控股有限公司', '36'}",14,"{'1027274008', '巨人投资有限公司', '科瑞集团有限公司', '34474008', '33702202', '北京长石投资有限公司', '43607048', '定价', '103679295', '资产', '北京合力同创投资有限公司', '泛海能源投资股份有限公司', '新华联控股有限公司', '36'}"
6,"{'现金', '15000000', '上海上科科技投资有限公司', '上海复旦科技产业控股有限公司', '36', '45000000'}",1133746,2,"{'15000000', '45000000'}",4,"{'36', '上海复旦科技产业控股有限公司', '上海上科科技投资有限公司', '现金'}",4,"{'现金', '上海复旦科技产业控股有限公司', '上海上科科技投资有限公司', '36'}"
4,"{'竞价', '现金', '京新控股', '36'}",1089463,0,set(),4,"{'竞价', '现金', '京新控股', '36'}",4,"{'竞价', '现金', '京新控股', '36'}"
20,"{'26750000', '江苏汇鸿国际集团中锦控股有限公司', '现金', '周艳', '王绍林', '新疆广汇实业投资(集团)有限责任公司', '8600000', '12', '上海力利投资管理合伙企业(有限合伙)', '定价', '华夏基金管理有限公司', '昆明盛世景投资中心(有限合伙)', '7000000', '9800000', '7600000', '景隆融尊(天津)股权投资基金合伙企业(有限合伙)', '8000000', '36', '2337181', '上海德华投资有限公司'}",1496951,1,{'2337181'},8,"{'36', '江苏汇鸿国际集团中锦控股有限公司', '现金', '周艳', '王绍林', '定价', '12', '上海德华投资有限公司'}",19,"{'26750000', '江苏汇鸿国际集团中锦控股有限公司', '现金', '周艳', '王绍林', '新疆广汇实业投资(集团)有限责任公司', '8600000', '12', '上海力利投资管理合伙企业(有限合伙)', '华夏基金管理有限公司', '定价', '昆明盛世景投资中心(有限合伙)', '7000000', '9800000', '7600000', '景隆融尊(天津)股权投资基金合伙企业(有限合伙)', '8000000', '36', '上海德华投资有限公司'}"
24,"{'红土创新基金管理有限公司', '168999964', '泰达宏利基金管理有限公司', '7216494', '154999988.9', '42585798.45', '299999995.6', '现金', '新沃基金管理有限公司', '财通基金管理有限公司', '竞价', '272999968', '鹏华资产管理(深圳)有限公司', '5286809', '4097277', '6000528', '农银汇理(上海)资产管理有限公司', '226999974.2', '199999984.5', '4467353', '1125715', '7930214', '胡逸舟', '12'}",15366621,3,"{'竞价', '199999984.5', '168999964'}",7,"{'现金', '红土创新基金管理有限公司', '新沃基金管理有限公司', '财通基金管理有限公司', '胡逸舟', '泰达宏利基金管理有限公司', '12'}",21,"{'红土创新基金管理有限公司', '42585798.45', '7216494', '泰达宏利基金管理有限公司', '154999988.9', '299999995.6', '现金', '新沃基金管理有限公司', '财通基金管理有限公司', '272999968', '鹏华资产管理(深圳)有限公司', '5286809', '4097277', '6000528', '农银汇理(上海)资产管理有限公司', '226999974.2', '4467353', '1125715', '7930214', '胡逸舟', '12'}"
13,"{'36', '陈华娟', '钱旭峰', '3500000', '1000000', '陈光辉', '郑坚江', '52300000', '李健', '1200000', '蒋盈', '10000000', '郑江'}",303000,4,"{'1200000', '1000000', '10000000', '52300000'}",8,"{'36', '陈华娟', '钱旭峰', '陈光辉', '郑坚江', '李健', '蒋盈', '郑江'}",9,"{'36', '陈华娟', '钱旭峰', '3500000', '陈光辉', '郑坚江', '李健', '蒋盈', '郑江'}"
18,"{'12000000', '20000000', '渤海证券有限责任公司', '现金', '上投摩根基金管理有限公司', '中信建投证券有限责任公司', '12', '14000000', '13000000', '中国人民财产保险股份有限公司', '易方达基金管理有限公司', '11000000', '北京城建集团有限责任公司', '江苏开元国际集团轻工业品进出口股份有限公司', '建信基金管理有限责任公司', '罗蒙集团股份有限公司', '36', '富通银行'}",537006,1,{'11000000'},7,"{'渤海证券有限责任公司', '现金', '中信建投证券有限责任公司', '12', '北京城建集团有限责任公司', '罗蒙集团股份有限公司', '36'}",17,"{'12000000', '20000000', '渤海证券有限责任公司', '现金', '上投摩根基金管理有限公司', '中信建投证券有限责任公司', '12', '14000000', '13000000', '中国人民财产保险股份有限公司', '易方达基金管理有限公司', '北京城建集团有限责任公司', '江苏开元国际集团轻工业品进出口股份有限公司', '建信基金管理有限责任公司', '罗蒙集团股份有限公司', '36', '富通银行'}"
11,"{'华安基金管理有限公司', '兴业全球基金管理有限公司', '7000000', '中国长城资产管理公司', '太平资产管理有限公司', '4413200', '中国对外经济贸易信托有限公司', '12500000', '高翔', '12', '7500000'}",407228,0,set(),7,"{'华安基金管理有限公司', '兴业全球基金管理有限公司', '12', '中国长城资产管理公司', '高翔', '中国对外经济贸易信托有限公司', '太平资产管理有限公司'}",11,"{'华安基金管理有限公司', '兴业全球基金管理有限公司', '7000000', '中国长城资产管理公司', '太平资产管理有限公司', '4413200', '中国对外经济贸易信托有限公司', '12500000', '高翔', '12', '7500000'}"
20,"{'150000000', '20000000', '900000000', '现金', '新疆宏昇源', '芜湖江和', '600000000', '100000000', '深圳中民', '长沙云鼎', '广西正和', '竞价', '300000000', '深圳盛财', '120000000', '50000000', '180000000', '孚威天玑', '30000000', '36'}",932886,6,"{'900000000', '600000000', '竞价', '300000000', '120000000', '180000000'}",9,"{'现金', '新疆宏昇源', '芜湖江和', '深圳中民', '长沙云鼎', '广西正和', '孚威天玑', '深圳盛财', '36'}",14,"{'150000000', '20000000', '现金', '新疆宏昇源', '芜湖江和', '100000000', '深圳中民', '长沙云鼎', '广西正和', '孚威天玑', '深圳盛财', '50000000', '30000000', '36'}"
13,"{'20000000', '湖南轻盐创业投资管理有限公司', '现金', '5000000', '湖南海利高新技术产业集团有限公司', '浙江省诸暨合力化学对外贸易公司', '1000000', '江苏华达化工集团有限公司', '湖南省天心实业集团有限公司', '10000000', '湘江产业投资有限责任公司', '30000000', '36'}",1077445,0,set(),8,"{'湖南轻盐创业投资管理有限公司', '现金', '浙江省诸暨合力化学对外贸易公司', '湖南海利高新技术产业集团有限公司', '江苏华达化工集团有限公司', '湖南省天心实业集团有限公司', '湘江产业投资有限责任公司', '36'}",13,"{'20000000', '湖南轻盐创业投资管理有限公司', '5000000', '浙江省诸暨合力化学对外贸易公司', '湖南海利高新技术产业集团有限公司', '1000000', '现金', '江苏华达化工集团有限公司', '湖南省天心实业集团有限公司', '10000000', '湘江产业投资有限责任公司', '30000000', '36'}"
7,"{'孔鑫明', '19305000', '定价', '工银瑞信投资管理有限公司', '154440000', '丁航飞', '36'}",1768471,0,set(),4,"{'孔鑫明', '定价', '丁航飞', '36'}",7,"{'孔鑫明', '19305000', '定价', '工银瑞信投资管理有限公司', '154440000', '丁航飞', '36'}"
8,"{'金花投资控股集团有限公司', '66684378', '现金', '4516472', '627500000', '员工持股计划', '42500000', '36'}",15827681,3,"{'66684378', '42500000', '627500000'}",4,"{'金花投资控股集团有限公司', '现金', '36', '员工持股计划'}",5,"{'金花投资控股集团有限公司', '现金', '4516472', '员工持股计划', '36'}"
11,"{'现金', '3959147', '93039954.5', '林建伟', '林峻', '陶晓海', '60', '竞价', '50231387', '36', '1180437595'}",18760752,2,"{'竞价', '1180437595'}",6,"{'现金', '林建伟', '林峻', '陶晓海', '60', '36'}",9,"{'93039954.5', '3959147', '现金', '林建伟', '林峻', '陶晓海', '60', '36', '50231387'}"
18,"{'368536350', '深圳市诚德投资有限公司', '54945000', '67497500', '深圳市人民政府国有资产监督管理委员会', '89393850', '12', '深圳市铖兴泰投资有限公司', '299999700', '16372500', '深圳光明酒店管理有限公司', '竞价', '深圳市远致投资有限公司', '华夏基金管理公司', '54600000', '生命人寿保险股份有限公司', '10000000', '36'}",1175937,7,"{'368536350', '89393850', '67497500', '299999700', '16372500', '54600000', '10000000'}",5,"{'36', '深圳市人民政府国有资产监督管理委员会', '深圳市远致投资有限公司', '竞价', '12'}",11,"{'深圳市诚德投资有限公司', '54945000', '深圳市人民政府国有资产监督管理委员会', '12', '深圳市铖兴泰投资有限公司', '深圳光明酒店管理有限公司', '深圳市远致投资有限公司', '华夏基金管理公司', '竞价', '生命人寿保险股份有限公司', '36'}"
14,"{'现金', '249984000', '10080000', '长石投资有限公司', '5040000', '鑫元基金管理有限公司', '东海基金管理有限责任公司', '深圳市方德智联投资管理有限公司', '4360000', '129753600', '149990400', '299980800', '36', '8400000'}",1932050,1,{'149990400'},6,"{'现金', '长石投资有限公司', '鑫元基金管理有限公司', '东海基金管理有限责任公司', '深圳市方德智联投资管理有限公司', '36'}",13,"{'现金', '249984000', '10080000', '长石投资有限公司', '5040000', '鑫元基金管理有限公司', '东海基金管理有限责任公司', '深圳市方德智联投资管理有限公司', '4360000', '129753600', '299980800', '36', '8400000'}"
4,"{'竞价', '现金', '36', '上海沪瑞实业有限公司'}",1911360,1,{'竞价'},3,"{'现金', '36', '上海沪瑞实业有限公司'}",3,"{'现金', '36', '上海沪瑞实业有限公司'}"
6,"{'现金', '定价', '160000000', '陶国平', '865600000', '36'}",15138087,1,{'865600000'},4,"{'定价', '陶国平', '现金', '36'}",5,"{'现金', '定价', '160000000', '陶国平', '36'}"
24,"{'安徽省铁路建设投资基金有限公司', '84745762', '申万菱信基金管理有限公司', '47080979', '50376647', '24146895', '现金', '定价', '财通基金管理有限公司', '青岛城投金融控股集团有限公司', '499999997', '鹏华资产管理(深圳)有限公司', '43126177', '华夏人寿保险股份有限公司', '899999992.4', '256440024.9', '中信证券股份有限公司', '543999995.1', '534999991.1', '51224105', '457999999.7', '合肥市国有资产控股有限公司', '民生通惠资产管理有限公司', '12'}",12047067,9,"{'256440024.9', '899999992.4', '534999991.1', '457999999.7', '51224105', '543999995.1', '499999997', '50376647', '24146895'}",11,"{'华夏人寿保险股份有限公司', '现金', '安徽省铁路建设投资基金有限公司', '定价', '财通基金管理有限公司', '中信证券股份有限公司', '青岛城投金融控股集团有限公司', '申万菱信基金管理有限公司', '合肥市国有资产控股有限公司', '民生通惠资产管理有限公司', '12'}",15,"{'43126177', '华夏人寿保险股份有限公司', '现金', '安徽省铁路建设投资基金有限公司', '合肥市国有资产控股有限公司', '定价', '84745762', '财通基金管理有限公司', '中信证券股份有限公司', '青岛城投金融控股集团有限公司', '申万菱信基金管理有限公司', '47080979', '民生通惠资产管理有限公司', '鹏华资产管理(深圳)有限公司', '12'}"
28,"{'9223673', '百利装备集团', '泰达宏利基金管理有限公司', '建信基金管理有限责任公司', '8455035', '现金', '25411222', '110585000', '定价', '财通基金管理有限公司', '8528823', '36', '8500000', '6752884', '东海基金管理有限责任公司', '8455034', '第一创业证券股份有限公司', '87855020.84', '109999992.3', '330599998.2', '119999985.7', '天弘基金管理有限公司', '110959987.2', '9223674', '创金合信基金管理有限公司', '110000005.4', '119999998.7', '12'}",1880250,1,{'110000005.4'},5,"{'现金', '12', '定价', '百利装备集团', '36'}",27,"{'9223673', '百利装备集团', '泰达宏利基金管理有限公司', '建信基金管理有限责任公司', '8455035', '现金', '25411222', '110585000', '定价', '财通基金管理有限公司', '8528823', '36', '8500000', '6752884', '东海基金管理有限责任公司', '8455034', '第一创业证券股份有限公司', '87855020.84', '109999992.3', '330599998.2', '119999985.7', '天弘基金管理有限公司', '110959987.2', '9223674', '创金合信基金管理有限公司', '119999998.7', '12'}"
5,"{'现金', '东方海洋集团', '2000000', '竞价', '36'}",1119600,1,{'竞价'},3,"{'36', '现金', '东方海洋集团'}",4,"{'36', '现金', '东方海洋集团', '2000000'}"
11,"{'3210571', '现金', '定价', '1104362', '平安资管', '平安养老险', '1380452', '久远银海1号定向资管计划', '1206877', '广发恒定24号集合资管计划', '36'}",15612312,4,"{'3210571', '1206877', '1104362', '1380452'}",5,"{'现金', '定价', '平安资管', '平安养老险', '36'}",7,"{'现金', '定价', '平安资管', '平安养老险', '久远银海1号定向资管计划', '广发恒定24号集合资管计划', '36'}"
5,"{'1150000000', '现金', '400696800', '银河天成集团有限公司', '36'}",14789,2,"{'1150000000', '400696800'}",3,"{'银河天成集团有限公司', '现金', '36'}",3,"{'银河天成集团有限公司', '现金', '36'}"
20,"{'136099990.2', '太平洋资产管理有限责任公司', '69999994.9', '10141579', '191267999.8', '12', '5216095', '1447990', '249999999', '163199989.3', '华商基金管理有限公司', '太平资产管理有限公司', '14252459', '19432025.8', '航天科技财务有限责任公司', '18628912', '中国航空科技工业股份有限公司', '36', '12160953', '中国东方资产管理公司'}",1201265,3,"{'136099990.2', '191267999.8', '163199989.3'}",8,"{'36', '太平洋资产管理有限责任公司', '华商基金管理有限公司', '太平资产管理有限公司', '航天科技财务有限责任公司', '中国航空科技工业股份有限公司', '12', '中国东方资产管理公司'}",17,"{'太平洋资产管理有限责任公司', '69999994.9', '10141579', '12', '5216095', '1447990', '249999999', '华商基金管理有限公司', '太平资产管理有限公司', '14252459', '19432025.8', '航天科技财务有限责任公司', '18628912', '中国航空科技工业股份有限公司', '36', '12160953', '中国东方资产管理公司'}"
13,"{'清华控股有限公司', '航天科工财务有限责任公司', '1000000', '7400000', '12', '4000000', '北京华清博远创业投资有限公司', '长江证券股份有限公司', '清华大学教育基金会', '华商基金管理有限公司', '8000000', '3600000', '36'}",1349283,0,set(),5,"{'清华控股有限公司', '12', '长江证券股份有限公司', '清华大学教育基金会', '36'}",13,"{'清华控股有限公司', '航天科工财务有限责任公司', '1000000', '7400000', '12', '4000000', '北京华清博远创业投资有限公司', '长江证券股份有限公司', '清华大学教育基金会', '华商基金管理有限公司', '8000000', '3600000', '36'}"
18,"{'20000000', '现金', '中信国安集团公司', '169779300', '12', '高志洪', '定价', '23000000', '杨亚涛', '新疆生产建设兵团投资有限责任公司', '上海盛太投资管理有限公司', '杨凯', '33000000', '25000000', '50000000', '18779200', '上海证券有限责任公司', '36'}",1259732,1,{'33000000'},6,"{'36', '现金', '中信国安集团公司', '新疆生产建设兵团投资有限责任公司', '定价', '12'}",17,"{'20000000', '现金', '中信国安集团公司', '169779300', '12', '高志洪', '杨亚涛', '23000000', '新疆生产建设兵团投资有限责任公司', '上海盛太投资管理有限公司', '杨凯', '定价', '25000000', '50000000', '18779200', '上海证券有限责任公司', '36'}"
12,"{'200000012.5', '现金', '泰康资管', '中国人寿', '52401746', '定价', '39301310', '899999999', '8733625', '安徽铁发', '36', '1199999983'}",15367067,0,set(),6,"{'泰康资管', '现金', '中国人寿', '定价', '安徽铁发', '36'}",12,"{'200000012.5', '泰康资管', '现金', '中国人寿', '52401746', '定价', '39301310', '899999999', '8733625', '安徽铁发', '36', '1199999983'}"
3,"{'169794680', '36', '中国交通建设股份有限公司'}",1207562,0,set(),2,"{'36', '中国交通建设股份有限公司'}",3,"{'169794680', '36', '中国交通建设股份有限公司'}"
13,"{'17125000', '现金', '中天资产', '13062500', '猎象资本', '盛世聚金', '盛世和金', '中睿智汇', '9000000', '28500000', '36', '14250000', '合涌源发展'}",1786379,0,set(),8,"{'现金', '中天资产', '猎象资本', '盛世聚金', '中睿智汇', '盛世和金', '36', '合涌源发展'}",13,"{'17125000', '现金', '中天资产', '13062500', '猎象资本', '盛世聚金', '盛世和金', '中睿智汇', '9000000', '28500000', '36', '14250000', '合涌源发展'}"
14,"{'广发证券资产管理(广东)有限公司', '现金', '30300000', '12', '英大基金管理有限公司', '16122000', '7000000', '东海证券股份有限公司', '17000000', '57900000', '厦门建发股份有限公司', '宝盈基金管理有限公司', '姚雄杰', '36'}",578410,2,"{'57900000', '30300000'}",8,"{'36', '现金', '英大基金管理有限公司', '东海证券股份有限公司', '厦门建发股份有限公司', '宝盈基金管理有限公司', '姚雄杰', '12'}",12,"{'广发证券资产管理(广东)有限公司', '36', '现金', '英大基金管理有限公司', '16122000', '7000000', '东海证券股份有限公司', '17000000', '厦门建发股份有限公司', '宝盈基金管理有限公司', '姚雄杰', '12'}"
4,"{'竞价', '现金', '36', '新疆天富电力(集团)有限责任公司'}",1229060,0,set(),4,"{'竞价', '现金', '36', '新疆天富电力(集团)有限责任公司'}",4,"{'竞价', '现金', '36', '新疆天富电力(集团)有限责任公司'}"
18,"{'银杏盛鸿', '睦源投资', '15647225', '现金', '7112376', '100000000', '冀延松', '70000000', '赵华涛', '宝新投资', '110000000', '130000000', '竞价', '14224751', '50000000', '18492176', '9957326', '36'}",1555080,6,"{'7112376', '15647225', '竞价', '14224751', '18492176', '9957326'}",7,"{'银杏盛鸿', '睦源投资', '现金', '冀延松', '赵华涛', '宝新投资', '36'}",12,"{'银杏盛鸿', '睦源投资', '现金', '100000000', '冀延松', '70000000', '赵华涛', '宝新投资', '110000000', '130000000', '50000000', '36'}"
14,"{'12000000', '20000000', '陈海昌', '汉川德诚投资中心', '亨通集团有限公司', '18000000', '15000000', '施德善', '华宝信托有限责任公司', '竞价', '10000000', '江苏苏豪创业投资有限公司', '8000000', '12'}",1279384,1,{'竞价'},3,"{'陈海昌', '12', '施德善'}",13,"{'12000000', '20000000', '陈海昌', '汉川德诚投资中心', '亨通集团有限公司', '18000000', '15000000', '施德善', '华宝信托有限责任公司', '10000000', '江苏苏豪创业投资有限公司', '8000000', '12'}"
27,"{'7828824', '国联安基金管理有限公司', '华泰资产管理有限公司', '广发乾和投资有限公司', '7812564', '212005980.8', '211441996.3', '10265853', '现金', '7834663', '7839541', '277793982.2', '定价', '财通基金管理有限公司', '安徽省投资集团控股有限公司', '212137979.5', '210671976.9', '7785365', '申银万国证券股份有限公司', '银河基金管理有限公司', '7813821', '19057358', '天弘基金管理有限公司', '211847977.4', '211407981.8', '515692107.5', '12'}",312646,5,"{'277793982.2', '212137979.5', '515692107.5', '212005980.8', '211441996.3'}",3,"{'定价', '现金', '12'}",22,"{'7828824', '国联安基金管理有限公司', '华泰资产管理有限公司', '广发乾和投资有限公司', '7812564', '10265853', '现金', '7834663', '7839541', '定价', '财通基金管理有限公司', '安徽省投资集团控股有限公司', '210671976.9', '7785365', '申银万国证券股份有限公司', '银河基金管理有限公司', '7813821', '19057358', '天弘基金管理有限公司', '211847977.4', '211407981.8', '12'}"
28,"{'4253835', '195999999.5', '嘉实资本管理有限公司', '建信基金管理有限责任公司', '41004184', '现金', '109999998.6', '财通基金管理有限公司', '汇添富基金管理股份有限公司', '36', '20920502', '27824267', '8507672', '199999999.1', '40666672.16', '125523012', '132999996.3', '20333331.3', '广发证券资产管理(广东)有限公司', '23012552', '中信国安投资有限公司', '599999997.4', '嘉实基金管理有限公司', '99999999.56', '泰康资产管理有限责任公司', '41841004', '12', '江西高技术产业发展有限责任公司'}",293799,5,"{'109999998.6', '40666672.16', '99999999.56', '599999997.4', '132999996.3'}",8,"{'现金', '12', '财通基金管理有限公司', '嘉实基金管理有限公司', '建信基金管理有限责任公司', '汇添富基金管理股份有限公司', '36', '江西高技术产业发展有限责任公司'}",23,"{'4253835', '195999999.5', '嘉实资本管理有限公司', '建信基金管理有限责任公司', '41004184', '现金', '财通基金管理有限公司', '汇添富基金管理股份有限公司', '36', '20920502', '27824267', '8507672', '199999999.1', '125523012', '20333331.3', '广发证券资产管理(广东)有限公司', '23012552', '中信国安投资有限公司', '嘉实基金管理有限公司', '泰康资产管理有限责任公司', '41841004', '12', '江西高技术产业发展有限责任公司'}"
4,"{'竞价', '现金', '36', '新疆生产建设兵团国有资产经营公司'}",1212330,0,set(),4,"{'竞价', '现金', '36', '新疆生产建设兵团国有资产经营公司'}",4,"{'竞价', '现金', '36', '新疆生产建设兵团国有资产经营公司'}"
9,"{'150000000', '现金', '550000000', '宁德国投', '竞价', '18159806', '福建投资集团', '66585956', '36'}",15572229,5,"{'150000000', '550000000', '竞价', '18159806', '66585956'}",4,"{'宁德国投', '现金', '36', '福建投资集团'}",4,"{'宁德国投', '现金', '36', '福建投资集团'}"
10,"{'150000000', '现金', '珠海市蓝桥基金管理有限公司', '定价', '深圳盛屯集团有限公司', '杭州渝逸投资管理合伙企业(有限合伙)', '500000000', '杨学平', '36', '1350000000'}",15740595,3,"{'150000000', '1350000000', '500000000'}",6,"{'现金', '珠海市蓝桥基金管理有限公司', '定价', '杨学平', '36', '深圳盛屯集团有限公司'}",7,"{'现金', '珠海市蓝桥基金管理有限公司', '定价', '杭州渝逸投资管理合伙企业(有限合伙)', '杨学平', '36', '深圳盛屯集团有限公司'}"
4,"{'四川省铁路产业投资集团有限责任公司', '现金', '竞价', '36'}",1207974,1,{'竞价'},3,"{'四川省铁路产业投资集团有限责任公司', '现金', '36'}",3,"{'四川省铁路产业投资集团有限责任公司', '现金', '36'}"
5,"{'209110000', '现金', '化医集团', '竞价', '36'}",1329617,1,{'209110000'},4,"{'36', '竞价', '现金', '化医集团'}",4,"{'36', '竞价', '现金', '化医集团'}"
11,"{'14700000', '36', '新疆盛世荣金股权投资合伙企业(有限合伙)', '陈俊磊', '2200000', '11700000', '江苏中超投资集团有限公司', '薛建英', '新疆盛世泉金股权投资合伙企业(有限合伙)', '12', '2300000'}",572158,1,{'11700000'},5,"{'陈俊磊', '12', '江苏中超投资集团有限公司', '薛建英', '36'}",10,"{'14700000', '36', '新疆盛世荣金股权投资合伙企业(有限合伙)', '陈俊磊', '2200000', '江苏中超投资集团有限公司', '薛建英', '新疆盛世泉金股权投资合伙企业(有限合伙)', '12', '2300000'}"
8,"{'华宝信托有限责任公司', '11000000', '天津证大金牛股权投资基金合伙企业(有限合伙)', '黄少彬', '吴树容', '9000000', '12', '19000000'}",1230191,0,set(),4,"{'华宝信托有限责任公司', '吴树容', '12', '黄少彬'}",8,"{'华宝信托有限责任公司', '11000000', '天津证大金牛股权投资基金合伙企业(有限合伙)', '黄少彬', '吴树容', '9000000', '12', '19000000'}"
24,"{'2799999997', '2119999997', '17407800009', '华安资产管理(香港)有限公司', '9671000005', '2199999998', '现金', '1555555554', '1544399998', '定价', '包头钢铁(集团)有限责任公司', '财通基金管理有限公司', '1222222221', '1177777776', '2227799997', '国华人寿保险股份有限公司', '招商财富资产管理有限公司', '上海六禾丁香投资中心(有限合伙)', '1237666665', '1499999998', '上海理家盈贸易有限公司', '833333332', '857999999', '36'}",1651716,3,"{'2119999997', '2199999998', '1499999998'}",7,"{'招商财富资产管理有限公司', '现金', '上海理家盈贸易有限公司', '国华人寿保险股份有限公司', '定价', '财通基金管理有限公司', '36'}",21,"{'2799999997', '17407800009', '华安资产管理(香港)有限公司', '9671000005', '1555555554', '现金', '1544399998', '包头钢铁(集团)有限责任公司', '定价', '财通基金管理有限公司', '1222222221', '1177777776', '2227799997', '国华人寿保险股份有限公司', '招商财富资产管理有限公司', '上海六禾丁香投资中心(有限合伙)', '1237666665', '上海理家盈贸易有限公司', '833333332', '857999999', '36'}"
13,"{'39997440', '天津硅谷天堂', '9999360', '74995200', '定价', '99943200', '新疆硅谷天堂', '南京瑞森', '海外控股', '13325760', '299980800', '36', '泰豪集团'}",1689897,0,set(),7,"{'天津硅谷天堂', '定价', '新疆硅谷天堂', '南京瑞森', '海外控股', '36', '泰豪集团'}",13,"{'39997440', '天津硅谷天堂', '9999360', '74995200', '99943200', '定价', '新疆硅谷天堂', '南京瑞森', '海外控股', '13325760', '299980800', '36', '泰豪集团'}"
6,"{'现金', '18172000', '36235000', '汇海资产管理计划', '36', '南方同正'}",1133212,2,"{'36235000', '18172000'}",4,"{'现金', '汇海资产管理计划', '36', '南方同正'}",4,"{'现金', '汇海资产管理计划', '36', '南方同正'}"
16,"{'199457244', '10854816', '现金', '天津和达', '16282226', '37991858', '奥鑫控股', '吴艳', '雄健投资', '299185903', '竞价', '54274084', '997286294', '方德智联', '36', '698100391'}",1787712,5,"{'199457244', '299185903', '竞价', '698100391', '997286294'}",6,"{'现金', '奥鑫控股', '吴艳', '雄健投资', '方德智联', '36'}",11,"{'10854816', '现金', '天津和达', '16282226', '37991858', '奥鑫控股', '吴艳', '雄健投资', '54274084', '方德智联', '36'}"
8,"{'现金', '3340000', '7990000', '侯文奇', '顾庆伟', '鼎汉1号资管计划', '6650000', '36'}",1874817,3,"{'7990000', '6650000', '3340000'}",4,"{'顾庆伟', '现金', '侯文奇', '36'}",5,"{'现金', '侯文奇', '顾庆伟', '鼎汉1号资管计划', '36'}"
17,"{'576972500', '现金', '华安基金管理有限公司', '21650000', '14000000', '374432500', '重庆新丰佳贸易有限公司', '财通基金管理有限公司', '国联安基金管理有限公司', '375765000', '165230000', '6200000', '14050000', '373100000', '12', '14100000', '杭州三赢实业有限公司'}",1558562,0,set(),7,"{'现金', '华安基金管理有限公司', '重庆新丰佳贸易有限公司', '财通基金管理有限公司', '国联安基金管理有限公司', '12', '杭州三赢实业有限公司'}",17,"{'576972500', '现金', '华安基金管理有限公司', '21650000', '14000000', '374432500', '重庆新丰佳贸易有限公司', '财通基金管理有限公司', '国联安基金管理有限公司', '375765000', '165230000', '6200000', '14050000', '373100000', '12', '14100000', '杭州三赢实业有限公司'}"
3,"{'1172078712', '酒泉钢铁(集团)有限责任公司', '36'}",1126856,0,set(),1,{'36'},3,"{'1172078712', '酒泉钢铁(集团)有限责任公司', '36'}"
17,"{'太平洋资产管理有限责任公司', '40000000', '395200000', '新华人寿保险股份有限公司', '335920000', '34000000', '招商基金管理有限公司', '福建省投资开发集团有限责任公司', '厦门象屿集团有限公司', '414960000', '上海海通证券资产管理有限公司', '42000000', '闽西兴杭国有资产投资经营有限公司', '长信基金管理有限责任公司', '泰达宏利基金管理有限公司', '12', '汇添富基金管理有限公司'}",229818,3,"{'395200000', '335920000', '414960000'}",11,"{'太平洋资产管理有限责任公司', '新华人寿保险股份有限公司', '招商基金管理有限公司', '福建省投资开发集团有限责任公司', '厦门象屿集团有限公司', '上海海通证券资产管理有限公司', '闽西兴杭国有资产投资经营有限公司', '长信基金管理有限责任公司', '泰达宏利基金管理有限公司', '12', '汇添富基金管理有限公司'}",14,"{'太平洋资产管理有限责任公司', '40000000', '新华人寿保险股份有限公司', '34000000', '招商基金管理有限公司', '福建省投资开发集团有限责任公司', '厦门象屿集团有限公司', '上海海通证券资产管理有限公司', '42000000', '闽西兴杭国有资产投资经营有限公司', '长信基金管理有限责任公司', '泰达宏利基金管理有限公司', '12', '汇添富基金管理有限公司'}"
28,"{'79677500', '62422500', '华安基金管理有限公司', '141592500', '13950000', '6150000', '5800000', '5880000', '钱海平', '63945000', '58058000', '1643707', '16683626.05', '恒泰证券股份有限公司', '7850000', '5720000', '6300000', '申银万国证券股份有限公司', '广东温氏投资有限公司', '58870000', '江信基金管理有限公司', '北京众和成长投资中心(有限合伙)', '59682000', '浙江浙旅投资有限责任公司', '5819593', '安信证券股份有限公司', '59068868.95', '12'}",904275,0,set(),9,"{'江信基金管理有限公司', '华安基金管理有限公司', '恒泰证券股份有限公司', '钱海平', '申银万国证券股份有限公司', '浙江浙旅投资有限责任公司', '广东温氏投资有限公司', '安信证券股份有限公司', '12'}",28,"{'79677500', '62422500', '华安基金管理有限公司', '141592500', '13950000', '6150000', '5800000', '5880000', '钱海平', '63945000', '58058000', '1643707', '16683626.05', '恒泰证券股份有限公司', '7850000', '5720000', '6300000', '申银万国证券股份有限公司', '广东温氏投资有限公司', '58870000', '江信基金管理有限公司', '北京众和成长投资中心(有限合伙)', '59682000', '浙江浙旅投资有限责任公司', '5819593', '安信证券股份有限公司', '59068868.95', '12'}"
19,"{'中国华电集团资本控股有限公司', '8740000', '366566400', '现金', '58208400', '深圳市通产集团有限公司', '9100000', '60606000', '159840000', '12', '55040000', '中国长城资产管理公司', '竞价', '广东温氏投资有限公司', '10000000', '新华信托股份有限公司', '36', '24000000', '66600000'}",1170735,6,"{'366566400', '58208400', '60606000', '159840000', '55040000', '66600000'}",5,"{'36', '现金', '深圳市通产集团有限公司', '竞价', '12'}",13,"{'中国华电集团资本控股有限公司', '8740000', '现金', '深圳市通产集团有限公司', '9100000', '12', '中国长城资产管理公司', '竞价', '广东温氏投资有限公司', '10000000', '新华信托股份有限公司', '36', '24000000'}"
6,"{'现金', '定价', '通用电气新加坡公司', '768882352', '3383000000', '36'}",1108457,1,{'3383000000'},3,"{'定价', '现金', '通用电气新加坡公司'}",5,"{'现金', '定价', '通用电气新加坡公司', '768882352', '36'}"
6,"{'25380710', '38071065', '定价', '常春藤', '常熟市铝箔厂', '36'}",2274583,0,set(),4,"{'常熟市铝箔厂', '定价', '36', '常春藤'}",6,"{'25380710', '38071065', '定价', '常春藤', '常熟市铝箔厂', '36'}"
5,"{'现金', '郑靭', '陈汉昭', '竞价', '36'}",1719965,0,set(),5,"{'现金', '郑靭', '陈汉昭', '竞价', '36'}",5,"{'现金', '郑靭', '陈汉昭', '竞价', '36'}"
15,"{'800000000', '150000000', '现金', '生态1期计划', '277850000', '844316', '财富证券', '定价', '65897858', '12355848', '10250000', '昆明农投', '云投集团', '22887149', '36'}",1930217,0,set(),6,"{'现金', '财富证券', '定价', '昆明农投', '云投集团', '36'}",15,"{'800000000', '150000000', '现金', '生态1期计划', '277850000', '844316', '财富证券', '定价', '65897858', '12355848', '10250000', '昆明农投', '云投集团', '22887149', '36'}"
18,"{'北京汤荣颐合风险投资有限公司', '36', '现金', '庆祖森', '4500000', '兴业证券股份有限公司', '苏州华音投资有限公司', '1600000', '江苏恒安投资担保有限公司', '嘉实基金管理有限公司', '2000000', '信邦投资有限公司', '中信证券股份有限公司', '1500000', '江苏嘉盛工贸实业有限公司', '1000000', '12', '江苏开元国际集团轻工业品进出口股份有限公司'}",824688,1,{'1600000'},4,"{'36', '现金', '庆祖森', '12'}",17,"{'北京汤荣颐合风险投资有限公司', '36', '现金', '庆祖森', '4500000', '兴业证券股份有限公司', '苏州华音投资有限公司', '江苏恒安投资担保有限公司', '嘉实基金管理有限公司', '2000000', '信邦投资有限公司', '中信证券股份有限公司', '1500000', '江苏嘉盛工贸实业有限公司', '1000000', '12', '江苏开元国际集团轻工业品进出口股份有限公司'}"
2,"{'华力控股', '36'}",1173230,0,set(),2,"{'华力控股', '36'}",2,"{'华力控股', '36'}"
34,"{'70000000', '214800000', '348029700', '537000000', '64810000', '现金', '40000000', '大连天盛硕博科技有限公司', '65000000', '云南惠君投资合伙企业(有限合伙)', '竞价', '375900000', '北京华信六合投资有限公司', '宁波同乐股权投资合伙企业(有限合伙)', '150000000', '349050000', '66000000', '78400000', '民生加银基金管理有限公司', '60', '国华人寿保险股份有限公司', '东海基金管理有限责任公司', '354420000', '46000000', '长信基金管理有限责任公司', '247020000', '100000000', '国开泰富基金管理有限责任公司', '421008000', '天弘基金管理有限公司', '106272300', '805500000', '19790000', '12'}",708960,16,"{'150000000', '349050000', '40000000', '78400000', '214800000', '805500000', '348029700', '421008000', '354420000', '竞价', '106272300', '46000000', '375900000', '19790000', '247020000', '537000000'}",11,"{'现金', '民生加银基金管理有限公司', '大连天盛硕博科技有限公司', '国开泰富基金管理有限责任公司', '60', '国华人寿保险股份有限公司', '东海基金管理有限责任公司', '天弘基金管理有限公司', '长信基金管理有限责任公司', '北京华信六合投资有限公司', '12'}",18,"{'大连天盛硕博科技有限公司', '民生加银基金管理有限公司', '66000000', '64810000', '现金', '100000000', '国开泰富基金管理有限责任公司', '70000000', '60', '国华人寿保险股份有限公司', '东海基金管理有限责任公司', '云南惠君投资合伙企业(有限合伙)', '65000000', '天弘基金管理有限公司', '长信基金管理有限责任公司', '北京华信六合投资有限公司', '12', '宁波同乐股权投资合伙企业(有限合伙)'}"
6,"{'现金', '1550947200', '中国第一重型机械集团公司', '定价', '319782927', '36'}",14590911,1,{'1550947200'},4,"{'定价', '中国第一重型机械集团公司', '现金', '36'}",5,"{'现金', '中国第一重型机械集团公司', '定价', '319782927', '36'}"
14,"{'王哲林', '现金', '林志强', '厦门时位', '浔兴集团', '15327500', '1172500', '13010000', '15254225', '6500000', '199410775', '84565000', '1000000', '36'}",283275,0,set(),6,"{'王哲林', '现金', '林志强', '厦门时位', '浔兴集团', '36'}",14,"{'王哲林', '现金', '林志强', '厦门时位', '浔兴集团', '15327500', '1172500', '13010000', '15254225', '6500000', '199410775', '84565000', '1000000', '36'}"
4,"{'竞价', '现金', '青岛煜明投资中心(有限合伙)', '36'}",1153669,1,{'青岛煜明投资中心(有限合伙)'},3,"{'竞价', '现金', '36'}",3,"{'竞价', '现金', '36'}"
10,"{'22514600', '现金', '118670585', '彭韬', '潘利斌', '23000000', '21000000', '姚芳媛', '36', '朱蓉娟'}",1130347,0,set(),6,"{'现金', '彭韬', '潘利斌', '姚芳媛', '36', '朱蓉娟'}",10,"{'22514600', '现金', '118670585', '彭韬', '潘利斌', '23000000', '21000000', '姚芳媛', '36', '朱蓉娟'}"
18,"{'现金', '李涛', '常州翔嘉中舟投资中心(有限合伙)', '中意资产管理有限责任公司', '4061302', '11448275', '4597701', '149399988.8', '60999993.45', '59999998.05', '199999993.5', '竞价', '上海擎达投资中心(有限合伙)', '4674329', '52999991.1', '12', '15325670', '太平资产管理有限公司'}",16882382,4,"{'149399988.8', '60999993.45', '竞价', '59999998.05'}",5,"{'现金', '李涛', '中意资产管理有限责任公司', '12', '太平资产管理有限公司'}",14,"{'现金', '李涛', '常州翔嘉中舟投资中心(有限合伙)', '中意资产管理有限责任公司', '4061302', '11448275', '4597701', '199999993.5', '上海擎达投资中心(有限合伙)', '4674329', '52999991.1', '12', '15325670', '太平资产管理有限公司'}"
9,"{'36', '4.02411E+11', '张康黎', '张桂平', '91249620000', '竞价', '南通百汇物资有限公司', '12', '4.18836E+11'}",1386014,4,"{'91249620000', '竞价', '4.02411E+11', '4.18836E+11'}",5,"{'张康黎', '张桂平', '12', '南通百汇物资有限公司', '36'}",5,"{'张康黎', '张桂平', '12', '南通百汇物资有限公司', '36'}"
5,"{'现金', '竞价', '252819600', '湘电集团', '12'}",1850298,1,{'252819600'},4,"{'湘电集团', '竞价', '现金', '12'}",4,"{'湘电集团', '竞价', '现金', '12'}"
26,"{'20000000000', '西藏紫光西岳通信', '西藏紫光神彩', '369822485', '554733727', '4700000000', '现金', '7000000000', '西藏紫光东岳通信', '同方国芯2015员工持股计划', '竞价', '西藏紫光博翊教育', '2600000000', '258875739', '173816568', '西藏健坤中芯', '15000000000', '739644970', '36982248', '96153846', '西藏紫光国芯', '1000000000', '西藏紫光树人教育', '10000000000', '36', '国研宝业'}",1807343,6,"{'4700000000', '2600000000', '1000000000', '竞价', '15000000000', '10000000000'}",10,"{'现金', '西藏紫光国芯', '西藏紫光东岳通信', '西藏健坤中芯', '西藏紫光树人教育', '西藏紫光西岳通信', '西藏紫光神彩', '西藏紫光博翊教育', '36', '国研宝业'}",20,"{'现金', '739644970', '7000000000', '36982248', '20000000000', '西藏紫光博翊教育', '西藏紫光国芯', '西藏紫光东岳通信', '258875739', '96153846', '173816568', '西藏紫光树人教育', '西藏健坤中芯', '西藏紫光西岳通信', '554733727', '西藏紫光神彩', '同方国芯2015员工持股计划', '369822485', '36', '国研宝业'}"
11,"{'深圳市前海银叶创富投资企业(有限合伙)', '40000000', '苏州华纳投资股份有限公司', '70000000', '274800000', '480900000', '竞价', '25000000', '西藏瑞华投资发展有限公司', '171750000', '36'}",1746098,5,"{'40000000', '274800000', '480900000', '竞价', '171750000'}",3,"{'苏州华纳投资股份有限公司', '36', '西藏瑞华投资发展有限公司'}",6,"{'深圳市前海银叶创富投资企业(有限合伙)', '苏州华纳投资股份有限公司', '70000000', '25000000', '西藏瑞华投资发展有限公司', '36'}"
16,"{'20979020', '广发证券资产管理(广东)有限公司', '现金', '11988011', '38701298', '定价', '王敏', '东海基金管理有限责任公司', '财通基金管理有限公司', '申万菱信(上海)资产管理有限公司', '16431568', '14985014', '泰达宏利基金管理有限公司', '4807197', '汇添富基金管理股份有限公司', '12'}",310682,0,set(),3,"{'定价', '现金', '12'}",16,"{'20979020', '广发证券资产管理(广东)有限公司', '现金', '11988011', '38701298', '王敏', '申万菱信(上海)资产管理有限公司', '东海基金管理有限责任公司', '财通基金管理有限公司', '16431568', '定价', '14985014', '泰达宏利基金管理有限公司', '4807197', '汇添富基金管理股份有限公司', '12'}"
18,"{'现金', '5706831', '4076308', '定价', '建信基金管理有限责任公司', '华安未来资产管理(上海)有限公司', '财通基金管理有限公司', '中国电子科技网络信息安全有限公司', '中航资本控股股份有限公司', '深圳市鸿力金通投资管理企业(有限合伙)', '深圳市方德智联投资管理有限公司', '3261046', '4891570', '四川三新创业投资有限责任公司', '中电科投资控股有限公司', '6522093', '36', '深圳大墨龙渊投资中心(有限合伙)'}",1718732,0,set(),10,"{'现金', '建信基金管理有限责任公司', '定价', '财通基金管理有限公司', '中国电子科技网络信息安全有限公司', '中航资本控股股份有限公司', '深圳市方德智联投资管理有限公司', '四川三新创业投资有限责任公司', '中电科投资控股有限公司', '36'}",18,"{'现金', '5706831', '4076308', '定价', '建信基金管理有限责任公司', '华安未来资产管理(上海)有限公司', '财通基金管理有限公司', '中国电子科技网络信息安全有限公司', '中航资本控股股份有限公司', '深圳市鸿力金通投资管理企业(有限合伙)', '深圳市方德智联投资管理有限公司', '3261046', '4891570', '四川三新创业投资有限责任公司', '中电科投资控股有限公司', '6522093', '36', '深圳大墨龙渊投资中心(有限合伙)'}"
21,"{'119999995.9', '101999991.1', '38733431', '390000000.3', '厦门国贸控股有限公司', '147277', '12', '陕西蓝海风投资管理有限公司', '2000021.66', '财通基金管理有限公司', '525999993', '竞价', '8836524', '159999994.6', '华鑫证券有限责任公司', '28718704', '7511045', '第一创业证券股份有限公司', '朱新明', '36', '11782032'}",1902389,3,"{'525999993', '159999994.6', '2000021.66'}",9,"{'第一创业证券股份有限公司', '厦门国贸控股有限公司', '12', '陕西蓝海风投资管理有限公司', '财通基金管理有限公司', '华鑫证券有限责任公司', '竞价', '朱新明', '36'}",18,"{'36', '7511045', '第一创业证券股份有限公司', '119999995.9', '厦门国贸控股有限公司', '147277', '390000000.3', '陕西蓝海风投资管理有限公司', '财通基金管理有限公司', '101999991.1', '华鑫证券有限责任公司', '28718704', '竞价', '38733431', '朱新明', '8836524', '12', '11782032'}"
3,"{'现金', '中国海油', '36'}",1227253,0,set(),3,"{'36', '中国海油', '现金'}",3,"{'现金', '中国海油', '36'}"
5,"{'现金', '7000000000', '中国海运(集团)总公司', '竞价', '36'}",14905706,0,set(),3,"{'竞价', '现金', '36'}",5,"{'现金', '7000000000', '中国海运(集团)总公司', '竞价', '36'}"
15,"{'31360000', '现金', '瑞士银行(UBS AG)', '172480000', '华夏基金管理有限公司', '4000000', '定价', '94080000', '2000000', '红塔证券股份有限公司', '11000000', '东吴证券有限责任公司', '6000000', '62720000', '12'}",814906,6,"{'31360000', '172480000', '瑞士银行(UBS AG)', '94080000', '11000000', '62720000'}",3,"{'现金', '定价', '12'}",9,"{'现金', '华夏基金管理有限公司', '4000000', '定价', '2000000', '红塔证券股份有限公司', '东吴证券有限责任公司', '6000000', '12'}"
4,"{'巨人投资有限公司', '现金', '上海海博鑫惠国际贸易有限公司', '36'}",407402,0,set(),4,"{'巨人投资有限公司', '36', '现金', '上海海博鑫惠国际贸易有限公司'}",4,"{'巨人投资有限公司', '现金', '上海海博鑫惠国际贸易有限公司', '36'}"
9,"{'现金', '48780487', '492999990', '599999990.1', '广州新华城市发展产业投资企业(有限合伙)', '竞价', '广州国寿城市发展产业投资企业(有限合伙)', '40081300', '12'}",16547555,1,{'竞价'},2,"{'现金', '12'}",8,"{'现金', '48780487', '492999990', '599999990.1', '广州新华城市发展产业投资企业(有限合伙)', '广州国寿城市发展产业投资企业(有限合伙)', '40081300', '12'}"
24,"{'12000000', '9100000', '易方达基金管理有限公司', '14800000', '195656000', '现金', '兴业全球基金管理有限公司', '387346000', '定价', '132200000', '常州投资集团有限公司', '景隆融尊(天津)股权投资基金合伙企业(有限合伙)', '10000000', '中财明远投资管理有限公司', '29300000', '30000000', '120302000', '岳丽英', '雅戈尔投资有限公司', '158640000', '396600000', '江西出版集团蓝海国际投资有限公司', '江西育科投资有限责任公司', '12'}",491896,7,"{'12000000', '120302000', '195656000', '387346000', '396600000', '132200000', '158640000'}",7,"{'现金', '兴业全球基金管理有限公司', '定价', '雅戈尔投资有限公司', '易方达基金管理有限公司', '中财明远投资管理有限公司', '12'}",17,"{'现金', '兴业全球基金管理有限公司', '岳丽英', '9100000', '定价', '江西出版集团蓝海国际投资有限公司', '雅戈尔投资有限公司', '易方达基金管理有限公司', '常州投资集团有限公司', '10000000', '江西育科投资有限责任公司', '景隆融尊(天津)股权投资基金合伙企业(有限合伙)', '中财明远投资管理有限公司', '29300000', '30000000', '12', '14800000'}"
6,"{'现金', '1200000000', '定价', '粤电集团', '200000000', '36'}",597323,2,"{'200000000', '1200000000'}",4,"{'粤电集团', '36', '定价', '现金'}",4,"{'粤电集团', '现金', '定价', '36'}"
25,"{'北京数码视讯科技股份有限公司', '50000000', '中国电子投资控股有限公司', '现金', '19426906', '定价', '237639600', '湖北省楚天视讯网络有限公司', '300000000', '163100000', '鹏华基金管理有限公司', '10000000', '30656039', '116000000', '中信国安信息产业股份有限公司', '北京中融鼎新投资管理有限公司', '江阴中南重工集团有限公司', '14570179', '316852800', '7112201', '18393623', '3065603', '北京捷成世纪科技股份有限公司', '500000000', '36'}",1841718,4,"{'237639600', '116000000', '163100000', '316852800'}",11,"{'现金', '中信国安信息产业股份有限公司', '北京数码视讯科技股份有限公司', '定价', '湖北省楚天视讯网络有限公司', '北京中融鼎新投资管理有限公司', '北京捷成世纪科技股份有限公司', '鹏华基金管理有限公司', '中国电子投资控股有限公司', '江阴中南重工集团有限公司', '36'}",21,"{'北京数码视讯科技股份有限公司', '50000000', '中国电子投资控股有限公司', '现金', '19426906', '定价', '湖北省楚天视讯网络有限公司', '300000000', '鹏华基金管理有限公司', '10000000', '30656039', '中信国安信息产业股份有限公司', '北京中融鼎新投资管理有限公司', '江阴中南重工集团有限公司', '14570179', '7112201', '18393623', '3065603', '北京捷成世纪科技股份有限公司', '500000000', '36'}"
12,"{'10600000', '天津盛熙股权投资基金合伙企业(有限合伙)', '天津证大金龙股权投资基金合伙企业(有限合伙)', '兴业全球基金管理有限公司', '中航证券有限公司北京资产管理分公司', '13000000', '周雪钦', '11000000', '竞价', '江苏瑞华投资控股集团有限公司', '上海国富永楠投资合伙企业(有限合伙)', '12'}",1218455,2,"{'10600000', '竞价'}",3,"{'江苏瑞华投资控股集团有限公司', '12', '兴业全球基金管理有限公司'}",10,"{'天津盛熙股权投资基金合伙企业(有限合伙)', '天津证大金龙股权投资基金合伙企业(有限合伙)', '兴业全球基金管理有限公司', '中航证券有限公司北京资产管理分公司', '13000000', '周雪钦', '11000000', '江苏瑞华投资控股集团有限公司', '上海国富永楠投资合伙企业(有限合伙)', '12'}"
23,"{'2953700000', '开源证券股份有限公司', '中信建投基金管理有限公司', '申万菱信基金管理有限公司', '363128491', '418994413', '新沃基金管理有有限公司', '1300000000', '现金', '1650000000', '竞价', '460893854', '华福基金管理有限责任公司', '招商财务资产管理有限公司', '1450000000', '中信证券股份有限公司', '1500000000', '825055865', '广发证券资产管理(广东)有限公司', '招商证券资产管理有限公司', '405027932', '安信证券股份有限公司', '12'}",14630323,6,"{'2953700000', '1650000000', '1450000000', '竞价', '1500000000', '1300000000'}",9,"{'现金', '开源证券股份有限公司', '招商证券资产管理有限公司', '华福基金管理有限责任公司', '中信建投基金管理有限公司', '中信证券股份有限公司', '申万菱信基金管理有限公司', '安信证券股份有限公司', '12'}",17,"{'广发证券资产管理(广东)有限公司', '现金', '安信证券股份有限公司', '开源证券股份有限公司', '招商证券资产管理有限公司', '华福基金管理有限责任公司', '招商财务资产管理有限公司', '中信建投基金管理有限公司', '中信证券股份有限公司', '申万菱信基金管理有限公司', '405027932', '363128491', '418994413', '新沃基金管理有有限公司', '825055865', '12', '460893854'}"
16,"{'8500000', '现金', '中国昊华化工(集团)总公司', '广东南辰机械有限责任公司', '12', '河南恒星科技股份有限公司', '湖北福星科技股份有限公司', '3900000', '19500000', '厦门海翼国际贸易有限公司', '10000000', '龙工(福建)桥箱有限公司', '59642148', '9900000', '江苏兴达钢帘线股份有限公司', '36'}",1358129,0,set(),10,"{'36', '现金', '中国昊华化工(集团)总公司', '广东南辰机械有限责任公司', '湖北福星科技股份有限公司', '河南恒星科技股份有限公司', '厦门海翼国际贸易有限公司', '59642148', '江苏兴达钢帘线股份有限公司', '12'}",16,"{'8500000', '现金', '中国昊华化工(集团)总公司', '广东南辰机械有限责任公司', '12', '河南恒星科技股份有限公司', '湖北福星科技股份有限公司', '3900000', '19500000', '厦门海翼国际贸易有限公司', '10000000', '龙工(福建)桥箱有限公司', '59642148', '9900000', '江苏兴达钢帘线股份有限公司', '36'}"
22,"{'财通基金-上海银行-财通基金-富春48号资产管理计划', '70000000', '宝山钢铁股份有限公司', '360749984', '全国社保基金一一二组合', '海通证券股份有限公司', '9996000', '56000000', '现金', '定价', '中国农业银行-国泰金牛创新成长股票型证券投资基金', '财通基金-工商银行-财通基金-同安定增保1号资产管理计划', '346657', '2500000', '36', '9706396', '357000', '12883928', '5126700', '2000000', '143547600', '12'}",909739,3,"{'56000000', '宝山钢铁股份有限公司', '9996000'}",4,"{'36', '定价', '现金', '12'}",19,"{'36', '财通基金-上海银行-财通基金-富春48号资产管理计划', '现金', '财通基金-工商银行-财通基金-同安定增保1号资产管理计划', '357000', '12', '70000000', '9706396', '定价', '5126700', '2000000', '360749984', '12883928', '全国社保基金一一二组合', '143547600', '海通证券股份有限公司', '346657', '中国农业银行-国泰金牛创新成长股票型证券投资基金', '2500000'}"
23,"{'4000000', '6400000', '卢君', '3300000', '80892000', '77040000', '江苏鑫惠创业投资有限公司', '3000000', '63558000', '现金', '竞价', '9138700', '富国天惠精选成长混合型证券投资基金( LOF)', '中航鑫港担保有限公司', '上海力利投资管理合伙企业(有限合伙)', '中新融创资本管理有限公司', '4200000', '123264000', '176011362', '博弘数君(天津)股权投资基金合伙企业(有限合伙)', '57780000', '上海证券有限责任公司', '12'}",1263232,10,"{'富国天惠精选成长混合型证券投资基金( LOF)', '123264000', '3300000', '80892000', '77040000', '竞价', '3000000', '176011362', '63558000', '57780000'}",7,"{'现金', '中航鑫港担保有限公司', '江苏鑫惠创业投资有限公司', '卢君', '中新融创资本管理有限公司', '上海证券有限责任公司', '12'}",13,"{'现金', '中航鑫港担保有限公司', '上海力利投资管理合伙企业(有限合伙)', '4000000', '6400000', '卢君', '江苏鑫惠创业投资有限公司', '中新融创资本管理有限公司', '4200000', '博弘数君(天津)股权投资基金合伙企业(有限合伙)', '9138700', '上海证券有限责任公司', '12'}"
3,"{'450000000', '山西煤炭进出口集团有限公司', '36'}",1454418,0,set(),2,"{'山西煤炭进出口集团有限公司', '36'}",3,"{'450000000', '山西煤炭进出口集团有限公司', '36'}"
9,"{'现金', '2802241', '天津晨鑫商务咨询有限公司', '69999980.18', '竞价', '6805444', '万科链家(北京)装饰有限公司', '12', '169999991.1'}",18866051,1,{'竞价'},3,"{'天津晨鑫商务咨询有限公司', '现金', '12'}",8,"{'现金', '2802241', '天津晨鑫商务咨询有限公司', '69999980.18', '6805444', '万科链家(北京)装饰有限公司', '12', '169999991.1'}"
4,"{'梁健锋', '竞价', '现金', '36'}",1156980,0,set(),4,"{'梁健锋', '竞价', '现金', '36'}",4,"{'梁健锋', '竞价', '现金', '36'}"
4,"{'荣继华', '现金', '10000000', '12'}",1665588,1,{'10000000'},3,"{'荣继华', '现金', '12'}",3,"{'荣继华', '现金', '12'}"
12,"{'20000000', '东吴基金管理有限公司', '新华人寿保险股份有限公司', '厦门厦信投资集团有限公司', '江苏瑞华投资发展有限公司', '定价', '三峡财务有限责任公司', '高新投资发展有限公司', '3063809', '上海仰印投资管理有限公司', '10000000', '12'}",546016,0,set(),2,"{'定价', '12'}",12,"{'20000000', '东吴基金管理有限公司', '新华人寿保险股份有限公司', '厦门厦信投资集团有限公司', '江苏瑞华投资发展有限公司', '定价', '三峡财务有限责任公司', '高新投资发展有限公司', '3063809', '上海仰印投资管理有限公司', '10000000', '12'}"
16,"{'平安大华基金管理有限公司', '现金', '16000000', '兴业全球基金管理有限公司', '华夏基金管理有限公司', '19200000', '13624691', '融通基金管理有限公司', '15700000', '长信基金管理有限公司', '西藏瑞华投资发展有限公司', '泰达宏利基金管理有限公司', '华商基金管理有限公司', '28500000', '30000000', '12'}",1139561,0,set(),10,"{'平安大华基金管理有限公司', '现金', '兴业全球基金管理有限公司', '华夏基金管理有限公司', '融通基金管理有限公司', '西藏瑞华投资发展有限公司', '泰达宏利基金管理有限公司', '华商基金管理有限公司', '长信基金管理有限公司', '12'}",16,"{'平安大华基金管理有限公司', '现金', '16000000', '兴业全球基金管理有限公司', '华夏基金管理有限公司', '19200000', '13624691', '融通基金管理有限公司', '15700000', '长信基金管理有限公司', '西藏瑞华投资发展有限公司', '泰达宏利基金管理有限公司', '华商基金管理有限公司', '28500000', '30000000', '12'}"
24,"{'179999999.8', '易方达基金管理有限公司', '周雪钦', '17267267', '现金', '12', '定价', '149999996.5', '财通基金管理有限公司', '289999996.4', '199999999.8', '36', '北信瑞丰基金管理有限公司', '189999996.5', '22522522', '方正证券股份有限公司', '唐山三友碱业(集团)有限公司', '27027027', '28528528', '中欧基金管理有限公司', '30030030', '43543543', '114999998.2', '厦门象屿集团有限公司'}",16303128,2,"{'189999996.5', '289999996.4'}",11,"{'中欧基金管理有限公司', '现金', '北信瑞丰基金管理有限公司', '12', '定价', '厦门象屿集团有限公司', '财通基金管理有限公司', '易方达基金管理有限公司', '方正证券股份有限公司', '周雪钦', '36'}",22,"{'179999999.8', '易方达基金管理有限公司', '周雪钦', '17267267', '现金', '12', '定价', '厦门象屿集团有限公司', '149999996.5', '财通基金管理有限公司', '199999999.8', '北信瑞丰基金管理有限公司', '22522522', '方正证券股份有限公司', '唐山三友碱业(集团)有限公司', '27027027', '28528528', '中欧基金管理有限公司', '30030030', '43543543', '114999998.2', '36'}"
15,"{'现金', '766871', '1533742', '景瑞兴', '王哲', '聚和盛', '德融资本', '达美投资', '李岩', '麦趣尔集团', '1000000', '彭炫皓', '9070936', '36', '383435'}",373601,5,"{'766871', '1533742', '1000000', '9070936', '383435'}",10,"{'现金', '景瑞兴', '聚和盛', '德融资本', '达美投资', '李岩', '麦趣尔集团', '王哲', '彭炫皓', '36'}",10,"{'现金', '景瑞兴', '聚和盛', '德融资本', '达美投资', '李岩', '麦趣尔集团', '王哲', '彭炫皓', '36'}"
18,"{'鑫安投资', '青岛百华盛', '5000000', '现金', '40000000', '鲍国熙', '7000000', '1029411', '竞价', '170000000', '25000000', '方海平', '5882352', '153000000', '22500000', '735294', '王卫青', '36'}",1500961,4,"{'竞价', '40000000', '170000000', '153000000'}",7,"{'鑫安投资', '青岛百华盛', '现金', '鲍国熙', '方海平', '王卫青', '36'}",14,"{'鑫安投资', '青岛百华盛', '5000000', '现金', '鲍国熙', '7000000', '1029411', '方海平', '25000000', '5882352', '22500000', '735294', '王卫青', '36'}"
20,"{'南京瑞森投资管理合伙企业(有限合伙)', '华夏人寿保险股份有限公司', '81930000', '兴业全球基金管理有限公司', '华夏基金管理有限公司', '124060400', '380596000', '东海基金管理有限责任公司', '财通基金管理有限公司', '16070000', '国泰基金管理有限公司', '竞价', '中信证券股份有限公司', '海通证券股份有限公司', '632499600', '49400000', '49300000', '汇添富基金管理股份有限公司', '12', '381368000'}",355699,8,"{'81930000', '124060400', '380596000', '16070000', '竞价', '632499600', '49400000', '381368000'}",3,"{'华夏人寿保险股份有限公司', '12', '兴业全球基金管理有限公司'}",12,"{'南京瑞森投资管理合伙企业(有限合伙)', '华夏人寿保险股份有限公司', '兴业全球基金管理有限公司', '华夏基金管理有限公司', '东海基金管理有限责任公司', '财通基金管理有限公司', '国泰基金管理有限公司', '中信证券股份有限公司', '海通证券股份有限公司', '49300000', '汇添富基金管理股份有限公司', '12'}"
5,"{'吉林昊融有色金属集团有限公司', '定价', '资产', '19317991', '36'}",1365591,0,set(),4,"{'吉林昊融有色金属集团有限公司', '资产', '定价', '36'}",5,"{'吉林昊融有色金属集团有限公司', '定价', '资产', '19317991', '36'}"
8,"{'41548631', '郭仁祥', '兴证资管鑫众—吉艾科技1号定向资产管理计划', '3208000', '竞价', '4721435', '南通元鼎投资有限公司', '36'}",15303388,2,"{'竞价', '3208000'}",3,"{'郭仁祥', '南通元鼎投资有限公司', '36'}",6,"{'41548631', '郭仁祥', '兴证资管鑫众—吉艾科技1号定向资产管理计划', '4721435', '南通元鼎投资有限公司', '36'}"
11,"{'60160000', '现金', '22400000', '君良投资', '3200000', '30080000', '6400000', '上银基金拟设立的资产管理计划', '210560000', '海川控股', '36'}",339941,3,"{'210560000', '60160000', '30080000'}",5,"{'现金', '君良投资', '上银基金拟设立的资产管理计划', '海川控股', '36'}",8,"{'36', '现金', '22400000', '君良投资', '3200000', '6400000', '海川控股', '上银基金拟设立的资产管理计划'}"
16,"{'南京瑞森投资管理合伙企业(有限合伙)', '现金', '13144058', '兴业全球基金管理有限公司', '26288117', '无锡坤然股权投资企业(有限合伙)', '财通基金管理有限公司', '国联安基金管理有限公司', '易方达基金管理有限公司', '国泰基金管理有限公司', '竞价', '14931650', '王世忱', '8723461', '12', '21030494'}",347149,1,{'竞价'},8,"{'现金', '兴业全球基金管理有限公司', '国联安基金管理有限公司', '财通基金管理有限公司', '易方达基金管理有限公司', '国泰基金管理有限公司', '王世忱', '12'}",15,"{'南京瑞森投资管理合伙企业(有限合伙)', '现金', '13144058', '兴业全球基金管理有限公司', '26288117', '无锡坤然股权投资企业(有限合伙)', '财通基金管理有限公司', '国联安基金管理有限公司', '易方达基金管理有限公司', '国泰基金管理有限公司', '14931650', '王世忱', '8723461', '12', '21030494'}"
11,"{'3800000', '国金证券有限责任公司', '现金', '新华人寿保险股份有限公司', '汇丰晋信基金管理有限公司', '4000000', '定价', '中银国际基金管理有限公司', '7600000', '9000000', '12'}",547410,1,{'3800000'},7,"{'国金证券有限责任公司', '现金', '新华人寿保险股份有限公司', '汇丰晋信基金管理有限公司', '12', '定价', '中银国际基金管理有限公司'}",10,"{'国金证券有限责任公司', '现金', '新华人寿保险股份有限公司', '汇丰晋信基金管理有限公司', '4000000', '定价', '中银国际基金管理有限公司', '7600000', '9000000', '12'}"
10,"{'17400615', '60212655', '横店家园化工', '定价', '横店康裕', '17211607', '22907880', '横店控股', '横店进出口', '36'}",917475,0,set(),6,"{'横店家园化工', '定价', '横店康裕', '横店控股', '横店进出口', '36'}",10,"{'17400615', '60212655', '横店家园化工', '定价', '横店康裕', '17211607', '22907880', '横店控股', '横店进出口', '36'}"
5,"{'金塔投资', '现金', '129477298', '竞价', '36'}",12064697,1,{'129477298'},4,"{'金塔投资', '现金', '竞价', '36'}",4,"{'金塔投资', '现金', '竞价', '36'}"
10,"{'现金', '129533679', '定价', '1000000000', '阳煤金陵', '259067357', '500000000', '金陵阳明', '36', '金陵恒毅'}",364279,2,"{'1000000000', '500000000'}",6,"{'现金', '定价', '阳煤金陵', '金陵阳明', '36', '金陵恒毅'}",8,"{'现金', '129533679', '定价', '阳煤金陵', '259067357', '金陵阳明', '36', '金陵恒毅'}"
9,"{'厦门豫联投资合伙企业(有限合伙)', '河南豫联能源集团有限责任公司', '现金', '70298769', '竞价', '149384885', '399999995.6', '849999995.7', '36'}",19288690,2,"{'竞价', '849999995.7'}",3,"{'现金', '河南豫联能源集团有限责任公司', '36'}",7,"{'厦门豫联投资合伙企业(有限合伙)', '河南豫联能源集团有限责任公司', '现金', '70298769', '149384885', '399999995.6', '36'}"
15,"{'6242197', '湖南唐人神控股投资股份有限公司', '现金', '湖南湘投高科技创业投资有限公司', '定价', '9987515', '李家权', '12484394', '唐人神集团股份有限公司员工持股计划', '深圳德威德佳投资有限公司', '广东温氏投资有限公司', '刘以林', '陈枝', '大生行饲料有限公司', '36'}",1817800,0,set(),12,"{'36', '湖南湘投高科技创业投资有限公司', '现金', '定价', '李家权', '唐人神集团股份有限公司员工持股计划', '深圳德威德佳投资有限公司', '广东温氏投资有限公司', '刘以林', '陈枝', '大生行饲料有限公司', '湖南唐人神控股投资股份有限公司'}",15,"{'6242197', '湖南唐人神控股投资股份有限公司', '现金', '湖南湘投高科技创业投资有限公司', '定价', '9987515', '李家权', '12484394', '唐人神集团股份有限公司员工持股计划', '深圳德威德佳投资有限公司', '广东温氏投资有限公司', '刘以林', '陈枝', '大生行饲料有限公司', '36'}"
16,"{'4800000', '4882400', '现金', '吴光蓉', '2200000', '2000000', '49654008', '竞价', '赵宝', '20340000', '魏敏钗', '周万沅', '浙江方正房地产开发有限公司', '22374000', '36', '48816000'}",1452734,4,"{'49654008', '22374000', '20340000', '48816000'}",8,"{'36', '吴光蓉', '现金', '竞价', '魏敏钗', '周万沅', '浙江方正房地产开发有限公司', '赵宝'}",12,"{'4800000', '4882400', '吴光蓉', '现金', '2200000', '2000000', '竞价', '赵宝', '魏敏钗', '周万沅', '浙江方正房地产开发有限公司', '36'}"
16,"{'现金', '北信瑞丰基金管理有限公司', '深圳天风天成资产管理有限公司', '16523800', '37852200', '天安财产保险股份有限公司', '厦门象屿股份有限公司', '财通基金管理有限公司', '47825400', '竞价', '25157200', '48742100', '江苏苏豪投资集团有限公司', '申万菱信基金管理有限公司', '华安未来资产管理(上海)有限公司', '12'}",2375199,1,{'竞价'},2,"{'现金', '12'}",15,"{'现金', '北信瑞丰基金管理有限公司', '深圳天风天成资产管理有限公司', '16523800', '37852200', '天安财产保险股份有限公司', '厦门象屿股份有限公司', '财通基金管理有限公司', '47825400', '25157200', '48742100', '江苏苏豪投资集团有限公司', '申万菱信基金管理有限公司', '华安未来资产管理(上海)有限公司', '12'}"
7,"{'现金', '5145027', '定价', '7128415', '肖中明', '王敬春', '12'}",1620679,2,"{'7128415', '5145027'}",5,"{'现金', '定价', '肖中明', '王敬春', '12'}",5,"{'现金', '定价', '肖中明', '王敬春', '12'}"
5,"{'现金', '陈卫', '竞价', '36', '力帆控股'}",9894988,0,set(),5,"{'现金', '陈卫', '竞价', '36', '力帆控股'}",5,"{'现金', '陈卫', '竞价', '36', '力帆控股'}"
10,"{'现金', '16000000', '宁波梅山保税港区道泰信泉投资合伙企业(有限合伙)', '160000000', '中国北方工业公司', '竞价', '创金合信基金管理有限公司', '8000000', '80000000', '12'}",19299347,1,{'竞价'},4,"{'创金合信基金管理有限公司', '现金', '12', '中国北方工业公司'}",9,"{'现金', '16000000', '宁波梅山保税港区道泰信泉投资合伙企业(有限合伙)', '160000000', '中国北方工业公司', '创金合信基金管理有限公司', '8000000', '80000000', '12'}"
15,"{'兵工财务有限责任公司', '定价', '深圳市前海欣诺投资合伙企业(有限合伙)', '549999995.9', '财通基金管理有限公司', '16491754', '天治基金管理有限公司', '130000000.9', '5397301', '5097451', '169999990.9', '3898051', '179999988.4', '易方达资产管理有限公司', '12'}",14999171,3,"{'169999990.9', '179999988.4', '130000000.9'}",6,"{'兵工财务有限责任公司', '定价', '财通基金管理有限公司', '天治基金管理有限公司', '易方达资产管理有限公司', '12'}",12,"{'兵工财务有限责任公司', '深圳市前海欣诺投资合伙企业(有限合伙)', '定价', '549999995.9', '财通基金管理有限公司', '16491754', '5397301', '5097451', '3898051', '天治基金管理有限公司', '易方达资产管理有限公司', '12'}"
4,"{'竞价', '现金', '36', '北京中环投资管理有限公司'}",16789289,1,{'竞价'},3,"{'现金', '36', '北京中环投资管理有限公司'}",3,"{'现金', '36', '北京中环投资管理有限公司'}"
9,"{'鼎晖一期', '27011950', '7618755', '定价', '鼎晖元博', '398253108', '资产', '36', '恒逸集团'}",885105,0,set(),6,"{'鼎晖一期', '定价', '鼎晖元博', '资产', '36', '恒逸集团'}",9,"{'鼎晖一期', '27011950', '7618755', '定价', '鼎晖元博', '398253108', '资产', '36', '恒逸集团'}"
8,"{'20000000', '深圳市架桥富凯七号股权投资企业(有限合伙)', '现金', '定价', '沂源县南麻街道集体资产经营管理中心', '10000000', '36', '淄博鑫联投资股份有限公司'}",1762504,2,"{'20000000', '10000000'}",5,"{'现金', '定价', '沂源县南麻街道集体资产经营管理中心', '36', '淄博鑫联投资股份有限公司'}",6,"{'深圳市架桥富凯七号股权投资企业(有限合伙)', '现金', '定价', '沂源县南麻街道集体资产经营管理中心', '36', '淄博鑫联投资股份有限公司'}"
14,"{'陈潮钿', '华夏基金管理有限公司(注)', '江苏瑞华投资发展有限公司', '12', '定价', '3700000', '雅戈尔集团股份有限公司', '3740000', '2730000', '博弘数君(天津)股权投资基金合伙企业(有限合伙)', '张清永', '6000000', '36', '陈明'}",1218029,1,{'6000000'},7,"{'陈潮钿', '36', '江苏瑞华投资发展有限公司', '定价', '雅戈尔集团股份有限公司', '张清永', '12'}",13,"{'陈潮钿', '华夏基金管理有限公司(注)', '江苏瑞华投资发展有限公司', '12', '定价', '3700000', '雅戈尔集团股份有限公司', '3740000', '2730000', '博弘数君(天津)股权投资基金合伙企业(有限合伙)', '张清永', '36', '陈明'}"
15,"{'现金', '1659429', '中金投资(集团)有限公司', '1600000', '上海宏邦股权投资管理有限公司', '嘉实基金管理有限公司', '长江证券股份有限公司', '2800000', '竞价', '3000000', '江苏汇鸿国际集团土产进出口股份有限公司', '南方基金管理有限公司', '1500000', '12', '富通银行'}",1501599,2,"{'竞价', '现金'}",7,"{'上海宏邦股权投资管理有限公司', '嘉实基金管理有限公司', '长江证券股份有限公司', '江苏汇鸿国际集团土产进出口股份有限公司', '南方基金管理有限公司', '12', '富通银行'}",13,"{'1659429', '中金投资(集团)有限公司', '1600000', '上海宏邦股权投资管理有限公司', '嘉实基金管理有限公司', '长江证券股份有限公司', '2800000', '1500000', '3000000', '江苏汇鸿国际集团土产进出口股份有限公司', '南方基金管理有限公司', '12', '富通银行'}"
17,"{'现金', '中邮创业基金管理有限公司', '15000000', '华宝信托有限责任公司', '竞价', '中信证券股份有限公司', '10000000', '南方基金管理有限公司', '鹏华基金管理有限公司', '江苏苏豪创业投资有限公司', '叶祥尧', '27000000', '7694800', '12500000', '江苏汇鸿国际集团针棉织品进出口有限公司', '12', '苏建平'}",1269869,3,"{'7694800', '竞价', '10000000'}",2,"{'现金', '12'}",14,"{'现金', '中邮创业基金管理有限公司', '15000000', '华宝信托有限责任公司', '27000000', '中信证券股份有限公司', '南方基金管理有限公司', '鹏华基金管理有限公司', '江苏苏豪创业投资有限公司', '叶祥尧', '12500000', '江苏汇鸿国际集团针棉织品进出口有限公司', '12', '苏建平'}"
25,"{'11594671', '102264998.2', '长安基金管理有限公司', '108239992.6', '101999992.5', '101430000', '2537985', '22385027.7', '财通基金管理有限公司', '宝盈基金管理有限公司', '汇添富基金管理股份有限公司', '13605442', '206499996.4', '北京华创智业投资有限公司', '23412698', '工银瑞信投资管理有限公司', '119999998.4', '11500000', '兴证证券资产管理有限公司', '11564625', '17006802', '12272108', '中国银河证券股份有限公司', '149999993.6', '信达国萃股权投资基金(上海)合伙企业(有限合伙)'}",293577,2,"{'206499996.4', '108239992.6'}",8,"{'长安基金管理有限公司', '兴证证券资产管理有限公司', '北京华创智业投资有限公司', '财通基金管理有限公司', '中国银河证券股份有限公司', '工银瑞信投资管理有限公司', '宝盈基金管理有限公司', '汇添富基金管理股份有限公司'}",23,"{'11594671', '102264998.2', '长安基金管理有限公司', '101999992.5', '101430000', '2537985', '22385027.7', '财通基金管理有限公司', '宝盈基金管理有限公司', '汇添富基金管理股份有限公司', '13605442', '北京华创智业投资有限公司', '23412698', '工银瑞信投资管理有限公司', '119999998.4', '11500000', '兴证证券资产管理有限公司', '11564625', '17006802', '12272108', '中国银河证券股份有限公司', '149999993.6', '信达国萃股权投资基金(上海)合伙企业(有限合伙)'}"
20,"{'南京瑞森投资管理合伙企业(有限合伙)', '现金', '股权、现金', '16000000', '94382022', '12', '诺安基金管理有限公司', '定价', '17700000', '国联安基金管理有限公司', '财通基金管理有限公司', '32600000', '莱茵达控股集团有限公司', '831461', '申万菱信基金管理有限公司', '宝盈基金管理有限公司', '18400000', '33300000', '深圳市融通资本财富管理有限公司', '36'}",351160,4,"{'18400000', '831461', '股权、现金', '94382022'}",5,"{'现金', '12', '定价', '莱茵达控股集团有限公司', '36'}",16,"{'南京瑞森投资管理合伙企业(有限合伙)', '36', '现金', '16000000', '诺安基金管理有限公司', '17700000', '定价', '国联安基金管理有限公司', '财通基金管理有限公司', '32600000', '莱茵达控股集团有限公司', '申万菱信基金管理有限公司', '宝盈基金管理有限公司', '33300000', '深圳市融通资本财富管理有限公司', '12'}"
28,"{'吉富创业投资股份有限公司', '4000000', '7000000', '申万菱信基金管理有限公司', '48880000', '15886000', '现金', '54990000', '3700000', '太平洋资产管理有限责任公司', '银华基金管理有限公司', '1300000', '61711000', '4200000', '西藏山南世纪金源投资管理有限公司', '汇添富基金管理有限公司', '江苏虎甲投资有限公司', '51324000', '85540000', '45214000', '2050000', '25051000', '4500000', '李刚', '5050000', '上海东方证券资产管理有限公司', '泰康资产管理有限责任公司', '12'}",221550,13,"{'85540000', '45214000', '2050000', '25051000', '54990000', '1300000', '7000000', '61711000', '5050000', '4200000', '51324000', '48880000', '15886000'}",2,"{'现金', '12'}",15,"{'太平洋资产管理有限责任公司', '现金', '银华基金管理有限公司', '4500000', '吉富创业投资股份有限公司', '4000000', '李刚', '3700000', '上海东方证券资产管理有限公司', '西藏山南世纪金源投资管理有限公司', '申万菱信基金管理有限公司', '泰康资产管理有限责任公司', '12', '汇添富基金管理有限公司', '江苏虎甲投资有限公司'}"
4,"{'广东宝丽华集团有限公司', '竞价', '现金', '36'}",1780940,1,{'36'},3,"{'广东宝丽华集团有限公司', '竞价', '现金'}",3,"{'广东宝丽华集团有限公司', '竞价', '现金'}"
9,"{'1001514000', '现金', '永冠贸易', '250378500', '厚康实业', '竞价', '52162200', '208648800', '36'}",1870086,5,"{'1001514000', '250378500', '竞价', '52162200', '208648800'}",4,"{'厚康实业', '现金', '永冠贸易', '36'}",4,"{'厚康实业', '现金', '永冠贸易', '36'}"
12,"{'金鹰基金管理有限公司', '张家港市金城融创投资管理有限公司', '第一创业证券股份有限公司', '定价', '260950000', '财通基金管理有限公司', '168850000', '11000000', '401349987.7', '17000000', '26146579', '12'}",1922894,5,"{'260950000', '168850000', '401349987.7', '17000000', '26146579'}",6,"{'金鹰基金管理有限公司', '张家港市金城融创投资管理有限公司', '第一创业证券股份有限公司', '定价', '财通基金管理有限公司', '12'}",7,"{'金鹰基金管理有限公司', '张家港市金城融创投资管理有限公司', '第一创业证券股份有限公司', '定价', '财通基金管理有限公司', '11000000', '12'}"
15,"{'192480000', '潜能恒信2015年第一期员工持股计划', '现金', '16000000', '1700000', '定价', '25263000', '12030000', '20451000', '2100000', '苗俊平', '周锦明', '1000000', '36', '于爱民'}",1776286,0,set(),6,"{'现金', '定价', '苗俊平', '周锦明', '36', '于爱民'}",15,"{'192480000', '潜能恒信2015年第一期员工持股计划', '现金', '16000000', '1700000', '定价', '25263000', '12030000', '20451000', '2100000', '苗俊平', '周锦明', '1000000', '36', '于爱民'}"
6,"{'北京合纵科技股份有限公司第一期员工持股计划', '现金', '定价', '9318466', '105485035.1', '36'}",14663628,2,"{'105485035.1', '定价'}",3,"{'北京合纵科技股份有限公司第一期员工持股计划', '现金', '36'}",4,"{'北京合纵科技股份有限公司第一期员工持股计划', '9318466', '现金', '36'}"
6,"{'现金', '1200000000', '定价', '温州德欣', '77619663', '36'}",16719367,2,"{'77619663', '1200000000'}",4,"{'定价', '现金', '温州德欣', '36'}",4,"{'36', '定价', '现金', '温州德欣'}"
5,"{'现金', '100000000', '定价', '柳州市产业投资有限公司基本情况', '36'}",80537,0,set(),3,"{'定价', '现金', '36'}",5,"{'现金', '100000000', '定价', '柳州市产业投资有限公司基本情况', '36'}"
12,"{'96061479', '现金', '神州长城投资(北京)有限公司', '120076849', '1000000000', '竞价', '24015369', '郑积华', '250000000', '北京安本医疗投资控股有限公司', '36', '1250000000'}",9387960,3,"{'1000000000', '竞价', '1250000000'}",4,"{'现金', '郑积华', '36', '北京安本医疗投资控股有限公司'}",9,"{'96061479', '现金', '神州长城投资(北京)有限公司', '120076849', '250000000', '24015369', '郑积华', '北京安本医疗投资控股有限公司', '36'}"
28,"{'上海金桥(集团)有限公司', '5338078', '西藏自治区投资有限公司', '中信建投基金管理有限公司', '72999992.45', '3219248', '现金', '定价', '财通基金管理有限公司', '88499994.6', '2066339345', '73839592.35', '45230434.4', '36', '太平洋资产管理有限责任公司', '上海自贸试验区一期股权投资基金合伙企业(有限合伙)', '5255487', '149999991.8', '10676156', '光大保德信基金管理有限公司', '74999995.9', '股权', '上银基金管理有限公司', '北京基业华商投资管理中心(有限合伙)', '6298932', '147070416', '5195729', '12'}",1729917,1,{'2066339345'},13,"{'36', '太平洋资产管理有限责任公司', '现金', '北京基业华商投资管理中心(有限合伙)', '上海自贸试验区一期股权投资基金合伙企业(有限合伙)', '定价', '财通基金管理有限公司', '西藏自治区投资有限公司', '中信建投基金管理有限公司', '光大保德信基金管理有限公司', '股权', '12', '上银基金管理有限公司'}",27,"{'上海金桥(集团)有限公司', '5338078', '西藏自治区投资有限公司', '中信建投基金管理有限公司', '72999992.45', '3219248', '现金', '定价', '财通基金管理有限公司', '88499994.6', '73839592.35', '45230434.4', '36', '太平洋资产管理有限责任公司', '上海自贸试验区一期股权投资基金合伙企业(有限合伙)', '5255487', '149999991.8', '10676156', '光大保德信基金管理有限公司', '74999995.9', '股权', '上银基金管理有限公司', '北京基业华商投资管理中心(有限合伙)', '6298932', '147070416', '5195729', '12'}"
21,"{'20000000', '宏源证券股份有限公司', '362000000', '易方达基金管理有限公司', '343900000', '19000000', '147499072', '现金', '兴业全球基金管理有限公司', '定价', '18000000', '常州投资集团有限公司', '271500000', '15000000', '方正证券股份有限公司', '中信证券股份有限公司', '235300000', '13000000', '325800000', '8149120', '12'}",1503662,6,"{'147499072', '362000000', '325800000', '343900000', '271500000', '235300000'}",8,"{'现金', '兴业全球基金管理有限公司', '宏源证券股份有限公司', '定价', '易方达基金管理有限公司', '常州投资集团有限公司', '中信证券股份有限公司', '12'}",15,"{'20000000', '现金', '兴业全球基金管理有限公司', '宏源证券股份有限公司', '13000000', '18000000', '15000000', '定价', '8149120', '易方达基金管理有限公司', '方正证券股份有限公司', '常州投资集团有限公司', '中信证券股份有限公司', '12', '19000000'}"
23,"{'上海健久生物科技有限公司', '20000000', '浙江饭店有限责任公司', '104000000', '浙江正清实业投资有限公司', '百瑞信托投资有限责任公司', '国金证券有限责任公司', '现金', '广东省机场管理集团公司', '40000000', '长江证券有限责任公司', '11000000', '竞价', '30000000', '24000000', '中铁二局集团有限公司', '上海通略投资管理有限公司', '36', '15000000', '股权', '江苏瑞华投资发展有限公司', '27000000', '12'}",536768,3,"{'11000000', '竞价', '104000000'}",14,"{'上海健久生物科技有限公司', '百瑞信托投资有限责任公司', '浙江饭店有限责任公司', '现金', '广东省机场管理集团公司', '国金证券有限责任公司', '江苏瑞华投资发展有限公司', '上海通略投资管理有限公司', '36', '长江证券有限责任公司', '浙江正清实业投资有限公司', '股权', '12', '中铁二局集团有限公司'}",20,"{'上海健久生物科技有限公司', '百瑞信托投资有限责任公司', '浙江饭店有限责任公司', '现金', '40000000', '广东省机场管理集团公司', '20000000', '江苏瑞华投资发展有限公司', '国金证券有限责任公司', '12', '上海通略投资管理有限公司', '长江证券有限责任公司', '15000000', '30000000', '27000000', '浙江正清实业投资有限公司', '股权', '36', '24000000', '中铁二局集团有限公司'}"
21,"{'9200000', '4000000', '50760000', '沈幼炳', '5000000', '63450000', '竞价', '常州投资集团有限公司', '池万申', '雅戈尔集团股份有限公司', '116748000', '52029000', '中国对外经济贸易信托有限公司', '深圳市科铭实业有限公司', '1790000', '22715100', '4100000', '浙江航民实业集团有限公司', '深圳市中信联合创业投资有限公司', '12', '宁波信升化工有限公司'}",69542,7,"{'1790000', '22715100', '63450000', '竞价', '116748000', '52029000', '50760000'}",3,"{'雅戈尔集团股份有限公司', '12', '浙江航民实业集团有限公司'}",14,"{'9200000', '5000000', '深圳市科铭实业有限公司', '4000000', '4100000', '浙江航民实业集团有限公司', '雅戈尔集团股份有限公司', '常州投资集团有限公司', '中国对外经济贸易信托有限公司', '深圳市中信联合创业投资有限公司', '宁波信升化工有限公司', '池万申', '12', '沈幼炳'}"
18,"{'49018186', '现金', '4273196', '1989601.92', '定价', '3774656', '99480002.88', '570571694', '蒋亨福', '深圳市方德智联投资管理有限公司', '上海善达投资管理有限公司', '49740001.44', '吴美莉', '43936995.84', '8546392', '170928', '吴国仕', '36'}",1823237,5,"{'99480002.88', '570571694', '49740001.44', '43936995.84', '1989601.92'}",8,"{'现金', '定价', '蒋亨福', '深圳市方德智联投资管理有限公司', '吴美莉', '上海善达投资管理有限公司', '吴国仕', '36'}",13,"{'49018186', '现金', '4273196', '定价', '3774656', '蒋亨福', '深圳市方德智联投资管理有限公司', '上海善达投资管理有限公司', '吴美莉', '8546392', '170928', '吴国仕', '36'}"
5,"{'现金', '125721661', '竞价', '宁波峰梅', '36'}",15530522,1,{'125721661'},4,"{'竞价', '现金', '宁波峰梅', '36'}",4,"{'竞价', '现金', '宁波峰梅', '36'}"
11,"{'208333200', '现金', '江西伟宸信息技术有限公司', '定价', '新力达集团', '西藏博启彰驰投资有限公司', '52083300', '165416500', '95000000', '36', '沈培今'}",1923440,3,"{'208333200', '165416500', '95000000'}",7,"{'现金', '江西伟宸信息技术有限公司', '定价', '新力达集团', '西藏博启彰驰投资有限公司', '36', '沈培今'}",8,"{'现金', '江西伟宸信息技术有限公司', '定价', '新力达集团', '西藏博启彰驰投资有限公司', '52083300', '36', '沈培今'}"
4,"{'竞价', '现金', '36', '特锐德2014年度员工持股计划'}",441022,1,{'竞价'},2,"{'现金', '36'}",3,"{'现金', '36', '特锐德2014年度员工持股计划'}"
18,"{'平安大华基金管理有限公司', '金鹰基金管理有限公司', '现金', '九泰基金管理有限公司', '12', '宁波梅山保税港区东峪投资合伙企业', '定价', '450999999.5', '财通基金管理有限公司', '1349000037', '64935064', '亿利资源集团有限公司', '金元顺安基金管理有限公司', '嘉兴天朗投资合伙企业', '65079365', '36', '194660900', '449999993.5'}",15707136,1,{'450999999.5'},12,"{'平安大华基金管理有限公司', '金鹰基金管理有限公司', '现金', '九泰基金管理有限公司', '12', '宁波梅山保税港区东峪投资合伙企业', '定价', '财通基金管理有限公司', '金元顺安基金管理有限公司', '亿利资源集团有限公司', '嘉兴天朗投资合伙企业', '36'}",17,"{'平安大华基金管理有限公司', '金鹰基金管理有限公司', '现金', '九泰基金管理有限公司', '12', '宁波梅山保税港区东峪投资合伙企业', '定价', '财通基金管理有限公司', '1349000037', '64935064', '亿利资源集团有限公司', '金元顺安基金管理有限公司', '嘉兴天朗投资合伙企业', '65079365', '36', '194660900', '449999993.5'}"
6,"{'现金', '1600000000', '竞价', '258900000', '冀中能源', '36'}",182919,3,"{'竞价', '258900000', '1600000000'}",3,"{'现金', '36', '冀中能源'}",3,"{'现金', '36', '冀中能源'}"
3,"{'南京新工投资集团有限责任公司', '200000000', '现金'}",15690994,1,{'200000000'},2,"{'南京新工投资集团有限责任公司', '现金'}",2,"{'南京新工投资集团有限责任公司', '现金'}"
12,"{'150000000', '现金', '31250000', '350000000', '定价', '1000000000', '万永兴', '上海豫辉投资管理中心(有限合伙)', '89285714', '13392857', '刘轶', '36'}",1685135,2,"{'150000000', '350000000'}",5,"{'现金', '定价', '万永兴', '刘轶', '36'}",10,"{'现金', '31250000', '定价', '1000000000', '万永兴', '上海豫辉投资管理中心(有限合伙)', '89285714', '13392857', '刘轶', '36'}"
22,"{'3800000', '唐琼舒', '16000000', '4000000', '西宁城市投资管理有限公司', '于荣强', '8000000', '5000000', '工银瑞信基金管理有限公司', '12', '竞价', '博宏数君(天津)投资合伙企业(有限合伙)', '华鑫国际信托有限公司', '2300000', '24000000', '3500000', '西宁经济技术开发区投资控股集团有限公司', '2000000', '王小花', '泰康资产管理有限责任公司', '36', '海富通基金管理有限公司'}",1143192,1,{'竞价'},4,"{'36', '王小花', '12', '于荣强'}",21,"{'3800000', '唐琼舒', '16000000', '4000000', '西宁城市投资管理有限公司', '于荣强', '8000000', '5000000', '工银瑞信基金管理有限公司', '12', '博宏数君(天津)投资合伙企业(有限合伙)', '华鑫国际信托有限公司', '2300000', '24000000', '3500000', '西宁经济技术开发区投资控股集团有限公司', '2000000', '王小花', '泰康资产管理有限责任公司', '36', '海富通基金管理有限公司'}"
13,"{'2418964', '967587', '国寿安保基金管理有限公司', '99999992.43', '20000023.29', '陈友', '49999985.88', '财通基金管理有限公司', '竞价', '279999995.3', '富荣基金管理有限公司', '4837929', '13546202'}",12020121,4,"{'99999992.43', '20000023.29', '竞价', '49999985.88'}",4,"{'陈友', '富荣基金管理有限公司', '财通基金管理有限公司', '国寿安保基金管理有限公司'}",9,"{'2418964', '967587', '国寿安保基金管理有限公司', '陈友', '财通基金管理有限公司', '279999995.3', '富荣基金管理有限公司', '4837929', '13546202'}"
20,"{'金鹰基金管理有限公司', '现金', '张家港市金城融创投资管理有限公司', '249999995.3', '64803149', '599999993.8', '新华基金管理股份有限公司', '31496062', '25748034', '327000031.8', '竞价', '中信证券股份有限公司', '19685039', '广州市玄元投资管理有限公司', '399999987.4', '建信基金管理有限责任公司', '47244094', '822999992.3', '12', '华融证券股份有限公司'}",15130073,1,{'竞价'},5,"{'金鹰基金管理有限公司', '现金', '新华基金管理股份有限公司', '建信基金管理有限责任公司', '12'}",19,"{'金鹰基金管理有限公司', '现金', '张家港市金城融创投资管理有限公司', '249999995.3', '64803149', '599999993.8', '新华基金管理股份有限公司', '31496062', '25748034', '327000031.8', '中信证券股份有限公司', '19685039', '广州市玄元投资管理有限公司', '399999987.4', '建信基金管理有限责任公司', '47244094', '822999992.3', '12', '华融证券股份有限公司'}"
7,"{'现金', '38750000', '定价', '237925000', '浙江双井投资有限公司', '泰达宏利基金管理有限公司', '36'}",1890381,1,{'237925000'},5,"{'现金', '定价', '浙江双井投资有限公司', '泰达宏利基金管理有限公司', '36'}",6,"{'现金', '38750000', '定价', '浙江双井投资有限公司', '泰达宏利基金管理有限公司', '36'}"
12,"{'5000000', '现金', '中航鑫港担保有限公司', '大成基金管理有限公司', '7400000', '定价', '陈世明', '4100000', '富国基金管理有限公司', '上海天迪科技投资发展有限公司', '10000000', '12'}",1147094,1,{'10000000'},5,"{'现金', '大成基金管理有限公司', '定价', '富国基金管理有限公司', '12'}",11,"{'5000000', '现金', '中航鑫港担保有限公司', '大成基金管理有限公司', '7400000', '定价', '陈世明', '4100000', '富国基金管理有限公司', '上海天迪科技投资发展有限公司', '12'}"
6,"{'日照港集团及其全资子公司岚山港务', '353107938', '昱桥公司钢企股东', '定价', '91914290', '36'}",178593,2,"{'353107938', '91914290'}",4,"{'日照港集团及其全资子公司岚山港务', '昱桥公司钢企股东', '定价', '36'}",4,"{'日照港集团及其全资子公司岚山港务', '昱桥公司钢企股东', '定价', '36'}"
13,"{'观由投资', '兴全定增107号特定多客户资产管理计划', '现金', '7005253', '定价', '5837711', '泰达宏利瑞源增益4号资产管理计划', '震泽投资', '8756567', '15469936', '程小彦', '36', '3794512'}",1649432,5,"{'7005253', '5837711', '8756567', '15469936', '3794512'}",6,"{'观由投资', '现金', '定价', '震泽投资', '程小彦', '36'}",8,"{'观由投资', '兴全定增107号特定多客户资产管理计划', '现金', '定价', '泰达宏利瑞源增益4号资产管理计划', '震泽投资', '程小彦', '36'}"
4,"{'竞价', '现金', '36', '上海市糖业烟酒(集团)有限公司'}",1096186,0,set(),3,"{'竞价', '现金', '36'}",4,"{'竞价', '现金', '36', '上海市糖业烟酒(集团)有限公司'}"
10,"{'钱炎君', '19161243', '9399856', '134999996', '130000008.5', '264999990.7', '闫鹏舟', '9761388', '竞价', '泰达宏利基金管理有限公司'}",14248183,3,"{'130000008.5', '竞价', '264999990.7'}",0,set(),7,"{'19161243', '钱炎君', '9399856', '134999996', '闫鹏舟', '9761388', '泰达宏利基金管理有限公司'}"
10,"{'现金', '刘雪楠', '竞价', '34300000', '康力投资1号', '沈刚', '10500000', '200000000', '股权', '36'}",1755323,3,"{'34300000', '200000000', '10500000'}",6,"{'现金', '刘雪楠', '竞价', '沈刚', '股权', '36'}",7,"{'现金', '刘雪楠', '竞价', '康力投资1号', '沈刚', '股权', '36'}"
5,"{'现金', '定价', '81724414', '东方国际(集团)有限公司', '36'}",1506476,1,{'定价'},2,"{'现金', '36'}",4,"{'东方国际(集团)有限公司', '现金', '36', '81724414'}"
4,"{'定价', '北京市海淀区国有资本经营管理中心', '36', '155749333'}",320259,0,set(),3,"{'定价', '北京市海淀区国有资本经营管理中心', '36'}",4,"{'定价', '北京市海淀区国有资本经营管理中心', '36', '155749333'}"
20,"{'国泓资产管理有限公司', '11036585', '平安大华基金管理有限公司', '9756097', '180999994', '99999984', '浙江浙商证券资产管理有限公司', '国寿安保基金管理有限公司', '93999994.8', '中广核财务有限责任公司', '5731707', '广发乾和投资有限公司', '易方达基金管理有限公司', '竞价', '4908540', '133999988.4', '80500056', '6097560', '汇添富基金管理股份有限公司', '12'}",94132,1,{'竞价'},9,"{'国泓资产管理有限公司', '平安大华基金管理有限公司', '浙江浙商证券资产管理有限公司', '国寿安保基金管理有限公司', '中广核财务有限责任公司', '易方达基金管理有限公司', '广发乾和投资有限公司', '汇添富基金管理股份有限公司', '12'}",19,"{'国泓资产管理有限公司', '11036585', '平安大华基金管理有限公司', '9756097', '180999994', '99999984', '浙江浙商证券资产管理有限公司', '国寿安保基金管理有限公司', '93999994.8', '中广核财务有限责任公司', '5731707', '广发乾和投资有限公司', '易方达基金管理有限公司', '4908540', '133999988.4', '80500056', '6097560', '汇添富基金管理股份有限公司', '12'}"
11,"{'26795284', '100000000', '10718113', '郑亚平', '华轩基金', '250000000', '竞价', '150053590', '1400000000', '36', '八大处控股'}",9886624,1,{'竞价'},4,"{'郑亚平', '华轩基金', '36', '八大处控股'}",10,"{'26795284', '100000000', '10718113', '郑亚平', '华轩基金', '250000000', '150053590', '1400000000', '36', '八大处控股'}"
11,"{'南京瑞森投资管理合伙企业(有限合伙)', '长城国融投资管理有限公司', '23216652', '11582395', '20225974', '德清县乌灵股权投资合伙企业(有限合伙)', '3457432', '竞价', '长信基金管理有限责任公司', '俞有强', '36'}",1698091,1,{'竞价'},4,"{'长城国融投资管理有限公司', '俞有强', '36', '长信基金管理有限责任公司'}",10,"{'南京瑞森投资管理合伙企业(有限合伙)', '长城国融投资管理有限公司', '23216652', '11582395', '20225974', '德清县乌灵股权投资合伙企业(有限合伙)', '3457432', '长信基金管理有限责任公司', '俞有强', '36'}"
6,"{'568999995.4', '现金', '定价', '100886524', '正元投资有限公司', '36'}",1852698,2,"{'568999995.4', '定价'}",3,"{'正元投资有限公司', '现金', '36'}",4,"{'100886524', '正元投资有限公司', '现金', '36'}"
26,"{'99999962.65', '华安基金管理有限公司', '2096985', '泰达宏利基金管理有限公司', '2437745', '北京中经瑞益投资管理有限公司', '中国万宝工程有限公司', '现金', '1572739', '46540062.45', '280960024.1', '2083879', '7364614', '竞价', '79999977.75', '长春轨道客车股份有限公司', '36', '南车株洲电力机车有限公司', '92999971.75', '诺安基金管理有限公司', '2621231', '1219923', '华宝信托有限责任公司', '59999992.85', '12', '79499983.85'}",1666721,7,"{'99999962.65', '92999971.75', '46540062.45', '竞价', '79999977.75', '59999992.85', '79499983.85'}",10,"{'北京中经瑞益投资管理有限公司', '南车株洲电力机车有限公司', '现金', '华安基金管理有限公司', '12', '诺安基金管理有限公司', '华宝信托有限责任公司', '泰达宏利基金管理有限公司', '长春轨道客车股份有限公司', '36'}",19,"{'北京中经瑞益投资管理有限公司', '1219923', '中国万宝工程有限公司', '现金', '1572739', '华安基金管理有限公司', '南车株洲电力机车有限公司', '12', '诺安基金管理有限公司', '280960024.1', '2083879', '华宝信托有限责任公司', '7364614', '2096985', '泰达宏利基金管理有限公司', '2437745', '长春轨道客车股份有限公司', '36', '2621231'}"
13,"{'平安大华基金管理有限公司', '华安基金管理有限公司', '299999997.6', '12', '28512826', '定价', '武汉盛和源矿产有限公司', '15698587', '191100000', '10000000', '544880104.9', '36', '宜昌兴发集团有限责任公司'}",147053,2,"{'544880104.9', '299999997.6'}",7,"{'平安大华基金管理有限公司', '华安基金管理有限公司', '12', '定价', '武汉盛和源矿产有限公司', '36', '宜昌兴发集团有限责任公司'}",11,"{'平安大华基金管理有限公司', '华安基金管理有限公司', '12', '28512826', '武汉盛和源矿产有限公司', '定价', '15698587', '191100000', '10000000', '36', '宜昌兴发集团有限责任公司'}"
3,"{'定价', '北京神雾环境能源科技集团股份有限公司', '115289766'}",1704793,0,set(),2,"{'定价', '北京神雾环境能源科技集团股份有限公司'}",3,"{'定价', '北京神雾环境能源科技集团股份有限公司', '115289766'}"
5,"{'现金', '广西黑五类食品集团有限责任公司', '153110047', '竞价', '12'}",1770981,0,set(),4,"{'竞价', '现金', '广西黑五类食品集团有限责任公司', '12'}",5,"{'现金', '广西黑五类食品集团有限责任公司', '153110047', '竞价', '12'}"
24,"{'51174474', '东方三山', '15267176', '紫金医药', '新工集团', '27480916', '现金', '543600000', '36641221', '335192800', '51174473', '86014400', '云泰丰', '竞价', '13131969', '180000000', 'Alliance Healthcare', '240000000', '82992366', '金融信7号专项资产管理计划', '100000000', '长城资管', '国禹健康', '36'}",16203335,7,"{'335192800', '543600000', '100000000', '240000000', '86014400', '竞价', '180000000'}",9,"{'现金', '东方三山', '紫金医药', '国禹健康', '长城资管', '新工集团', '云泰丰', 'Alliance Healthcare', '36'}",17,"{'现金', '36641221', '51174474', '51174473', '东方三山', '27480916', '15267176', '紫金医药', '长城资管', '云泰丰', '新工集团', '82992366', '13131969', '国禹健康', '金融信7号专项资产管理计划', 'Alliance Healthcare', '36'}"
16,"{'电化集团', '8700000', '现金', '特定客户资产管理计划', '13030000', '湘潭新盛', '6960000', '定价', '416000', '15650000', '瀚信定增1号', '700000', '湘潭新鹏', '智越投资', '景贤投资', '36'}",1617727,6,"{'8700000', '13030000', '6960000', '416000', '15650000', '700000'}",9,"{'电化集团', '现金', '特定客户资产管理计划', '湘潭新盛', '定价', '湘潭新鹏', '智越投资', '景贤投资', '36'}",10,"{'电化集团', '现金', '特定客户资产管理计划', '湘潭新盛', '定价', '瀚信定增1号', '湘潭新鹏', '智越投资', '景贤投资', '36'}"
16,"{'招商财富资产管理有限公司', '金鹰基金管理有限公司', '5000000', '平安大华基金管理有限公司', '48001697.84', '4500000', '4600000', '62698000', '61335000', '财通基金管理有限公司', '80417000', '申万菱信基金管理有限公司', '68150000', '5900000', '3521768', '12'}",83618,1,{'48001697.84'},5,"{'招商财富资产管理有限公司', '金鹰基金管理有限公司', '平安大华基金管理有限公司', '财通基金管理有限公司', '12'}",15,"{'招商财富资产管理有限公司', '金鹰基金管理有限公司', '5000000', '平安大华基金管理有限公司', '4500000', '4600000', '62698000', '61335000', '财通基金管理有限公司', '80417000', '申万菱信基金管理有限公司', '68150000', '5900000', '3521768', '12'}"
13,"{'40425530', '现金', '48510640', '16170210', '博锐奇投资', '嘉华成美', '西藏锦鸿', '上海原龙', '民加奥瑞金专项资管计划', '建投投资', '9788180', '36', '71062660'}",14471975,5,"{'40425530', '48510640', '16170210', '9788180', '71062660'}",8,"{'现金', '嘉华成美', '博锐奇投资', '西藏锦鸿', '上海原龙', '民加奥瑞金专项资管计划', '建投投资', '36'}",8,"{'现金', '嘉华成美', '博锐奇投资', '西藏锦鸿', '上海原龙', '民加奥瑞金专项资管计划', '建投投资', '36'}"
5,"{'现金', '366413448', '东方国际集团', '竞价', '36'}",1870182,2,"{'竞价', '366413448'}",3,"{'东方国际集团', '现金', '36'}",3,"{'东方国际集团', '现金', '36'}"
15,"{'招商财富资产管理有限公司', '189999990', '21760633', '现金', '泰康资产管理有限责任公司', '219999999.6', '申万菱信(上海)资产管理有限公司', '东海基金管理有限责任公司', '159999990.5', '30000019.71', '15825914', '泰达宏利基金管理有限公司', '2967361', '华富基金管理有限公司', '18793273'}",1815981,0,set(),1,{'现金'},15,"{'招商财富资产管理有限公司', '189999990', '21760633', '泰康资产管理有限责任公司', '现金', '219999999.6', '申万菱信(上海)资产管理有限公司', '东海基金管理有限责任公司', '159999990.5', '30000019.71', '15825914', '泰达宏利基金管理有限公司', '2967361', '华富基金管理有限公司', '18793273'}"
25,"{'137974138', '申万菱信(上海)资产管理有限公司', '138889655', '165603448', '138158621', '现金', '803839997.4', '上银瑞金资本管理有限公司', '定价', '960499998.4', '财通基金管理有限公司', '186013793', '天安财产保险股份有限公司', '800250000.4', '平安大华基金管理有限公司', '华夏人寿保险股份有限公司', '博时基金管理有限公司', '336103448', '801320001.8', '138593103', '1078879999', '创金合信基金管理有限公司', '1949399998', '12', '805559999'}",1670837,0,set(),10,"{'平安大华基金管理有限公司', '华夏人寿保险股份有限公司', '现金', '上银瑞金资本管理有限公司', '博时基金管理有限公司', '定价', '财通基金管理有限公司', '天安财产保险股份有限公司', '创金合信基金管理有限公司', '12'}",25,"{'137974138', '申万菱信(上海)资产管理有限公司', '138889655', '165603448', '138158621', '现金', '803839997.4', '上银瑞金资本管理有限公司', '定价', '960499998.4', '财通基金管理有限公司', '186013793', '天安财产保险股份有限公司', '800250000.4', '平安大华基金管理有限公司', '华夏人寿保险股份有限公司', '博时基金管理有限公司', '336103448', '801320001.8', '138593103', '1078879999', '创金合信基金管理有限公司', '1949399998', '12', '805559999'}"
6,"{'现金', '汪子夏', '10000000', '赵波', '黄维肖', '30000000'}",16389388,2,"{'10000000', '30000000'}",4,"{'汪子夏', '黄维肖', '现金', '赵波'}",4,"{'汪子夏', '黄维肖', '现金', '赵波'}"
14,"{'厦门豫联投资合伙企业(有限合伙)', '现金', '河南豫联能源集团有限责任公司', '900000000', '79086115', '合恩伟业(深圳)资产管理中心(有限合伙)', '北京银杏盛鸿投资管理有限公司', '450000000', '厦门文创汇通投资合伙企业(有限合伙)', '北京蓝巨房地产投资基金管理中心(有限合伙)', '南通卓联资产管理有限公司', '厦门向日葵朝阳投资合伙企业(有限合伙)', '158172231', '36'}",1871793,3,"{'158172231', '450000000', '900000000'}",5,"{'现金', '河南豫联能源集团有限责任公司', '北京银杏盛鸿投资管理有限公司', '南通卓联资产管理有限公司', '36'}",11,"{'厦门豫联投资合伙企业(有限合伙)', '现金', '河南豫联能源集团有限责任公司', '合恩伟业(深圳)资产管理中心(有限合伙)', '79086115', '北京银杏盛鸿投资管理有限公司', '厦门文创汇通投资合伙企业(有限合伙)', '北京蓝巨房地产投资基金管理中心(有限合伙)', '南通卓联资产管理有限公司', '厦门向日葵朝阳投资合伙企业(有限合伙)', '36'}"
4,"{'竞价', '现金', '36', '天津中环电子信息集团有限公司'}",1245414,0,set(),4,"{'竞价', '现金', '36', '天津中环电子信息集团有限公司'}",4,"{'竞价', '现金', '36', '天津中环电子信息集团有限公司'}"
17,"{'金鹰基金管理有限公司', '12711864', '12288135', '北信瑞丰基金管理有限公司', '154999997.4', '18644067', '定价', '华安未来资产管理(上海)有限公司', '149999995.2', '13135593', '成都力鼎银科股权投资基金中心(有限合伙)', '3220341', '38000023.8', '中国华电集团财务有限公司', '144999993', '219999990.6', '12'}",14139754,0,set(),2,"{'定价', '12'}",17,"{'金鹰基金管理有限公司', '12711864', '12288135', '北信瑞丰基金管理有限公司', '154999997.4', '18644067', '定价', '华安未来资产管理(上海)有限公司', '149999995.2', '13135593', '成都力鼎银科股权投资基金中心(有限合伙)', '3220341', '38000023.8', '中国华电集团财务有限公司', '144999993', '219999990.6', '12'}"
26,"{'102000000', '116800036.8', '15931372', '申万菱信(上海)资产管理有限公司', '西藏自治区投资有限公司', '12500000', '112999998.2', '11887254', '14313730', '现金', '12', '定价', '129999995.5', '财通基金管理有限公司', '96999992.64', '华夏人寿保险股份有限公司', '97999992.48', '诺安基金管理有限公司', '东海基金管理有限责任公司', '12009803', '北京鼎博文化发展有限公司', '13848039', '华宝信托有限责任公司', '14215686', '中国华电集团资本控股有限公司', '115999997.8'}",1807816,3,"{'96999992.64', '115999997.8', '97999992.48'}",11,"{'华夏人寿保险股份有限公司', '中国华电集团资本控股有限公司', '现金', '诺安基金管理有限公司', '定价', '东海基金管理有限责任公司', '财通基金管理有限公司', '西藏自治区投资有限公司', '华宝信托有限责任公司', '北京鼎博文化发展有限公司', '12'}",23,"{'102000000', '15931372', '申万菱信(上海)资产管理有限公司', '西藏自治区投资有限公司', '12500000', '112999998.2', '11887254', '14313730', '现金', '12', '定价', '129999995.5', '财通基金管理有限公司', '华夏人寿保险股份有限公司', '诺安基金管理有限公司', '东海基金管理有限责任公司', '12009803', '北京鼎博文化发展有限公司', '13848039', '华宝信托有限责任公司', '14215686', '116800036.8', '中国华电集团资本控股有限公司'}"
21,"{'44444444', '重庆骏旺投资咨询有限公司', '155999998.4', '建信基金管理有限责任公司', '现金', '12', '定价', '财通基金管理有限公司', '63492063', '汇添富基金管理股份有限公司', '华夏人寿保险股份有限公司', '376999997.9', '139999998.6', '119682539', '44126984', '199999998.5', '138999999.6', '118152319', '49523809', '江海证券有限公司', '372179804.9'}",358245,6,"{'199999998.5', '现金', '376999997.9', '定价', '155999998.4', '372179804.9'}",7,"{'华夏人寿保险股份有限公司', '财通基金管理有限公司', '重庆骏旺投资咨询有限公司', '建信基金管理有限责任公司', '江海证券有限公司', '汇添富基金管理股份有限公司', '12'}",15,"{'138999999.6', '华夏人寿保险股份有限公司', '118152319', '49523809', '44444444', '139999998.6', '44126984', '财通基金管理有限公司', '重庆骏旺投资咨询有限公司', '119682539', '江海证券有限公司', '建信基金管理有限责任公司', '63492063', '汇添富基金管理股份有限公司', '12'}"
17,"{'宿迁人合安泰投资合伙企业(有限合伙)', '现金', '5800000', '兴业全球基金管理有限公司', '华安基金管理有限公司', '833300', '招商基金管理有限公司', '7000000', '联发集团有限公司', '广发乾和投资有限公司', '6300000', '海通证券股份有限公司', '南方基金管理有限公司', '海峡产业投资基金(福建)有限合伙企业', '10000000', '12', '6800000'}",1044427,2,"{'833300', '6800000'}",9,"{'现金', '华安基金管理有限公司', '兴业全球基金管理有限公司', '招商基金管理有限公司', '联发集团有限公司', '广发乾和投资有限公司', '海通证券股份有限公司', '南方基金管理有限公司', '12'}",15,"{'宿迁人合安泰投资合伙企业(有限合伙)', '现金', '5800000', '兴业全球基金管理有限公司', '华安基金管理有限公司', '招商基金管理有限公司', '7000000', '联发集团有限公司', '广发乾和投资有限公司', '6300000', '海通证券股份有限公司', '南方基金管理有限公司', '海峡产业投资基金(福建)有限合伙企业', '10000000', '12'}"
7,"{'6533278', '湖州摩山资产管理有限公司', '159999978.2', '定价', '南通金玖锐信投资管理有限公司', '青岛国信资本投资有限公司', '12'}",16527840,0,set(),5,"{'湖州摩山资产管理有限公司', '定价', '南通金玖锐信投资管理有限公司', '青岛国信资本投资有限公司', '12'}",7,"{'6533278', '湖州摩山资产管理有限公司', '12', '定价', '南通金玖锐信投资管理有限公司', '青岛国信资本投资有限公司', '159999978.2'}"
4,"{'现金', '竞价', '电信院', '36'}",597088,1,{'竞价'},3,"{'现金', '电信院', '36'}",3,"{'现金', '电信院', '36'}"
16,"{'8422579', '现金', '长城资本管理有限公司', '10107095', '正海集团有限公司', '定价', '11791610', '中国长城资产管理股份有限公司', '上海汽车集团股权投资有限公司-上汽投资-颀瑞1号', '150999999.3', '125833330.3', '10107096', '176166653.4', '151000014.2', '36', '山东省国有资产投资控股有限公司'}",15649803,1,{'125833330.3'},7,"{'36', '长城资本管理有限公司', '现金', '正海集团有限公司', '定价', '中国长城资产管理股份有限公司', '山东省国有资产投资控股有限公司'}",15,"{'8422579', '长城资本管理有限公司', '现金', '10107095', '正海集团有限公司', '定价', '11791610', '中国长城资产管理股份有限公司', '上海汽车集团股权投资有限公司-上汽投资-颀瑞1号', '150999999.3', '10107096', '176166653.4', '151000014.2', '36', '山东省国有资产投资控股有限公司'}"
15,"{'孔鑫明', '现金', '北京鑫达唯特投资管理中心', '7050000', '200389300', '鹏华基金管理有限公司-全国社保基金一零四、五零三组合', '上海晨灿投资中心', '定价', '泰达宏利基金管理有限公司-价值成长定向增发235号资产管理计划', '深圳市创东方长盈投资企业', '100194600', '杭州君达投资管理有限公司', '36', '14100000', '浙江硅谷天堂产业投资管理有限公司-健盛投资基金'}",2040502,2,"{'100194600', '200389300'}",9,"{'孔鑫明', '北京鑫达唯特投资管理中心', '现金', '上海晨灿投资中心', '定价', '深圳市创东方长盈投资企业', '杭州君达投资管理有限公司', '36', '浙江硅谷天堂产业投资管理有限公司-健盛投资基金'}",13,"{'孔鑫明', '北京鑫达唯特投资管理中心', '现金', '7050000', '鹏华基金管理有限公司-全国社保基金一零四、五零三组合', '上海晨灿投资中心', '定价', '泰达宏利基金管理有限公司-价值成长定向增发235号资产管理计划', '深圳市创东方长盈投资企业', '杭州君达投资管理有限公司', '36', '14100000', '浙江硅谷天堂产业投资管理有限公司-健盛投资基金'}"
19,"{'1245583', '许利银', '36', '现金', '1198712', '第一创业证券股份有限公司', '2393889', '2374420', '定价', '博时基金管理有限公司', '上海韬韫投资管理有限公司', '财通基金管理有限公司', '1198590', '1198591', '陈邦锐', '浙江东港投资有限公司', '12', '泓德基金管理有限公司', '1116184'}",14765349,0,set(),12,"{'许利银', '现金', '第一创业证券股份有限公司', '12', '定价', '博时基金管理有限公司', '上海韬韫投资管理有限公司', '财通基金管理有限公司', '陈邦锐', '浙江东港投资有限公司', '36', '泓德基金管理有限公司'}",19,"{'1245583', '许利银', '36', '现金', '1198712', '第一创业证券股份有限公司', '2393889', '2374420', '博时基金管理有限公司', '上海韬韫投资管理有限公司', '1198590', '财通基金管理有限公司', '定价', '1198591', '陈邦锐', '浙江东港投资有限公司', '12', '泓德基金管理有限公司', '1116184'}"
5,"{'现金', '华君电力', '550692259', '定价', '36'}",15616957,1,{'550692259'},4,"{'定价', '现金', '36', '华君电力'}",4,"{'定价', '现金', '36', '华君电力'}"
4,"{'36', '竞价', '现金', '永泰控股'}",1499981,0,set(),4,"{'永泰控股', '现金', '竞价', '36'}",4,"{'36', '竞价', '现金', '永泰控股'}"
7,"{'现金', '练卫飞', '定价', '苏光伟', '21000000', '25000000', '36'}",883819,0,set(),5,"{'现金', '练卫飞', '定价', '苏光伟', '36'}",7,"{'现金', '练卫飞', '定价', '苏光伟', '21000000', '25000000', '36'}"
24,"{'14170000', '江苏瑞华投资控股集团有限公司', '新活力资本投资有限公司', '183600000', '兴业全球基金管理有限公司', '安信证券股份有限公司', '竞价', '宝盈基金管理有限公司', '102024000', '169200000', '华夏人寿保险股份有限公司', '36', '福建旗滨集团有限公司', '21500000', '147600000', '宁波天堂硅谷亨达股权投资合伙企业(有限合伙)', '154800000', '93600000', '13000000', '23500000', '东海基金管理有限公司', '25500000', '20500000', '12'}",713662,9,"{'14170000', '169200000', '154800000', '93600000', '183600000', '21500000', '23500000', '147600000', '102024000'}",11,"{'华夏人寿保险股份有限公司', '福建旗滨集团有限公司', '兴业全球基金管理有限公司', '12', '安信证券股份有限公司', '东海基金管理有限公司', '竞价', '宝盈基金管理有限公司', '江苏瑞华投资控股集团有限公司', '新活力资本投资有限公司', '36'}",15,"{'华夏人寿保险股份有限公司', '福建旗滨集团有限公司', '兴业全球基金管理有限公司', '12', '13000000', '宝盈基金管理有限公司', '东海基金管理有限公司', '25500000', '安信证券股份有限公司', '竞价', '20500000', '江苏瑞华投资控股集团有限公司', '新活力资本投资有限公司', '36', '宁波天堂硅谷亨达股权投资合伙企业(有限合伙)'}"
4,"{'350000000', '冀中能源集团有限责任公司', '现金', '36'}",156727,0,set(),3,"{'冀中能源集团有限责任公司', '现金', '36'}",4,"{'350000000', '冀中能源集团有限责任公司', '现金', '36'}"
5,"{'现金', '竞价', '辽宁曙光集团有限责任公司', '47000000', '36'}",236020,1,{'47000000'},4,"{'36', '竞价', '现金', '辽宁曙光集团有限责任公司'}",4,"{'辽宁曙光集团有限责任公司', '现金', '竞价', '36'}"
18,"{'12000000', '现金', '上投摩根基金管理有限公司', '上海申能资产管理有限公司', '5400000', '国泰君安证券股份有限公司', '竞价', '3000000', '富国基金管理有限公司', '江阴市文华纱线有限公司', '1500000', '鹏华基金管理有限公司', '6300000', '10000000', '宁波鹿剑复合材料有限公司', '上海证券有限责任公司', '12', '东海证券有限责任公司'}",969071,2,"{'1500000', '竞价'}",2,"{'现金', '12'}",16,"{'12000000', '现金', '上投摩根基金管理有限公司', '上海申能资产管理有限公司', '5400000', '国泰君安证券股份有限公司', '3000000', '江阴市文华纱线有限公司', '富国基金管理有限公司', '鹏华基金管理有限公司', '6300000', '10000000', '宁波鹿剑复合材料有限公司', '上海证券有限责任公司', '12', '东海证券有限责任公司'}"
7,"{'13837838', '现金', '定价', '富国资产-互金1号资产管理计划', '124540540', '周世平', '36'}",1712722,0,set(),4,"{'定价', '现金', '36', '周世平'}",7,"{'13837838', '现金', '定价', '富国资产-互金1号资产管理计划', '124540540', '周世平', '36'}"
10,"{'134919048', '现金', '1206176300', '定价', '股权、债权', '1000000000', '深圳中航', '111856823', '36', '中航国际'}",596314,4,"{'1000000000', '134919048', '1206176300', '股权、债权'}",5,"{'现金', '定价', '深圳中航', '36', '中航国际'}",6,"{'现金', '定价', '深圳中航', '111856823', '36', '中航国际'}"
9,"{'101500000', '康恩贝', '现金', '杭州华弘海泰投资管理合伙企业', '定价', '上海巽利投资有限公司', '邢翰学', '6383647', '36'}",2156686,1,{'101500000'},7,"{'康恩贝', '现金', '杭州华弘海泰投资管理合伙企业', '定价', '上海巽利投资有限公司', '邢翰学', '36'}",8,"{'康恩贝', '现金', '杭州华弘海泰投资管理合伙企业', '上海巽利投资有限公司', '定价', '邢翰学', '6383647', '36'}"
22,"{'国联安基金管理有限公司', '1058500', '48000000', '申万菱信基金管理有限公司', '100320000', '现金', '兴业全球基金管理有限公司', '198000000', '竞价', '31755000', '197925000', '天治基金管理有限公司', '36', '6600000', '航天科工资产管理有限公司', '384000000', '1600000', '6597500', '中国航天科工集团公司', '12800000', '3344000', '12'}",1683307,1,{'竞价'},9,"{'36', '现金', '兴业全球基金管理有限公司', '航天科工资产管理有限公司', '国联安基金管理有限公司', '申万菱信基金管理有限公司', '天治基金管理有限公司', '中国航天科工集团公司', '12'}",21,"{'国联安基金管理有限公司', '1058500', '48000000', '申万菱信基金管理有限公司', '100320000', '现金', '兴业全球基金管理有限公司', '198000000', '31755000', '197925000', '天治基金管理有限公司', '36', '6600000', '航天科工资产管理有限公司', '384000000', '1600000', '6597500', '中国航天科工集团公司', '12800000', '3344000', '12'}"
5,"{'现金', '100000000', '珠海地海恒通投资有限公司', '竞价', '36'}",153460,1,{'竞价'},3,"{'现金', '珠海地海恒通投资有限公司', '36'}",4,"{'100000000', '现金', '珠海地海恒通投资有限公司', '36'}"
23,"{'35000000', '北京开元', '162400000', '50000000', '郭宏杰', '深圳富邦', '139200000', '现金', '255200000', '长江万汇', '55000000', '10000000', '30000000', '232000000', '深圳龙源', '90000000', '深圳智为', '417600000', '麦田投资', '46400000', '北京卓远', '北京力天', '36'}",1568033,6,"{'417600000', '255200000', '46400000', '162400000', '232000000', '139200000'}",11,"{'现金', '麦田投资', '深圳龙源', '北京卓远', '长江万汇', '北京开元', '北京力天', '郭宏杰', '深圳富邦', '36', '深圳智为'}",17,"{'现金', '麦田投资', '深圳龙源', '35000000', '55000000', '90000000', '北京开元', '北京卓远', '北京力天', '长江万汇', '50000000', '10000000', '郭宏杰', '深圳富邦', '30000000', '36', '深圳智为'}"
7,"{'现金', '京国发基金', '52874551', '竞价', '448028673', '金隅集团', '36'}",1105697,2,"{'竞价', '448028673'}",4,"{'金隅集团', '京国发基金', '现金', '36'}",5,"{'现金', '京国发基金', '52874551', '金隅集团', '36'}"
15,"{'40425530', '1063916', '现金', '16170210', '嘉华成美', '博锐奇投资', '西藏锦鸿', '定价', '上海原龙', '8724264', '周原', '37021505', '建投投资', '36', '71062660'}",15349302,0,set(),9,"{'现金', '嘉华成美', '博锐奇投资', '西藏锦鸿', '定价', '上海原龙', '周原', '建投投资', '36'}",15,"{'40425530', '1063916', '现金', '16170210', '嘉华成美', '博锐奇投资', '西藏锦鸿', '定价', '上海原龙', '8724264', '周原', '37021505', '建投投资', '36', '71062660'}"
17,"{'山东黄金集团平度黄金有限公司', '现金', '上投摩根基金管理有限公司', '6937217', '山东黄金集团有限公司', '12', '定价', '融通基金管理有限公司', '2000000', '资产', '1500000', '2006834', '1940000', '南方基金管理有限公司', '中国人寿资产管理有限公司', '北京开元久盛投资有限公司', '36'}",1366124,0,set(),12,"{'山东黄金集团平度黄金有限公司', '36', '现金', '上投摩根基金管理有限公司', '山东黄金集团有限公司', '定价', '融通基金管理有限公司', '资产', '南方基金管理有限公司', '中国人寿资产管理有限公司', '北京开元久盛投资有限公司', '12'}",17,"{'山东黄金集团平度黄金有限公司', '现金', '上投摩根基金管理有限公司', '6937217', '山东黄金集团有限公司', '12', '定价', '融通基金管理有限公司', '2000000', '资产', '1500000', '2006834', '1940000', '南方基金管理有限公司', '中国人寿资产管理有限公司', '北京开元久盛投资有限公司', '36'}"
10,"{'南京瑞茂投资管理合伙企业(有限合伙)', '32000000', '204800000', '张家港市金茂集体资产经营管理中心', '安徽天大投资有限公司', '9800000', '62720000', '30000000', '12', '192000000'}",1130189,3,"{'62720000', '204800000', '192000000'}",3,"{'安徽天大投资有限公司', '12', '张家港市金茂集体资产经营管理中心'}",7,"{'南京瑞茂投资管理合伙企业(有限合伙)', '32000000', '张家港市金茂集体资产经营管理中心', '安徽天大投资有限公司', '9800000', '30000000', '12'}"
4,"{'竞价', '现金', '36', '巨化集团'}",505252,0,set(),4,"{'竞价', '现金', '36', '巨化集团'}",4,"{'竞价', '现金', '36', '巨化集团'}"
5,"{'800000000', '现金', '竞价', '百业源投资有限公司', '36'}",15486868,1,{'800000000'},4,"{'竞价', '现金', '百业源投资有限公司', '36'}",4,"{'竞价', '现金', '百业源投资有限公司', '36'}"
7,"{'现金', '1638000000', '国管中心', '竞价', '263000000', '北汽集团', '36'}",557888,3,"{'1638000000', '竞价', '263000000'}",4,"{'国管中心', '现金', '北汽集团', '36'}",4,"{'国管中心', '现金', '北汽集团', '36'}"
21,"{'12706481', '324999992.2', '杭州东裕投资合伙企业(有限合伙)', '现金', '浙江东睿资产管理有限公司', '上海盈保投资管理有限公司', '定价', '杭州艮雷投资管理合伙企业(有限合伙)', '1499999995', '27954256', '190597204', '7623889', '219999994.7', '100000005.5', '33672173', '李澄澄', '浙江围海控股集团有限公司', '41296060', '265000001.5', '60000006.43', '36'}",15780140,1,{'100000005.5'},7,"{'36', '现金', '浙江东睿资产管理有限公司', '上海盈保投资管理有限公司', '定价', '李澄澄', '浙江围海控股集团有限公司'}",20,"{'7623889', '现金', '浙江围海控股集团有限公司', '219999994.7', '12706481', '浙江东睿资产管理有限公司', '上海盈保投资管理有限公司', '杭州东裕投资合伙企业(有限合伙)', '杭州艮雷投资管理合伙企业(有限合伙)', '定价', '41296060', '265000001.5', '33672173', '1499999995', '27954256', '324999992.2', '李澄澄', '190597204', '60000006.43', '36'}"
23,"{'青海机电', '288000000', '1152000000', '青海汽车运输', '50000000', '200000000', '现金', '贵州中科', '定价', '西宁特钢第一期员工持股计划', '新疆泰达', '1440000000', '青海发展投资', '576000000', '3899000', '上海穆昭', '100000000', '邓建宇', '青海物资产业', '250000000', '22458240', '国华人寿', '36'}",1642462,5,"{'288000000', '1152000000', '1440000000', '22458240', '576000000'}",13,"{'青海机电', '36', '现金', '贵州中科', '青海汽车运输', '邓建宇', '青海物资产业', '新疆泰达', '定价', '青海发展投资', '国华人寿', '西宁特钢第一期员工持股计划', '上海穆昭'}",18,"{'青海机电', '现金', '贵州中科', '青海汽车运输', '100000000', '邓建宇', '青海物资产业', '定价', '新疆泰达', '青海发展投资', '250000000', '西宁特钢第一期员工持股计划', '50000000', '3899000', '国华人寿', '200000000', '36', '上海穆昭'}"
18,"{'北信瑞丰基金宏瑞2号资产管理计划', '245999973.2', '现金', '北信瑞丰基金弘唯基石华丰1号资产管理计划', '25000013.92', '7932924', '806192', '定价', '8061915', '8997099', '199999987.3', '6449532', '中意资产-招商银行-定增精选87号资产管理产品', '圆信永丰基金-工商银行-圆信永丰互信6号资产管理计划', '249999984.2', '广东省铁路发展基金有限责任公司', '279000040', '12'}",20270805,3,"{'249999984.2', '25000013.92', '279000040'}",3,"{'定价', '现金', '12'}",15,"{'北信瑞丰基金宏瑞2号资产管理计划', '245999973.2', '北信瑞丰基金弘唯基石华丰1号资产管理计划', '现金', '7932924', '806192', '8061915', '8997099', '定价', '199999987.3', '6449532', '圆信永丰基金-工商银行-圆信永丰互信6号资产管理计划', '中意资产-招商银行-定增精选87号资产管理产品', '广东省铁路发展基金有限责任公司', '12'}"
14,"{'5208333', '粮油集团', '现金', '961000', '新翔投资', '26041667', '定价', '轻盐创投', '天心实业', '52083333', '高新创投', '2475000', '新翼投资', '36'}",1599533,2,"{'26041667', '961000'}",9,"{'粮油集团', '现金', '新翔投资', '定价', '天心实业', '轻盐创投', '高新创投', '新翼投资', '36'}",12,"{'5208333', '粮油集团', '现金', '新翔投资', '定价', '天心实业', '轻盐创投', '52083333', '高新创投', '2475000', '新翼投资', '36'}"
7,"{'4709449', '7807283', '2008033', '董建华', '浙信安享(天津)投资管理中心(有限合伙)', '淄博矿业集团有限责任公司', '36'}",1134125,0,set(),3,"{'淄博矿业集团有限责任公司', '36', '董建华'}",7,"{'4709449', '7807283', '2008033', '董建华', '浙信安享(天津)投资管理中心(有限合伙)', '淄博矿业集团有限责任公司', '36'}"
4,"{'现金', '61000000', '北京有色金属研究总院', '36'}",1332112,1,{'61000000'},3,"{'现金', '北京有色金属研究总院', '36'}",3,"{'现金', '北京有色金属研究总院', '36'}"
21,"{'3499999990', '799999991.2', '南方资产', '499999998.5', '187441424', '泰康人寿', '国开投', '74976569', '华泰汽车', '定价', '力勤投资', '281162136', '恒天集团', '328022492', '华能资本', '2999999991', '西安开源', '中信证券', '46860356', '1999999994', '36'}",1304889,5,"{'3499999990', '74976569', '46860356', '281162136', '187441424'}",11,"{'泰康人寿', '国开投', '华泰汽车', '定价', '华能资本', '西安开源', '中信证券', '力勤投资', '恒天集团', '36', '南方资产'}",16,"{'泰康人寿', '国开投', '799999991.2', '华泰汽车', '328022492', '华能资本', '2999999991', '定价', '西安开源', '中信证券', '力勤投资', '1999999994', '恒天集团', '36', '南方资产', '499999998.5'}"
4,"{'KKR(卢森堡)', '竞价', '现金', '36'}",1102739,1,{'竞价'},1,{'现金'},3,"{'KKR(卢森堡)', '现金', '36'}"
25,"{'299025000', '9850000', '14950000', '511665000', '西安投资控股有限公司', '新华人寿保险股份有限公司', '兴业全球基金管理有限公司', '9650000', '财通基金管理有限公司', '256497000', '301683000', '信达澳银基金管理有限公司', '上海复星产业投资有限公司', '261813000', '银华基金管理有限公司', '博时基金管理有限公司', '264471000', '11250000', '11350000', '9950000', '265474979.8', '19250000', '9987772', '12', '397371000'}",1133967,1,{'265474979.8'},9,"{'银华基金管理有限公司', '兴业全球基金管理有限公司', '新华人寿保险股份有限公司', '博时基金管理有限公司', '西安投资控股有限公司', '财通基金管理有限公司', '信达澳银基金管理有限公司', '上海复星产业投资有限公司', '12'}",24,"{'299025000', '9850000', '14950000', '511665000', '西安投资控股有限公司', '新华人寿保险股份有限公司', '兴业全球基金管理有限公司', '9650000', '财通基金管理有限公司', '256497000', '301683000', '信达澳银基金管理有限公司', '上海复星产业投资有限公司', '261813000', '银华基金管理有限公司', '博时基金管理有限公司', '264471000', '11250000', '11350000', '9950000', '19250000', '9987772', '12', '397371000'}"
3,"{'昝圣达', '现金', '36'}",492598,0,set(),3,"{'昝圣达', '现金', '36'}",3,"{'昝圣达', '现金', '36'}"
11,"{'22514600', '现金', '118670585', '彭韬', '潘利斌', '定价', '23000000', '21000000', '姚芳媛', '36', '朱蓉娟'}",8523,0,set(),7,"{'现金', '彭韬', '潘利斌', '定价', '姚芳媛', '36', '朱蓉娟'}",11,"{'22514600', '现金', '118670585', '彭韬', '潘利斌', '定价', '23000000', '21000000', '姚芳媛', '36', '朱蓉娟'}"
14,"{'12000000', '现金', '天津证大金马股权投资基金合伙企业(有限合伙)', '山西证券股份有限公司', '河南农开产业基金投资有限责任公司', '江苏瑞华投资发展有限公司', '北京首沣投资管理有限公司', '13000000', '定价', '1310000', '7000000', '中信证券股份有限公司', '6000000', '12'}",1502911,3,"{'12000000', '山西证券股份有限公司', '1310000'}",3,"{'定价', '现金', '12'}",11,"{'现金', '天津证大金马股权投资基金合伙企业(有限合伙)', '河南农开产业基金投资有限责任公司', '江苏瑞华投资发展有限公司', '北京首沣投资管理有限公司', '13000000', '定价', '7000000', '中信证券股份有限公司', '6000000', '12'}"
14,"{'52258852', '现金', '北信瑞丰基金管理有限公司', '62271062', '信诚基金管理有限公司', '财通基金管理有限公司', '竞价', '建信基金管理有限公司', '120879120', '宁波梅山保税港区和盛乾通股权投资合伙企业', '8133680', '238827838', '12', '华泰柏瑞基金管理有限公司'}",16044511,1,{'竞价'},2,"{'现金', '12'}",13,"{'52258852', '现金', '北信瑞丰基金管理有限公司', '62271062', '信诚基金管理有限公司', '财通基金管理有限公司', '建信基金管理有限公司', '120879120', '宁波梅山保税港区和盛乾通股权投资合伙企业', '8133680', '238827838', '12', '华泰柏瑞基金管理有限公司'}"
21,"{'283500000', '45000000', '现金', '850500000', '长安平安富贵恒康医疗资产管理计划', '28664021', '20224868', '竞价', '喀什思山', '382250100', '宋丽华', '振兴基金', '新余恒道', '15000000', '云能金融', '20175132', '381310000', '541750000', '11111111', '210000000', '36'}",310362,13,"{'381310000', '283500000', '850500000', '541750000', '11111111', '210000000', '15000000', '28664021', '20224868', '竞价', '382250100', '20175132', '45000000'}",8,"{'现金', '宋丽华', '振兴基金', '新余恒道', '长安平安富贵恒康医疗资产管理计划', '云能金融', '喀什思山', '36'}",8,"{'现金', '宋丽华', '振兴基金', '新余恒道', '长安平安富贵恒康医疗资产管理计划', '云能金融', '喀什思山', '36'}"
9,"{'现金', '22229822', '哲安投资', '定价', '嘉财盈沣', '柯维龙', '22229823', '英拓聚鑫', '36'}",1717577,2,"{'22229822', '22229823'}",7,"{'现金', '哲安投资', '定价', '嘉财盈沣', '柯维龙', '英拓聚鑫', '36'}",7,"{'现金', '哲安投资', '定价', '嘉财盈沣', '柯维龙', '英拓聚鑫', '36'}"
6,"{'现金', '12', '其他发行对象', '竞价', '城建集团', '36'}",409282,0,set(),6,"{'36', '现金', '其他发行对象', '竞价', '城建集团', '12'}",6,"{'36', '现金', '其他发行对象', '竞价', '城建集团', '12'}"
17,"{'平安大华基金管理有限公司', '140999994.9', '12844909', '641799992', '14272121', '申万菱信(上海)资产管理有限公司', '134999993.6', '财通基金管理有限公司', '东海基金管理有限责任公司', '易方达基金管理有限公司', '华鑫证券有限责任公司', '14005712', '147200033.1', '13415794', '61065651', '12', '149999991.7'}",2274576,1,{'134999993.6'},1,{'12'},16,"{'平安大华基金管理有限公司', '140999994.9', '12844909', '641799992', '14272121', '申万菱信(上海)资产管理有限公司', '东海基金管理有限责任公司', '财通基金管理有限公司', '易方达基金管理有限公司', '华鑫证券有限责任公司', '14005712', '147200033.1', '13415794', '61065651', '12', '149999991.7'}"
15,"{'现金', '40000000', '1000000', '世纪阳光控股集团有限公司', '23000000', '深圳华强鼎信担保投资有限公司', '15000000', '无锡市国联发展(集团)有限公司', '深圳市远致投资有限公司', '竞价', '3000000', '深圳市福田投资发展公司', '深圳市江南丰投资有限公司', '10000000', '36'}",820147,8,"{'40000000', '无锡市国联发展(集团)有限公司', '23000000', '15000000', '竞价', '3000000', '10000000', '1000000'}",7,"{'现金', '世纪阳光控股集团有限公司', '深圳华强鼎信担保投资有限公司', '深圳市远致投资有限公司', '深圳市福田投资发展公司', '深圳市江南丰投资有限公司', '36'}",7,"{'现金', '世纪阳光控股集团有限公司', '深圳华强鼎信担保投资有限公司', '深圳市远致投资有限公司', '深圳市福田投资发展公司', '深圳市江南丰投资有限公司', '36'}"
14,"{'66447609', '平安大华基金管理有限公司', '16317016', '兴证证券资产管理有限公司', '23776223', '12', '嘉实基金管理有限公司', '财通基金管理有限公司', '竞价', '37200550', '上海交运(集团)公司', '安信证券股份有限公司', '36', '11188811'}",15397053,5,"{'66447609', '16317016', '23776223', '竞价', '37200550'}",7,"{'平安大华基金管理有限公司', '兴证证券资产管理有限公司', '12', '财通基金管理有限公司', '嘉实基金管理有限公司', '安信证券股份有限公司', '36'}",9,"{'平安大华基金管理有限公司', '36', '兴证证券资产管理有限公司', '嘉实基金管理有限公司', '财通基金管理有限公司', '上海交运(集团)公司', '安信证券股份有限公司', '12', '11188811'}"
12,"{'1188287360', '现金', '296891078.6', '前海新旺兆', '定价', '30356961', '43821558.96', '汇通正源', '121501775', '4480732', '陈永弟', '36'}",4923226,3,"{'1188287360', '296891078.6', '43821558.96'}",6,"{'现金', '前海新旺兆', '定价', '汇通正源', '陈永弟', '36'}",9,"{'现金', '前海新旺兆', '定价', '30356961', '汇通正源', '121501775', '4480732', '陈永弟', '36'}"
7,"{'银华财富资本管理(北京)有限公司', '现金', '民生加银基金管理有限公司', '华安基金管理有限公司', '70374100', '56946400', '12'}",1139255,0,set(),4,"{'12', '现金', '民生加银基金管理有限公司', '华安基金管理有限公司'}",7,"{'银华财富资本管理(北京)有限公司', '现金', '70374100', '民生加银基金管理有限公司', '华安基金管理有限公司', '56946400', '12'}"
6,"{'现金', '146833894', '4800000000', '康得投资集团有限公司', '竞价', '36'}",1842529,3,"{'竞价', '146833894', '4800000000'}",3,"{'现金', '36', '康得投资集团有限公司'}",3,"{'现金', '36', '康得投资集团有限公司'}"
23,"{'4340277', '47743055', '杭州希野投资管理合伙企业(有限合伙)', '西藏自治区投资有限公司', '50000000', '34722222', '17361111', '200000000', '550000000', '现金', '400000000', '舟山如山汇金壹号投资合伙企业(有限合伙)', '国机财务有限责任公司', '定价', '中广核财务有限责任公司', '300000000', '泰信基金管理有限公司', '150000000', '13020833', '北京领瑞投资管理有限公司', '26041666', '华安未来资产管理(上海)有限公司', '36'}",1763909,3,"{'150000000', '200000000', '300000000'}",8,"{'36', '现金', '国机财务有限责任公司', '定价', '中广核财务有限责任公司', '西藏自治区投资有限公司', '北京领瑞投资管理有限公司', '泰信基金管理有限公司'}",20,"{'现金', '400000000', '舟山如山汇金壹号投资合伙企业(有限合伙)', '4340277', '国机财务有限责任公司', '13020833', '定价', '550000000', '中广核财务有限责任公司', '47743055', '杭州希野投资管理合伙企业(有限合伙)', '西藏自治区投资有限公司', '北京领瑞投资管理有限公司', '26041666', '34722222', '17361111', '50000000', '泰信基金管理有限公司', '华安未来资产管理(上海)有限公司', '36'}"
6,"{'现金', '40000000', '266400000', '竞价', '徐国瑞', '36'}",901597,3,"{'竞价', '40000000', '266400000'}",3,"{'现金', '徐国瑞', '36'}",3,"{'现金', '徐国瑞', '36'}"
14,"{'69899989.5', '56400055.29', '北信瑞丰基金管理有限公司', '80899986.96', '中融基金管理有限公司', '2027850', '财通基金管理有限公司', '竞价', '3988975', '2346968', '137499968.3', '鹏华资产管理(深圳)有限公司', '12', '1636207'}",14780779,2,"{'137499968.3', '竞价'}",4,"{'北信瑞丰基金管理有限公司', '12', '财通基金管理有限公司', '中融基金管理有限公司'}",12,"{'69899989.5', '56400055.29', '北信瑞丰基金管理有限公司', '80899986.96', '中融基金管理有限公司', '2027850', '财通基金管理有限公司', '3988975', '2346968', '鹏华资产管理(深圳)有限公司', '12', '1636207'}"
16,"{'东方国际集团上海投资有限公司', '上海赛领并购投资基金合伙企业(有限合伙)', '现金', '毛蔚瀛', '199999993.8', '4618940', '上海诚鼎新扬子投资合伙企业(有限合伙)', '上海交大产业投资管理(集团)有限公司', '定价', '9237875', '4618937', '上海交大企业管理中心', '99999986.05', '100000051', '36', '上海赛领讯达股权投资基金合伙企业(有限合伙)'}",14109507,2,"{'199999993.8', '99999986.05'}",6,"{'东方国际集团上海投资有限公司', '毛蔚瀛', '现金', '定价', '上海交大企业管理中心', '36'}",14,"{'东方国际集团上海投资有限公司', '上海赛领并购投资基金合伙企业(有限合伙)', '现金', '毛蔚瀛', '4618940', '上海诚鼎新扬子投资合伙企业(有限合伙)', '上海交大产业投资管理(集团)有限公司', '9237875', '定价', '4618937', '上海交大企业管理中心', '100000051', '36', '上海赛领讯达股权投资基金合伙企业(有限合伙)'}"
4,"{'唐山港口实业集团有限公司', '现金', '竞价', '36'}",720840,1,{'竞价'},3,"{'唐山港口实业集团有限公司', '现金', '36'}",3,"{'唐山港口实业集团有限公司', '现金', '36'}"
16,"{'36', '新疆金阳股权投资合伙企业(有限合伙', '6952000', '东海基金管理有限责任公司', '61230600', '122461200', '财通基金管理有限公司', '184440000', '60482400', '国投财务有限公司', '14076000', '21200000', '中国船舶重工集团公司', '7038000', '12', '太平资产管理有限公司'}",222472,8,"{'6952000', '122461200', '184440000', '61230600', '60482400', '14076000', '21200000', '7038000'}",6,"{'12', '东海基金管理有限责任公司', '财通基金管理有限公司', '国投财务有限公司', '36', '太平资产管理有限公司'}",8,"{'36', '新疆金阳股权投资合伙企业(有限合伙', '东海基金管理有限责任公司', '财通基金管理有限公司', '国投财务有限公司', '中国船舶重工集团公司', '12', '太平资产管理有限公司'}"
14,"{'现金', '14000000', '13000000', '融通基金管理有限公司', '15000000', '张大中', '7000000', '国泰基金管理有限公司', '海通证券股份有限公司', '鹏华基金管理有限公司', '10000000', '12', '江苏开元国际集团轻工业品进出口股份有限公司', '太平资产管理有限公司'}",1454855,1,{'14000000'},8,"{'现金', '融通基金管理有限公司', '国泰基金管理有限公司', '海通证券股份有限公司', '鹏华基金管理有限公司', '12', '江苏开元国际集团轻工业品进出口股份有限公司', '太平资产管理有限公司'}",13,"{'现金', '13000000', '融通基金管理有限公司', '15000000', '张大中', '7000000', '国泰基金管理有限公司', '海通证券股份有限公司', '鹏华基金管理有限公司', '10000000', '12', '江苏开元国际集团轻工业品进出口股份有限公司', '太平资产管理有限公司'}"
22,"{'北京丰实联合投资基金(有限合伙)', '105769200', '长安基金管理有限公司', '629999500', '36923000', '38461500', '1374999600', '45000000', '15848700', '天安财产保险股份有限公司', '财通基金管理有限公司', '竞价', '585000000', '平安大华基金管理有限公司', '国华人寿保险股份有限公司', '206033100', '中信证券股份有限公司', '499999500', '华融证券股份有限公司', '48461500', '12', '479999000'}",5003389,7,"{'629999500', '206033100', '585000000', '竞价', '1374999600', '499999500', '479999000'}",8,"{'平安大华基金管理有限公司', '长安基金管理有限公司', '国华人寿保险股份有限公司', '天安财产保险股份有限公司', '财通基金管理有限公司', '中信证券股份有限公司', '华融证券股份有限公司', '12'}",15,"{'平安大华基金管理有限公司', '105769200', '北京丰实联合投资基金(有限合伙)', '长安基金管理有限公司', '15848700', '36923000', '38461500', '国华人寿保险股份有限公司', '天安财产保险股份有限公司', '财通基金管理有限公司', '中信证券股份有限公司', '华融证券股份有限公司', '48461500', '12', '45000000'}"
21,"{'华安基金管理有限公司', '28000000', '988573', '现金', '1342856', '财通基金管理有限公司', '46999995', '34600055', '竞价', '26099990', '800000', '平安大华基金管理有限公司', '46999960', '吴歌军', '1342857', '745714', '泓德基金管理有限公司', '九泰基金管理有限公司', '78299970', '12', '2237142'}",1809701,0,set(),3,"{'竞价', '现金', '12'}",21,"{'华安基金管理有限公司', '28000000', '988573', '现金', '1342856', '财通基金管理有限公司', '46999995', '34600055', '26099990', '竞价', '800000', '平安大华基金管理有限公司', '46999960', '吴歌军', '1342857', '745714', '泓德基金管理有限公司', '九泰基金管理有限公司', '78299970', '12', '2237142'}"
19,"{'深圳市津房物业发展有限公司', '渤海证券有限责任公司', '20000000', '现金', '齐鲁证券有限公司', '64885166', '天津市房地产开发经营有限公司', '12', '长江证券有限责任公司', '易方达基金管理有限公司', '22000000', '上海锦江国际投资管理有限公司', '25000000', '深圳建设(集团)有限公司', '17400000', '南方工业资产管理有限公司', '宏大兴业投资控股有限公司', '36', '24000000'}",1343801,0,set(),12,"{'深圳市津房物业发展有限公司', '36', '渤海证券有限责任公司', '现金', '齐鲁证券有限公司', '天津市房地产开发经营有限公司', '长江证券有限责任公司', '易方达基金管理有限公司', '上海锦江国际投资管理有限公司', '南方工业资产管理有限公司', '宏大兴业投资控股有限公司', '12'}",19,"{'深圳市津房物业发展有限公司', '渤海证券有限责任公司', '20000000', '现金', '齐鲁证券有限公司', '64885166', '天津市房地产开发经营有限公司', '12', '长江证券有限责任公司', '易方达基金管理有限公司', '22000000', '上海锦江国际投资管理有限公司', '25000000', '深圳建设(集团)有限公司', '17400000', '南方工业资产管理有限公司', '宏大兴业投资控股有限公司', '36', '24000000'}"
8,"{'现金', '福建漳龙集团有限公司', '400000000', '71556351', '北京碧水源科技股份有限公司', '35778175', '200000000', '36'}",15616824,0,set(),3,"{'福建漳龙集团有限公司', '现金', '36'}",8,"{'现金', '福建漳龙集团有限公司', '400000000', '71556351', '北京碧水源科技股份有限公司', '35778175', '200000000', '36'}"
4,"{'车轼', '竞价', '现金', '36'}",15663924,1,{'竞价'},3,"{'车轼', '现金', '36'}",3,"{'车轼', '现金', '36'}"
4,"{'陈光珠', '竞价', '现金', '36'}",15664131,0,set(),4,"{'陈光珠', '竞价', '现金', '36'}",4,"{'陈光珠', '竞价', '现金', '36'}"
4,"{'现金', '竞价', '天通高新集团有限公司', '36'}",488750,0,set(),4,"{'36', '竞价', '天通高新集团有限公司', '现金'}",4,"{'现金', '竞价', '天通高新集团有限公司', '36'}"
19,"{'浙江天堂硅谷久融股权投资合伙企业(有限合伙)', '西安长登投资管理有限合伙企业', '现金', '中航鑫港担保有限公司', '8600000', '广发证券股份有限公司', '4400000', '定价', '15000000', '9000000', '天津远策恒昌股权投资基金合伙企业(有限合伙)', '陈晓军', '6200000', '8800000', '海亮集团有限公司', '陈伟峰', '9900000', '12', '西安长咸投资管理有限合伙企业'}",1145498,2,"{'4400000', '6200000'}",10,"{'西安长登投资管理有限合伙企业', '现金', '中航鑫港担保有限公司', '广发证券股份有限公司', '定价', '陈晓军', '海亮集团有限公司', '陈伟峰', '12', '西安长咸投资管理有限合伙企业'}",17,"{'浙江天堂硅谷久融股权投资合伙企业(有限合伙)', '西安长登投资管理有限合伙企业', '现金', '中航鑫港担保有限公司', '8600000', '广发证券股份有限公司', '定价', '15000000', '9000000', '天津远策恒昌股权投资基金合伙企业(有限合伙)', '陈晓军', '8800000', '海亮集团有限公司', '陈伟峰', '9900000', '12', '西安长咸投资管理有限合伙企业'}"
19,"{'新余创裕投资中心(有限合伙)', '现金', '304902', '于洪涛', '457353', '何建锋', '李刚', '刘海金', '182941', '4034869', '金鹰筠业琢石资产管理计划', '29473856', '竞价', '李礼', '李景相', '赵洪武', '203268', '508170', '36'}",1684600,1,{'竞价'},10,"{'现金', '于洪涛', '何建锋', '李刚', '刘海金', '金鹰筠业琢石资产管理计划', '李礼', '赵洪武', '李景相', '36'}",18,"{'新余创裕投资中心(有限合伙)', '现金', '304902', '于洪涛', '457353', '何建锋', '李刚', '刘海金', '182941', '4034869', '金鹰筠业琢石资产管理计划', '29473856', '李礼', '李景相', '赵洪武', '203268', '508170', '36'}"
14,"{'150000000', '现金', '中华保险', '银河投资', '100000000', '定价', '中电科投资', '1768346', '航天财务', '884173', '2652519', '50000000', '36', '南方资产'}",1677782,2,"{'150000000', '50000000'}",8,"{'36', '现金', '中华保险', '银河投资', '定价', '航天财务', '中电科投资', '南方资产'}",12,"{'现金', '中华保险', '银河投资', '100000000', '定价', '中电科投资', '1768346', '航天财务', '884173', '2652519', '36', '南方资产'}"
18,"{'汇祥镒泰(天津)股权投资基金合伙企业(有限合伙)', '9450000', '46978002.2', '66000000', '湖北珩生投资有限公司', '4431887', '光明食品(集团)有限公司', '12', '定价', '301521992.6', '28445471', '699600000', '33900000', '上海六禾之泰投资中心(有限合伙)', '上海广电资产经营管理有限公司', '100170000', '36', '359340000'}",186612,0,set(),5,"{'湖北珩生投资有限公司', '12', '定价', '上海广电资产经营管理有限公司', '36'}",18,"{'汇祥镒泰(天津)股权投资基金合伙企业(有限合伙)', '9450000', '46978002.2', '66000000', '湖北珩生投资有限公司', '4431887', '光明食品(集团)有限公司', '12', '定价', '301521992.6', '28445471', '699600000', '33900000', '上海六禾之泰投资中心(有限合伙)', '上海广电资产经营管理有限公司', '100170000', '36', '359340000'}"
3,"{'武汉市水务集团有限公司', '140688600', '36'}",409851,0,set(),2,"{'武汉市水务集团有限公司', '36'}",3,"{'武汉市水务集团有限公司', '140688600', '36'}"
5,"{'现金', '157749762', '双星集团', '竞价', '36'}",14109784,2,"{'竞价', '157749762'}",3,"{'现金', '36', '双星集团'}",3,"{'现金', '36', '双星集团'}"
4,"{'中国长城资产管理公司', '宁夏宝塔石化集团有限公司', '36', '债权'}",677179,0,set(),4,"{'中国长城资产管理公司', '宁夏宝塔石化集团有限公司', '36', '债权'}",4,"{'中国长城资产管理公司', '宁夏宝塔石化集团有限公司', '36', '债权'}"
26,"{'乐源盛世', '80971659', '2024291', '50000000', '3175384', '屠叶初', '新纪元期货', '105977500', '江信基金', '400000000', '定价', '10121457', '153392600', '26494300', '15686400', '21452935', '10000000', '48269068', '拉萨热风', '36', '31051133', '郑亮', '5363218', '俞斌', '238449200', '东吴证券'}",16768195,7,"{'105977500', '400000000', '153392600', '26494300', '15686400', '10000000', '238449200'}",10,"{'新纪元期货', '36', '乐源盛世', '江信基金', '定价', '郑亮', '俞斌', '东吴证券', '屠叶初', '拉萨热风'}",19,"{'新纪元期货', '31051133', '乐源盛世', '80971659', '江信基金', '5363218', '定价', '东吴证券', '2024291', '10121457', '俞斌', '50000000', '3175384', '21452935', '郑亮', '48269068', '36', '屠叶初', '拉萨热风'}"
4,"{'竞价', '现金', '12', '友阿控股'}",1835052,0,set(),4,"{'竞价', '现金', '12', '友阿控股'}",4,"{'竞价', '现金', '12', '友阿控股'}"
17,"{'现金', '单银木', '70000000', '杨强跃', '单际华', '2000000', '许荣根', '1500000', '3000000', '陆拥军', '寿林平', '刘安贵', '郑红梅', '1000000', '刘亮俊', '36', '7500000'}",1150675,6,"{'70000000', '2000000', '1500000', '3000000', '1000000', '7500000'}",11,"{'36', '现金', '单银木', '杨强跃', '许荣根', '寿林平', '刘安贵', '郑红梅', '刘亮俊', '单际华', '陆拥军'}",11,"{'36', '现金', '单银木', '杨强跃', '许荣根', '寿林平', '刘安贵', '郑红梅', '刘亮俊', '单际华', '陆拥军'}"
25,"{'147250000', '4980000', '天平汽车保险股份有限公司', '77190000', '93000000', '7000000', '河北凌云工业集团有限公司', '6500000', '6000000', '8000000', '国机财务有限责任公司', '定价', '36', '王绍林', '唐向山', '上海证大投资管理有限公司', '雅戈尔投资有限公司', '26889989', '108500000', '9500000', '124000000', '100750000', '1734838', '上海景贤投资有限公司', '12'}",499454,7,"{'147250000', '77190000', '93000000', '124000000', '100750000', '26889989', '108500000'}",3,"{'36', '定价', '12'}",18,"{'4980000', '王绍林', '天平汽车保险股份有限公司', '9500000', '12', '国机财务有限责任公司', '定价', '唐向山', '7000000', '上海证大投资管理有限公司', '雅戈尔投资有限公司', '1734838', '河北凌云工业集团有限公司', '6500000', '上海景贤投资有限公司', '6000000', '8000000', '36'}"
10,"{'20000000', '张金刚', '王荣礼', '4500000', '19150000', '2000000', '李梓亮', '林韶山', '12', '李江海'}",333228,4,"{'20000000', '19150000', '4500000', '2000000'}",6,"{'张金刚', '王荣礼', '李梓亮', '林韶山', '12', '李江海'}",6,"{'张金刚', '王荣礼', '李梓亮', '林韶山', '12', '李江海'}"
30,"{'1758999991', '91182640', '1521629989', '1708999987', '海通证券股份有限公司', '119760100', '现金', '兴业全球基金管理有限公司', '1986820059', '120101265', '竞价', '纳爱斯集团有限公司', '中国海洋石油总公司', '1512719998', '太平洋资产管理有限责任公司', '1512110000', '平安资产管理有限责任公司', '雅戈尔集团股份有限公司', '91719710', '1992479986', '1504139998', '90665461', '90542495', '103013863', '106027727', '刘益谦', '1502099992', '91145871', '泰康资产管理有限责任公司', '12'}",1203242,6,"{'1512110000', '1758999991', '1521629989', '1504139998', '竞价', '1512719998'}",11,"{'太平洋资产管理有限责任公司', '现金', '兴业全球基金管理有限公司', '平安资产管理有限责任公司', '雅戈尔集团股份有限公司', '中国海洋石油总公司', '海通证券股份有限公司', '纳爱斯集团有限公司', '泰康资产管理有限责任公司', '12', '刘益谦'}",24,"{'91182640', '1708999987', '海通证券股份有限公司', '119760100', '现金', '兴业全球基金管理有限公司', '1986820059', '120101265', '纳爱斯集团有限公司', '中国海洋石油总公司', '太平洋资产管理有限责任公司', '平安资产管理有限责任公司', '雅戈尔集团股份有限公司', '91719710', '1992479986', '90665461', '90542495', '103013863', '106027727', '刘益谦', '1502099992', '91145871', '泰康资产管理有限责任公司', '12'}"
17,"{'12056493', '10334137', '第一创业证券股份有限公司', '499999975.8', '天风证券股份有限公司', '199999978.7', '17223561', '财通基金管理有限公司', '天安财产保险股份有限公司', '竞价', '349999991.8', '299999997.1', '史佩浩', '20000044.32', '688944', '6889424', '12'}",12056841,2,"{'竞价', '349999991.8'}",3,"{'史佩浩', '12', '财通基金管理有限公司'}",15,"{'12056493', '10334137', '第一创业证券股份有限公司', '499999975.8', '天风证券股份有限公司', '199999978.7', '17223561', '财通基金管理有限公司', '天安财产保险股份有限公司', '299999997.1', '史佩浩', '20000044.32', '688944', '6889424', '12'}"
9,"{'622650000', '现金', '成都工投', '定价', '15000000', '29800000', '股权', '36', '王府井国际'}",1502546,3,"{'622650000', '29800000', '15000000'}",5,"{'现金', '定价', '成都工投', '股权', '王府井国际'}",6,"{'现金', '定价', '成都工投', '股权', '36', '王府井国际'}"
11,"{'226240000', '234515972.3', '北信瑞丰基金管理有限公司', '平安资产管理有限责任公司', '光大保德信基金管理有限公司', '8292644', '263004000', '9300000', '泰达宏利基金管理有限公司', '8000000', '12'}",94041,4,"{'234515972.3', '226240000', '9300000', '263004000'}",5,"{'北信瑞丰基金管理有限公司', '平安资产管理有限责任公司', '光大保德信基金管理有限公司', '泰达宏利基金管理有限公司', '12'}",7,"{'北信瑞丰基金管理有限公司', '平安资产管理有限责任公司', '光大保德信基金管理有限公司', '8292644', '泰达宏利基金管理有限公司', '8000000', '12'}"
7,"{'现金', '26800000', '财通证券资产管理有限公司', '70000000', '定价', '杭州永银投资合伙企业', '36'}",12007008,0,set(),5,"{'现金', '财通证券资产管理有限公司', '定价', '杭州永银投资合伙企业', '36'}",7,"{'现金', '26800000', '财通证券资产管理有限公司', '70000000', '定价', '杭州永银投资合伙企业', '36'}"
6,"{'现金', '定价', '浙江香溢控股有限公司', '中天发展控股集团有限公司', '36', '45000000'}",1378655,1,{'定价'},4,"{'中天发展控股集团有限公司', '现金', '36', '浙江香溢控股有限公司'}",5,"{'现金', '浙江香溢控股有限公司', '中天发展控股集团有限公司', '36', '45000000'}"
13,"{'15249714', '现金', '景和道', '7624857', '定价', '青尚股权', '11437285', '3812428', '深圳鼎江', '宁波中汇', '莫杨岛川', '36', '深圳平湖'}",4940933,0,set(),9,"{'36', '现金', '景和道', '定价', '青尚股权', '宁波中汇', '莫杨岛川', '深圳鼎江', '深圳平湖'}",13,"{'15249714', '现金', '景和道', '7624857', '11437285', '青尚股权', '3812428', '定价', '深圳鼎江', '宁波中汇', '莫杨岛川', '36', '深圳平湖'}"
24,"{'127710000', '9160000', '21141600', '20007900', '现金', '12', '定价', '1410000', '129999982.2', '299999304', '204915406', '9000000', '民生加银基金管理有限公司', '27153123', '兵工财务有限责任公司', '14440832', '汇添富基金管理有限公司', '江西德宏投资管理有限公司', '9161380', '129980400', '安徽新华传媒股份有限公司', '上海浦东科技投资有限公司', '385302815', '江西省铁路投资集团公司'}",141918,9,"{'127710000', '1410000', '129980400', '129999982.2', '299999304', '20007900', '204915406', '9000000', '385302815'}",10,"{'现金', '江西德宏投资管理有限公司', '民生加银基金管理有限公司', '兵工财务有限责任公司', '定价', '安徽新华传媒股份有限公司', '上海浦东科技投资有限公司', '12', '汇添富基金管理有限公司', '江西省铁路投资集团公司'}",15,"{'现金', '江西德宏投资管理有限公司', '27153123', '14440832', '民生加银基金管理有限公司', '兵工财务有限责任公司', '9160000', '9161380', '定价', '安徽新华传媒股份有限公司', '21141600', '上海浦东科技投资有限公司', '12', '汇添富基金管理有限公司', '江西省铁路投资集团公司'}"
3,"{'现金', '36', '上海交运(集团)公司'}",2096193,0,set(),2,"{'现金', '36'}",3,"{'现金', '36', '上海交运(集团)公司'}"
6,"{'银河集团', '现金', '830394700', '竞价', '84907433', '36'}",15533512,3,"{'竞价', '84907433', '830394700'}",3,"{'银河集团', '现金', '36'}",3,"{'银河集团', '现金', '36'}"
8,"{'40999159', '现金', '马革', '常厚春', '李祖芹', '55299599', '12', '41642235'}",93012,3,"{'41642235', '40999159', '55299599'}",5,"{'现金', '马革', '常厚春', '李祖芹', '12'}",5,"{'现金', '马革', '常厚春', '李祖芹', '12'}"
6,"{'现金', '80000000', '定价', '208000000', '上海紫江(集团)有限公司', '36'}",283042,1,{'208000000'},3,"{'现金', '定价', '36'}",5,"{'上海紫江(集团)有限公司', '现金', '定价', '80000000', '36'}"
21,"{'39650000', '江玉明', '李霞', '49959000', '14800000', '5000000', '36874500', '定价', '4540000', '4650000', '信达澳银基金管理有限公司', '117364000', '安惊川', '36', '张宇', '10100000', '6300000', '36002200', '80093000', '中发控股', '12'}",711425,6,"{'39650000', '36874500', '80093000', '49959000', '36002200', '117364000'}",9,"{'安惊川', '36', '江玉明', '李霞', '张宇', '定价', '中发控股', '信达澳银基金管理有限公司', '12'}",15,"{'安惊川', '5000000', '江玉明', '李霞', '12', '张宇', '定价', '10100000', '4540000', '6300000', '4650000', '中发控股', '信达澳银基金管理有限公司', '36', '14800000'}"
8,"{'113895200', '现金', '广发基金管理有限公司', '91116200', '华富基金管理有限公司', '36', '宏运(深圳)资本有限公司', '250569500'}",1563669,4,"{'113895200', '91116200', '宏运(深圳)资本有限公司', '250569500'}",3,"{'广发基金管理有限公司', '华富基金管理有限公司', '现金'}",4,"{'华富基金管理有限公司', '广发基金管理有限公司', '现金', '36'}"
9,"{'28558225', '中欧基金管理有限公司', '兴业全球基金管理有限公司', '19463955', '78922225', '62846580', '汇添富基金管理股份有限公司', '12', '招商证券股份有限公司'}",308969,3,"{'19463955', '78922225', '62846580'}",1,{'12'},6,"{'28558225', '中欧基金管理有限公司', '兴业全球基金管理有限公司', '汇添富基金管理股份有限公司', '12', '招商证券股份有限公司'}"
5,"{'900000000', '现金', '100000000', '保利投资控股有限公司', '保利久联控股集团有限责任公司'}",1643320,2,"{'100000000', '900000000'}",3,"{'保利久联控股集团有限责任公司', '现金', '保利投资控股有限公司'}",3,"{'保利久联控股集团有限责任公司', '现金', '保利投资控股有限公司'}"
20,"{'平安大华基金管理有限公司', '现金', '373266000', '东方红鹭(北京)国际投资有限公司', '360450000', '甘肃省煤炭资源开发投资有限责任公司', '诺安基金管理有限公司', '申万菱信(上海)资产管理有限公司', '1194257', '财通基金管理有限公司', '9565998.57', '61800000', '495018000', '天弘基金管理有限公司', '46600000', '宝盈基金管理有限公司', '泰达宏利基金管理有限公司', '华安未来资产管理(上海)有限公司', '12', '45000000'}",1562428,1,{'9565998.57'},9,"{'平安大华基金管理有限公司', '现金', '甘肃省煤炭资源开发投资有限责任公司', '诺安基金管理有限公司', '财通基金管理有限公司', '天弘基金管理有限公司', '宝盈基金管理有限公司', '泰达宏利基金管理有限公司', '12'}",19,"{'平安大华基金管理有限公司', '现金', '373266000', '东方红鹭(北京)国际投资有限公司', '360450000', '甘肃省煤炭资源开发投资有限责任公司', '诺安基金管理有限公司', '申万菱信(上海)资产管理有限公司', '1194257', '财通基金管理有限公司', '61800000', '495018000', '天弘基金管理有限公司', '46600000', '宝盈基金管理有限公司', '泰达宏利基金管理有限公司', '华安未来资产管理(上海)有限公司', '12', '45000000'}"
9,"{'现金', '302755', '52679382', '1739999987', '竞价', '9999997.65', '建信基金管理有限责任公司', '12', '华泰柏瑞基金管理有限公司'}",1854146,2,"{'9999997.65', '竞价'}",4,"{'建信基金管理有限责任公司', '现金', '12', '华泰柏瑞基金管理有限公司'}",7,"{'现金', '302755', '52679382', '1739999987', '建信基金管理有限责任公司', '12', '华泰柏瑞基金管理有限公司'}"
4,"{'定价', '三胞集团有限公司', '36', '101754385'}",1722044,1,{'定价'},2,"{'三胞集团有限公司', '36'}",3,"{'三胞集团有限公司', '36', '101754385'}"
12,"{'50000027.32', '农银汇理(上海)资产管理有限公司', '华安基金管理有限公司', '249999995.6', '竞价', '青岛城投金融控股集团有限公司', '14188422', '2837686', '中国华电集团财务有限公司', '5675368', '12', '99999984.16'}",1827192,3,"{'竞价', '50000027.32', '99999984.16'}",1,{'12'},9,"{'农银汇理(上海)资产管理有限公司', '华安基金管理有限公司', '249999995.6', '青岛城投金融控股集团有限公司', '14188422', '2837686', '中国华电集团财务有限公司', '5675368', '12'}"
17,"{'230000000', '现金', '12931034', '10775862', '100000000', '股权', '定价', '岳顺红', '恩川实业', '24784483', '高小榕', '120000000', '50000000', '5387931', '高小峰', '久锐实业', '36'}",1562994,4,"{'100000000', '50000000', '230000000', '120000000'}",9,"{'现金', '股权', '定价', '岳顺红', '恩川实业', '高小榕', '高小峰', '久锐实业', '36'}",13,"{'现金', '12931034', '10775862', '股权', '定价', '岳顺红', '恩川实业', '24784483', '高小榕', '5387931', '高小峰', '久锐实业', '36'}"
18,"{'金鹰基金管理有限公司', '上海禹恒投资管理中心(有限合伙)', '12', '196899997.2', '竞价', '四川大西洋集团有限责任公司', '10649546', '23548806', '上海锐懿资产管理有限公司', '宝盈基金管理有限公司', '199499995.6', '155893100', '30135951', '5538128', '70499994.52', '36', '29743202', '36662407.36'}",906643,1,{'竞价'},6,"{'36', '金鹰基金管理有限公司', '四川大西洋集团有限责任公司', '上海锐懿资产管理有限公司', '宝盈基金管理有限公司', '12'}",17,"{'金鹰基金管理有限公司', '上海禹恒投资管理中心(有限合伙)', '12', '196899997.2', '四川大西洋集团有限责任公司', '10649546', '23548806', '上海锐懿资产管理有限公司', '宝盈基金管理有限公司', '199499995.6', '155893100', '30135951', '5538128', '70499994.52', '36', '29743202', '36662407.36'}"
4,"{'福建建工', '竞价', '现金', '36'}",941632,1,{'竞价'},3,"{'福建建工', '现金', '36'}",3,"{'福建建工', '现金', '36'}"
6,"{'现金', '59599987.84', '深圳市宏利创新投资合伙企业(有限合伙)', '竞价', '4542682', '12'}",19172706,1,{'竞价'},2,"{'现金', '12'}",5,"{'现金', '59599987.84', '深圳市宏利创新投资合伙企业(有限合伙)', '4542682', '12'}"
15,"{'35571992.04', '16095925', '71143984.08', '5365308', '中国再生资源开发有限公司', '177859966.8', '财通基金管理有限公司', '竞价', '银晟资本(天津)股权投资基金管理有限公司', '10730616', '供销集团北京鑫诚投资基金管理有限公司', '106715982.8', '26826541', '36', '四川省物流产业股权投资基金管理有限公司'}",16040568,4,"{'106715982.8', '竞价', '35571992.04', '71143984.08'}",3,"{'中国再生资源开发有限公司', '36', '财通基金管理有限公司'}",11,"{'16095925', '5365308', '中国再生资源开发有限公司', '177859966.8', '财通基金管理有限公司', '银晟资本(天津)股权投资基金管理有限公司', '10730616', '供销集团北京鑫诚投资基金管理有限公司', '26826541', '36', '四川省物流产业股权投资基金管理有限公司'}"
14,"{'现金', '齐星集团', '76019172', '首誉资管', '52566449', '千石创富', '英大基金', '46298911', '94013072', '永康投资', '聚辉投资', '金元惠理', '68740740', '36'}",675754,0,set(),9,"{'现金', '齐星集团', '首誉资管', '千石创富', '英大基金', '永康投资', '聚辉投资', '金元惠理', '36'}",14,"{'现金', '齐星集团', '76019172', '首誉资管', '52566449', '千石创富', '英大基金', '46298911', '94013072', '永康投资', '聚辉投资', '金元惠理', '68740740', '36'}"
2,"{'创越能源集团有限公司', '20130000'}",1043481,0,set(),1,{'创越能源集团有限公司'},2,"{'创越能源集团有限公司', '20130000'}"
5,"{'20000000', '现金', '中国光大控股有限公司', '60', '竞价'}",312670,1,{'20000000'},4,"{'中国光大控股有限公司', '60', '竞价', '现金'}",4,"{'中国光大控股有限公司', '60', '竞价', '现金'}"
16,"{'孙军', '李鹏', '刘夷', '现金', '1100000', '1600000', '福建丰琪投资有限公司', '翁祖翔', '95891980', '魏立平', '薛建', '宋克均', '聂慧', '刘晓鸣', '1000000', '36'}",67012,0,set(),12,"{'孙军', '李鹏', '刘夷', '现金', '36', '福建丰琪投资有限公司', '翁祖翔', '宋克均', '薛建', '聂慧', '刘晓鸣', '魏立平'}",16,"{'孙军', '李鹏', '刘夷', '现金', '1100000', '1600000', '福建丰琪投资有限公司', '翁祖翔', '95891980', '魏立平', '薛建', '宋克均', '聂慧', '刘晓鸣', '1000000', '36'}"
14,"{'现金', '6934813', '29368932', '16643551', '27739251', '83217753', '11095700', '博源凯德', '东莞鑫隆', '贤诚矿业', '南方资本', '大成创新', '睿渠投资', '36'}",609619,6,"{'16643551', '29368932', '27739251', '83217753', '11095700', '6934813'}",8,"{'现金', '博源凯德', '东莞鑫隆', '贤诚矿业', '南方资本', '大成创新', '睿渠投资', '36'}",8,"{'现金', '博源凯德', '东莞鑫隆', '贤诚矿业', '南方资本', '大成创新', '睿渠投资', '36'}"
14,"{'9404537', '申万菱信-长盈定增8号资产管理计划', '现金', '11814745', '长城国融', '博时资本-谦益跃升2号专项资产管理计划', '申万菱信-掌运百纳资产管理计划', '定价', '25992439', '2362949', '申万菱信-写瑞竑观定增1号资产管理计划', '4725898', '申万菱信-怀瑾抱钰定增1号资产管理计划', '36'}",1805562,3,"{'4725898', '11814745', '2362949'}",4,"{'定价', '现金', '36', '长城国融'}",11,"{'9404537', '申万菱信-长盈定增8号资产管理计划', '现金', '长城国融', '博时资本-谦益跃升2号专项资产管理计划', '申万菱信-掌运百纳资产管理计划', '定价', '25992439', '申万菱信-写瑞竑观定增1号资产管理计划', '申万菱信-怀瑾抱钰定增1号资产管理计划', '36'}"
5,"{'现金', '竞价', '福建新大陆科技集团有限公司', '36', '7500000'}",819705,1,{'7500000'},3,"{'竞价', '现金', '福建新大陆科技集团有限公司'}",4,"{'36', '竞价', '现金', '福建新大陆科技集团有限公司'}"
4,"{'现金', '定价', '36', '大唐集团'}",15625057,0,set(),4,"{'定价', '现金', '36', '大唐集团'}",4,"{'定价', '现金', '36', '大唐集团'}"
10,"{'现金', '上海凯势拟筹建和管理的股权投资基金', '定价', '21360000', '重庆宝润拟筹建和管理的股权投资基金', '20535600', '信诚达融拟筹建和管理的股权投资基金', '10000000', '聚赢产业基金', '36'}",1844097,3,"{'21360000', '10000000', '20535600'}",7,"{'现金', '上海凯势拟筹建和管理的股权投资基金', '定价', '重庆宝润拟筹建和管理的股权投资基金', '信诚达融拟筹建和管理的股权投资基金', '聚赢产业基金', '36'}",7,"{'现金', '上海凯势拟筹建和管理的股权投资基金', '定价', '重庆宝润拟筹建和管理的股权投资基金', '信诚达融拟筹建和管理的股权投资基金', '聚赢产业基金', '36'}"
7,"{'18947360', '现金', '12', '昆明钢铁控股有限公司', '75789440', '建信基金管理有限责任公司', '36'}",1095071,2,"{'75789440', '18947360'}",5,"{'36', '现金', '昆明钢铁控股有限公司', '建信基金管理有限责任公司', '12'}",5,"{'36', '现金', '昆明钢铁控股有限公司', '建信基金管理有限责任公司', '12'}"
12,"{'新华基金管理有限公司', '河南和华实业有限公司', '17700000', '36900000', '15700000', '5510526', '竞价', '中信证券股份有限公司', '河南富轩实业有限公司', '华西证券有限责任公司', '12', '8400000'}",408780,6,"{'17700000', '36900000', '5510526', '15700000', '竞价', '8400000'}",1,{'12'},6,"{'新华基金管理有限公司', '河南和华实业有限公司', '中信证券股份有限公司', '河南富轩实业有限公司', '华西证券有限责任公司', '12'}"
8,"{'现金', '兴业全球基金管理有限公司', '8430000', '招商基金管理有限公司', '华宝信托有限责任公司', '中国人寿资产管理有限公司', '8000000', '12'}",985007,1,{'8430000'},6,"{'现金', '兴业全球基金管理有限公司', '招商基金管理有限公司', '华宝信托有限责任公司', '中国人寿资产管理有限公司', '12'}",7,"{'现金', '兴业全球基金管理有限公司', '招商基金管理有限公司', '华宝信托有限责任公司', '中国人寿资产管理有限公司', '8000000', '12'}"
13,"{'现金', '华安基金管理有限公司', '71079520', '35775212', '15992892', '财通基金管理有限公司', '17223456', '广发基金管理有限公司', '中信建投基金管理有限公司', '竞价', '国家集成电路产业投资基金股份有限公司', '15859617', '12'}",1840938,1,{'竞价'},3,"{'国家集成电路产业投资基金股份有限公司', '现金', '12'}",12,"{'现金', '华安基金管理有限公司', '71079520', '35775212', '15992892', '财通基金管理有限公司', '17223456', '广发基金管理有限公司', '中信建投基金管理有限公司', '国家集成电路产业投资基金股份有限公司', '15859617', '12'}"
11,"{'现金', '张新美', '刘锐', '林忠峰', '罗斌', '龙建播', '儒亿投资', '连若晹', '36', '北京电信', '赵序宏'}",1100102,0,set(),11,"{'现金', '张新美', '刘锐', '林忠峰', '罗斌', '龙建播', '儒亿投资', '连若晹', '36', '北京电信', '赵序宏'}",11,"{'现金', '张新美', '刘锐', '林忠峰', '罗斌', '龙建播', '儒亿投资', '连若晹', '36', '北京电信', '赵序宏'}"
20,"{'480000290', '6729500', '154777803', '张明', '50000185', '郭为', '199999997', '26917900', '64603000', '王廷月', '1149999076', '竞价', '100000370', '中信建投基金管理有限公司', '29609700', '王晓岩', '13459000', '220000071', '36', '钱学宁'}",1908177,7,"{'480000290', '50000185', '199999997', '竞价', '100000370', '220000071', '1149999076'}",7,"{'张明', '郭为', '王廷月', '中信建投基金管理有限公司', '王晓岩', '36', '钱学宁'}",13,"{'6729500', '154777803', '张明', '郭为', '26917900', '64603000', '王廷月', '中信建投基金管理有限公司', '29609700', '王晓岩', '13459000', '36', '钱学宁'}"
26,"{'公用集团', '1085906250', '99999999', '300000015', '55555555', '现金', '西藏瑞华', '鹏华基金管理的“全国社保基金一零四组合”和“全国社保基金五零三组合”', '42222230', '杭州岳玺', '180000000', '190000035', '22222222', '241312500', '249999750', '王治国', '55555500', '凯鼎聚富', '810000000', '方德-香山7号证券投资基金', '23965323', '66666670', '107843953.5', '249999997.5', '深圳丰之海', '36'}",1637919,7,"{'方德-香山7号证券投资基金', '1085906250', '107843953.5', '300000015', '249999750', '249999997.5', '190000035'}",9,"{'公用集团', '西藏瑞华', '现金', '鹏华基金管理的“全国社保基金一零四组合”和“全国社保基金五零三组合”', '杭州岳玺', '王治国', '凯鼎聚富', '深圳丰之海', '36'}",19,"{'现金', '公用集团', '西藏瑞华', '鹏华基金管理的“全国社保基金一零四组合”和“全国社保基金五零三组合”', '23965323', '241312500', '66666670', '99999999', '42222230', '杭州岳玺', '王治国', '55555500', '凯鼎聚富', '180000000', '深圳丰之海', '810000000', '36', '22222222', '55555555'}"
23,"{'申万菱信(上海)资产管理有限公司', '华泰资产管理有限公司', '30383211', '265999989.1', '华泰柏瑞基金管理', '邦信资产管理有限公司', '14662921', '定价', '财通基金管理有限公司', '332999992.6', '23813868', '24087591', '诺安基金管理有限公司', '160705614.2', '泓德基金管理有限公司', '宁波沁融股权投资合伙企业(有限合伙)', '25547445', '279999997.2', '24270072', '华宝信托有限责任公司', '260999993.3', '广西铁路发展投资基金(有限合伙)', '263999997.4'}",1818868,4,"{'260999993.3', '160705614.2', '263999997.4', '332999992.6'}",8,"{'华泰柏瑞基金管理', '邦信资产管理有限公司', '诺安基金管理有限公司', '定价', '财通基金管理有限公司', '华泰资产管理有限公司', '华宝信托有限责任公司', '泓德基金管理有限公司'}",19,"{'华泰柏瑞基金管理', '邦信资产管理有限公司', '24087591', '14662921', '宁波沁融股权投资合伙企业(有限合伙)', '25547445', '279999997.2', '定价', '申万菱信(上海)资产管理有限公司', '24270072', '财通基金管理有限公司', '华泰资产管理有限公司', '华宝信托有限责任公司', '诺安基金管理有限公司', '23813868', '广西铁路发展投资基金(有限合伙)', '30383211', '265999989.1', '泓德基金管理有限公司'}"
6,"{'现金', '13266998', '竞价', '159999995.9', '12', '红塔红土基金管理有限公司'}",15312043,2,"{'159999995.9', '竞价'}",3,"{'现金', '12', '红塔红土基金管理有限公司'}",4,"{'13266998', '现金', '12', '红塔红土基金管理有限公司'}"
3,"{'36', '现金', '镇江新区经济开发总公司'}",1089269,0,set(),3,"{'36', '现金', '镇江新区经济开发总公司'}",3,"{'36', '现金', '镇江新区经济开发总公司'}"
15,"{'现金', '40000000', '8000000', '43700000', '架桥资本', '70000000', '174800000', '东灿贸易', '34960000', '何晓玉', '305900000', '10000000', '36', '法尔胜泓昇', '华西集团'}",332291,8,"{'40000000', '43700000', '70000000', '174800000', '34960000', '10000000', '8000000', '305900000'}",7,"{'现金', '架桥资本', '东灿贸易', '何晓玉', '36', '法尔胜泓昇', '华西集团'}",7,"{'现金', '架桥资本', '东灿贸易', '何晓玉', '36', '法尔胜泓昇', '华西集团'}"
4,"{'竞价', '现金', '36', '卫星控股'}",1705198,0,set(),4,"{'竞价', '现金', '36', '卫星控股'}",4,"{'竞价', '现金', '36', '卫星控股'}"
18,"{'平安大华基金管理有限公司', '28600000', '现金', '16800000', '16000000', '4400000', '定价', '15000000', '东海基金管理有限责任公司', '财通基金管理有限公司', '长江证券股份有限公司', '太平资产管理有限公司', '安徽省安庆市曙光化工股份有限公司', '15600000', '江苏瑞华投资控股集团有限公司', '高翔', '12', '38600000'}",1135427,6,"{'28600000', '16800000', '16000000', '4400000', '15600000', '38600000'}",11,"{'平安大华基金管理有限公司', '现金', '定价', '东海基金管理有限责任公司', '财通基金管理有限公司', '长江证券股份有限公司', '安徽省安庆市曙光化工股份有限公司', '江苏瑞华投资控股集团有限公司', '高翔', '12', '太平资产管理有限公司'}",12,"{'平安大华基金管理有限公司', '现金', '定价', '15000000', '东海基金管理有限责任公司', '财通基金管理有限公司', '长江证券股份有限公司', '安徽省安庆市曙光化工股份有限公司', '江苏瑞华投资控股集团有限公司', '高翔', '12', '太平资产管理有限公司'}"
14,"{'招商财富资产管理有限公司', '847000000', '现金', '18000000', '博时基金管理有限公司', '融通基金管理有限公司', '东海基金管理有限责任公司', '77000000', '招商基金管理有限公司', '198000000', '76399994', '6945454', '永赢基金管理有限公司', '12'}",353501,0,set(),8,"{'招商财富资产管理有限公司', '现金', '博时基金管理有限公司', '融通基金管理有限公司', '东海基金管理有限责任公司', '招商基金管理有限公司', '永赢基金管理有限公司', '12'}",14,"{'招商财富资产管理有限公司', '847000000', '现金', '博时基金管理有限公司', '18000000', '融通基金管理有限公司', '东海基金管理有限责任公司', '77000000', '招商基金管理有限公司', '198000000', '76399994', '6945454', '永赢基金管理有限公司', '12'}"
6,"{'现金', '竞价', '晋正企业股份有限公司', '晋正投资有限公司', '200000000', '36'}",1167984,1,{'200000000'},5,"{'现金', '竞价', '晋正企业股份有限公司', '晋正投资有限公司', '36'}",5,"{'现金', '竞价', '晋正企业股份有限公司', '晋正投资有限公司', '36'}"
5,"{'现金', '曹国路', '竞价', '盈峰控股', '36'}",1157061,1,{'竞价'},4,"{'36', '现金', '盈峰控股', '曹国路'}",4,"{'36', '现金', '盈峰控股', '曹国路'}"
18,"{'太平洋资产管理有限责任公司', '142168674', '12048192', '上海建工(集团)总公司', '浦银安盛基金管理有限公司', '12', '183132530', '144578315', '定价', '115662650', '国联安基金管理有限公司', '91566265', '圆信永丰基金管理有限公司', '财通基金管理有限公司', '汇添富基金管理有限公司', '36', '上海城投控股股份有限公司', '太平资产管理有限公司'}",318103,0,set(),3,"{'36', '定价', '12'}",18,"{'太平洋资产管理有限责任公司', '142168674', '上海建工(集团)总公司', '浦银安盛基金管理有限公司', '12', '183132530', '144578315', '115662650', '国联安基金管理有限公司', '圆信永丰基金管理有限公司', '91566265', '财通基金管理有限公司', '12048192', '定价', '汇添富基金管理有限公司', '36', '上海城投控股股份有限公司', '太平资产管理有限公司'}"
9,"{'399999996.6', '现金', '599999994.9', '乐山市国资公司', '渤海基金', '中环集团', '79470198', '52980132', '36'}",344381,2,"{'79470198', '52980132'}",5,"{'现金', '渤海基金', '乐山市国资公司', '中环集团', '36'}",7,"{'399999996.6', '现金', '599999994.9', '乐山市国资公司', '渤海基金', '中环集团', '36'}"
9,"{'现金', '科道基金', '13850000', '定价', '49998500', '110800000', '399988000', '36', '光耀集团'}",1268262,4,"{'399988000', '49998500', '110800000', '13850000'}",5,"{'现金', '科道基金', '定价', '36', '光耀集团'}",5,"{'现金', '科道基金', '定价', '36', '光耀集团'}"
4,"{'福建漳龙', '竞价', '现金', '36'}",1017458,0,set(),4,"{'福建漳龙', '竞价', '现金', '36'}",4,"{'福建漳龙', '竞价', '现金', '36'}"
4,"{'现金', '竞价', '昆钢控股', '36'}",158996,0,set(),4,"{'36', '竞价', '昆钢控股', '现金'}",4,"{'现金', '竞价', '昆钢控股', '36'}"
12,"{'平安大华基金管理有限公司', '现金', '郭旭', '100000000', '建投投资有限责任公司', '唐灼林', '西藏自治区投资有限公司', '15290519', '盛稷(上海)投资管理有限公司', '7645259', '200000000', '36'}",298788,2,"{'100000000', '200000000'}",7,"{'平安大华基金管理有限公司', '郭旭', '现金', '建投投资有限责任公司', '唐灼林', '西藏自治区投资有限公司', '36'}",10,"{'平安大华基金管理有限公司', '现金', '郭旭', '建投投资有限责任公司', '唐灼林', '西藏自治区投资有限公司', '15290519', '盛稷(上海)投资管理有限公司', '7645259', '36'}"
19,"{'87999995.04', '现金', '14184397', '山西吉昌投资有限公司', '7446808', '83999994.24', '华泰资产管理有限公司', '财通基金管理有限公司', '竞价', '79999993.44', '7092198', '富国基金管理有限公司', '21276595', '239999991.6', '159999998.2', '7801418', '厦门半导体投资集团有限公司', '12', '汇安基金管理有限责任公司'}",19163639,2,"{'159999998.2', '竞价'}",8,"{'现金', '山西吉昌投资有限公司', '财通基金管理有限公司', '华泰资产管理有限公司', '富国基金管理有限公司', '厦门半导体投资集团有限公司', '12', '汇安基金管理有限责任公司'}",17,"{'87999995.04', '山西吉昌投资有限公司', '14184397', '现金', '7446808', '83999994.24', '华泰资产管理有限公司', '财通基金管理有限公司', '21276595', '79999993.44', '7092198', '富国基金管理有限公司', '239999991.6', '厦门半导体投资集团有限公司', '7801418', '12', '汇安基金管理有限责任公司'}"
4,"{'金世旗控股', '现金', '竞价', '36'}",2333167,0,set(),4,"{'金世旗控股', '现金', '竞价', '36'}",4,"{'金世旗控股', '现金', '竞价', '36'}"
10,"{'5661766', '现金', '陈显龙', '罗新伟', '4403706', '竞价', '8523831', '江春华', '方文', '36'}",14320475,4,"{'竞价', '8523831', '5661766', '4403706'}",6,"{'现金', '陈显龙', '罗新伟', '江春华', '方文', '36'}",6,"{'现金', '陈显龙', '罗新伟', '江春华', '方文', '36'}"
17,"{'定向资管计划(暨员工持股计划)', '100000000', '1253879', '定价', '42819967.85', '7620497', '260240000', '2928257', '14641288', '国华人寿', '广晟公司', '500000000', '珺容战略资源1号基金', '452000000', '36', '刘益谦', '13235724'}",15346608,0,set(),5,"{'定价', '国华人寿', '广晟公司', '36', '刘益谦'}",17,"{'定向资管计划(暨员工持股计划)', '100000000', '1253879', '定价', '42819967.85', '7620497', '260240000', '2928257', '14641288', '国华人寿', '广晟公司', '500000000', '珺容战略资源1号基金', '452000000', '36', '刘益谦', '13235724'}"
24,"{'89999992.55', '贾伟平', '179999998.1', '现金', '中广核财务有限责任公司', '财通基金管理有限公司', '6917755', '7686395', '竞价', '吴立', '104999989.1', '99999998.95', '中信证券股份有限公司', '96999997.03', '7455803', '九泰基金管理有限公司', '大成基金管理有限公司', '银华基金管理股份有限公司', '2618666', '8070714', '34068844.66', '13835511', '银河金汇证券资产管理有限公司', '12'}",16428926,1,{'竞价'},11,"{'现金', '九泰基金管理有限公司', '大成基金管理有限公司', '银华基金管理股份有限公司', '中广核财务有限责任公司', '财通基金管理有限公司', '中信证券股份有限公司', '贾伟平', '吴立', '银河金汇证券资产管理有限公司', '12'}",23,"{'89999992.55', '贾伟平', '179999998.1', '现金', '中广核财务有限责任公司', '财通基金管理有限公司', '6917755', '7686395', '吴立', '104999989.1', '99999998.95', '中信证券股份有限公司', '96999997.03', '7455803', '九泰基金管理有限公司', '大成基金管理有限公司', '银华基金管理股份有限公司', '2618666', '8070714', '34068844.66', '13835511', '银河金汇证券资产管理有限公司', '12'}"
4,"{'竞价', '现金', '36', '天方集团'}",1329660,0,set(),4,"{'竞价', '现金', '36', '天方集团'}",4,"{'竞价', '现金', '36', '天方集团'}"
9,"{'20000000', '现金', '广西银河天成实业有限公司', '定价', '上海瀚叶财富管理顾问有限公司', '银河天成集团有限公司', '81639300', '200000000', '36'}",1774472,3,"{'20000000', '200000000', '81639300'}",6,"{'现金', '广西银河天成实业有限公司', '定价', '上海瀚叶财富管理顾问有限公司', '银河天成集团有限公司', '36'}",6,"{'现金', '广西银河天成实业有限公司', '定价', '上海瀚叶财富管理顾问有限公司', '银河天成集团有限公司', '36'}"
5,"{'现金', '保利集团', '竞价', '1500000000', '36'}",1565504,1,{'1500000000'},4,"{'36', '竞价', '现金', '保利集团'}",4,"{'36', '竞价', '现金', '保利集团'}"
24,"{'50000000', '南方资本-当代东方定向增发专项资产管理计划', '9259259', '550000000', '现金', '13888889', '134259259', '吕桧瑛', '150000000', '5555556', '长航联合', '当代文化', '60000000', '1450000000', '先锋亚太', '厦门旭熙', '胡惠康', '厦门华鑫丰', '100000000', '7407407', '50925926', '4629630', '80000000', '36'}",317576,11,"{'150000000', '80000000', '100000000', '60000000', '1450000000', '13888889', '50000000', '134259259', '50925926', '9259259', '550000000'}",9,"{'胡惠康', '现金', '长航联合', '厦门华鑫丰', '当代文化', '吕桧瑛', '先锋亚太', '36', '厦门旭熙'}",13,"{'胡惠康', '现金', '5555556', '长航联合', '厦门华鑫丰', '7407407', '当代文化', '吕桧瑛', '南方资本-当代东方定向增发专项资产管理计划', '4629630', '先锋亚太', '36', '厦门旭熙'}"
4,"{'36', '竞价', '现金', '福建省投资开发集团有限责任公司'}",5009356,0,set(),4,"{'36', '竞价', '现金', '福建省投资开发集团有限责任公司'}",4,"{'36', '竞价', '现金', '福建省投资开发集团有限责任公司'}"
15,"{'8422579', '现金', '长城资本管理有限公司', '10107095', '正海集团有限公司', '11791610', '中国长城资产管理股份有限公司', '上海汽车集团股权投资有限公司-上汽投资-颀瑞1号', '150999999.3', '125833330.3', '10107096', '176166653.4', '151000014.2', '36', '山东省国有资产投资控股有限公司'}",15789434,1,{'125833330.3'},6,"{'36', '长城资本管理有限公司', '现金', '正海集团有限公司', '中国长城资产管理股份有限公司', '山东省国有资产投资控股有限公司'}",14,"{'8422579', '现金', '长城资本管理有限公司', '10107095', '正海集团有限公司', '11791610', '中国长城资产管理股份有限公司', '上海汽车集团股权投资有限公司-上汽投资-颀瑞1号', '150999999.3', '10107096', '176166653.4', '151000014.2', '36', '山东省国有资产投资控股有限公司'}"
4,"{'现金', '竞价', '黄伟兴', '36'}",1180783,1,{'竞价'},3,"{'现金', '黄伟兴', '36'}",3,"{'现金', '黄伟兴', '36'}"
25,"{'200000085.4', '18612521', '16920481', '16920473', '现金', '兴业全球基金管理有限公司', '财通基金管理有限公司', '天安财产保险股份有限公司', '竞价', '203043', '鹏华资产管理(深圳)有限公司', '平安养老保险股份有限公司', '219999998.2', '199999990.9', '安徽安元投资基金有限公司', '2399968.26', '289999988.5', '招商财富资产管理有限公司', '287599996.6', '兴证证券资产管理有限公司', '圆信永丰基金管理有限公司', '24534686', '浙江浙旅投资有限责任公司', '24331641', '12'}",14590073,3,"{'竞价', '2399968.26', '199999990.9'}",3,"{'现金', '平安养老保险股份有限公司', '12'}",22,"{'200000085.4', '18612521', '16920481', '现金', '16920473', '兴业全球基金管理有限公司', '财通基金管理有限公司', '天安财产保险股份有限公司', '203043', '鹏华资产管理(深圳)有限公司', '平安养老保险股份有限公司', '219999998.2', '安徽安元投资基金有限公司', '289999988.5', '招商财富资产管理有限公司', '287599996.6', '兴证证券资产管理有限公司', '圆信永丰基金管理有限公司', '24534686', '浙江浙旅投资有限责任公司', '24331641', '12'}"
4,"{'中建新疆建工(集团)有限公司', '竞价', '现金', '36'}",1659982,1,{'竞价'},3,"{'中建新疆建工(集团)有限公司', '现金', '36'}",3,"{'中建新疆建工(集团)有限公司', '现金', '36'}"
15,"{'陈小荣', '8000000', '北京国际信托有限公司', '山西证券股份有限公司', '百年化妆护理品有限公司', '定价', '7000000', '上海华中实业(集团)有限公司', '9000000', '上海天臻实业有限公司', '10000000', '6000000', '西安国际信托有限公司', '上海证券有限责任公司', '12'}",1214769,5,"{'山西证券股份有限公司', '7000000', '10000000', '6000000', '9000000'}",2,"{'定价', '12'}",10,"{'陈小荣', '8000000', '北京国际信托有限公司', '百年化妆护理品有限公司', '定价', '上海华中实业(集团)有限公司', '上海天臻实业有限公司', '西安国际信托有限公司', '上海证券有限责任公司', '12'}"
15,"{'现金', '1529825', '675360', '12208003.5', '9911207.88', '华泰硅宝1号定向资产管理计划', '1242006', '1054760', '竞价', '杨丽玫', '8416984.8', '郭弟民', '5389372.8', '王有治', '36'}",12027938,1,{'竞价'},5,"{'现金', '杨丽玫', '郭弟民', '王有治', '36'}",14,"{'现金', '1529825', '675360', '12208003.5', '9911207.88', '华泰硅宝1号定向资产管理计划', '1242006', '1054760', '杨丽玫', '8416984.8', '郭弟民', '5389372.8', '王有治', '36'}"
16,"{'90225563', '现金', '120300751', '66727728', '12', '959999990.3', '249999993.6', '竞价', '709983025.9', '浙江浙旅投资有限责任公司', '浙江浙盐控股有限公司', '袁志敏', '巨化集团公司', '23496240', '36', '1279999991'}",14762087,1,{'1279999991'},8,"{'现金', '12', '竞价', '浙江浙旅投资有限责任公司', '浙江浙盐控股有限公司', '袁志敏', '巨化集团公司', '36'}",15,"{'36', '90225563', '现金', '120300751', '66727728', '959999990.3', '249999993.6', '竞价', '709983025.9', '浙江浙旅投资有限责任公司', '浙江浙盐控股有限公司', '袁志敏', '巨化集团公司', '23496240', '12'}"
6,"{'国家电力公司南京电力自动化设备总厂', '现金', '60018750', '384120000', '定价', '36'}",18768987,1,{'384120000'},4,"{'定价', '国家电力公司南京电力自动化设备总厂', '现金', '36'}",5,"{'国家电力公司南京电力自动化设备总厂', '现金', '60018750', '定价', '36'}"
9,"{'51311069', '现金', '兴宁市金顺安投资有限公司', '定价', '46278987', '深圳市金信安投资有限公司', '27488086', '兴宁市众益福投资有限公司', '36'}",15480569,0,set(),6,"{'现金', '兴宁市金顺安投资有限公司', '定价', '深圳市金信安投资有限公司', '兴宁市众益福投资有限公司', '36'}",9,"{'51311069', '现金', '兴宁市金顺安投资有限公司', '定价', '46278987', '深圳市金信安投资有限公司', '27488086', '兴宁市众益福投资有限公司', '36'}"
4,"{'42530278', '定价', '36', '江苏双良科技有限公司'}",1385989,2,"{'42530278', '定价'}",2,"{'36', '江苏双良科技有限公司'}",2,"{'36', '江苏双良科技有限公司'}"
18,"{'中国青旅集团公司', '山东省文化产业投资有限公司', '现金', '14081184', '民生加银基金管理有限公司', '6600000', '黑龙江业丰生物技术有限公司', '华夏资本管理有限公司', '12', '8700000', '定价', '华安基金管理有限公司', '天弘基金管理有限公司', '7800000', '6828816', '泰达宏利基金管理有限公司', '10000000', '36'}",68060,3,"{'10000000', '6828816', '6600000'}",5,"{'中国青旅集团公司', '现金', '12', '定价', '36'}",15,"{'中国青旅集团公司', '山东省文化产业投资有限公司', '14081184', '民生加银基金管理有限公司', '华夏资本管理有限公司', '黑龙江业丰生物技术有限公司', '8700000', '华安基金管理有限公司', '12', '现金', '定价', '天弘基金管理有限公司', '7800000', '泰达宏利基金管理有限公司', '36'}"
4,"{'精工控股集团有限公司的全资子公司精工控股集团(浙江)投资有限公司', '定价', '现金', '36'}",15676531,1,{'精工控股集团有限公司的全资子公司精工控股集团(浙江)投资有限公司'},3,"{'36', '定价', '现金'}",3,"{'定价', '现金', '36'}"
24,"{'20000000', '13500000', '兵器财务有限责任公司', '航天科工财务有限责任公司', '16000000', '199988000', '136000000', '86496000', '91800000', '现金', '108800000', '竞价', '浙江庆盛控股集团有限公司', '86360000', '深圳市平安创新资本投资有限公司', '10943058', '74412794.4', '29410000', '12700000', '新疆中油化工集团有限公司', '绍兴县宏鹏股权投资合伙企业(普通合伙)', '绍兴金顺投资有限公司', '西藏林芝正源策略投资有限公司', '12'}",555876,10,"{'10943058', '199988000', '74412794.4', '136000000', '86496000', '91800000', '108800000', '竞价', '12700000', '86360000'}",9,"{'兵器财务有限责任公司', '现金', '航天科工财务有限责任公司', '新疆中油化工集团有限公司', '绍兴金顺投资有限公司', '西藏林芝正源策略投资有限公司', '浙江庆盛控股集团有限公司', '深圳市平安创新资本投资有限公司', '12'}",14,"{'20000000', '13500000', '兵器财务有限责任公司', '现金', '航天科工财务有限责任公司', '新疆中油化工集团有限公司', '16000000', '绍兴县宏鹏股权投资合伙企业(普通合伙)', '29410000', '绍兴金顺投资有限公司', '西藏林芝正源策略投资有限公司', '浙江庆盛控股集团有限公司', '深圳市平安创新资本投资有限公司', '12'}"
18,"{'胡惠康', '厦门旭熙股权投资基金管理有限公司', '现金', '南方资本管理有限公司', '5555556', '厦门长航联合投资合伙企业(有限合伙)', '7407407', '87777777', '厦门华鑫丰广告有限公司', '13888889', '竞价', '吕桧瑛', '50925926', '4629630', '北京先锋亚太投资有限公司', '9259259', '36', '厦门当代文化发展股份有限公司'}",1665678,1,{'竞价'},8,"{'胡惠康', '厦门旭熙股权投资基金管理有限公司', '现金', '厦门华鑫丰广告有限公司', '北京先锋亚太投资有限公司', '吕桧瑛', '36', '厦门当代文化发展股份有限公司'}",17,"{'胡惠康', '厦门旭熙股权投资基金管理有限公司', '南方资本管理有限公司', '现金', '5555556', '厦门长航联合投资合伙企业(有限合伙)', '7407407', '87777777', '厦门华鑫丰广告有限公司', '13888889', '吕桧瑛', '50925926', '4629630', '北京先锋亚太投资有限公司', '9259259', '36', '厦门当代文化发展股份有限公司'}"
5,"{'现金', '400000000', '中国华能集团公司', '竞价', '36'}",1153872,2,"{'竞价', '400000000'}",3,"{'现金', '36', '中国华能集团公司'}",3,"{'现金', '36', '中国华能集团公司'}"
13,"{'现金', '大成基金管理有限公司', '4000000', '定价', '浙江银河股份有限公司', '成都国光电气股份有限公司', '成都仁道投资有限公司', '7900000', '佛山市金海集团有限公司', '8000000', '中海基金管理有限公司', '12', '19000000'}",820995,0,set(),8,"{'现金', '大成基金管理有限公司', '定价', '浙江银河股份有限公司', '成都国光电气股份有限公司', '佛山市金海集团有限公司', '中海基金管理有限公司', '12'}",13,"{'现金', '大成基金管理有限公司', '4000000', '定价', '浙江银河股份有限公司', '成都国光电气股份有限公司', '成都仁道投资有限公司', '7900000', '佛山市金海集团有限公司', '8000000', '中海基金管理有限公司', '12', '19000000'}"
21,"{'180505415', '499999999.6', '287189263', '324909747', '200000000', '72202166', '现金', '中铁建投资', '定价', '北方工业', '上海彤关', '180000000', '99999999.91', '900000000', '员工持股计划', '64981949', '有色控股', '36101083', '国华人寿', '795514258.5', '36'}",15645251,2,"{'99999999.91', '499999999.6'}",9,"{'现金', '中铁建投资', '有色控股', '定价', '员工持股计划', '北方工业', '上海彤关', '国华人寿', '36'}",19,"{'324909747', '72202166', '现金', '900000000', '中铁建投资', '定价', '有色控股', '180505415', '员工持股计划', '200000000', '北方工业', '36101083', '287189263', '上海彤关', '180000000', '795514258.5', '64981949', '36', '国华人寿'}"
4,"{'竞价', '现金', '中粮集团', '36'}",155465,0,set(),4,"{'竞价', '现金', '中粮集团', '36'}",4,"{'竞价', '现金', '中粮集团', '36'}"
7,"{'南京瑞森投资管理合伙企业(有限合伙)', '郑伟光', '西藏莱美医药投资有限公司', '13418160', '4626951', '5783689', '36'}",1863464,0,set(),3,"{'西藏莱美医药投资有限公司', '36', '郑伟光'}",7,"{'南京瑞森投资管理合伙企业(有限合伙)', '郑伟光', '西藏莱美医药投资有限公司', '13418160', '4626951', '5783689', '36'}"
4,"{'现金', '竞价', '东莞晨星', '12'}",444778,0,set(),4,"{'现金', '竞价', '东莞晨星', '12'}",4,"{'现金', '竞价', '东莞晨星', '12'}"
14,"{'北信瑞丰基金管理有限公司', '71428571', '399999997.6', '721720008.8', '113851785', '建信基金管理有限责任公司', '128878573', '637569996', '竞价', '387807142', '西部利得基金管理有限公司', '2171719995', '12', '红塔红土基金管理有限公司'}",14944441,0,set(),6,"{'北信瑞丰基金管理有限公司', '竞价', '西部利得基金管理有限公司', '建信基金管理有限责任公司', '12', '红塔红土基金管理有限公司'}",14,"{'北信瑞丰基金管理有限公司', '71428571', '399999997.6', '721720008.8', '113851785', '建信基金管理有限责任公司', '128878573', '637569996', '竞价', '387807142', '西部利得基金管理有限公司', '2171719995', '12', '红塔红土基金管理有限公司'}"
21,"{'7454000', '湖北新海天投资有限公司', '9690000', '200000000', '长沙琛远财务咨询有限公司', '现金', '581400000', '36', '90000000', '中国纸业投资有限公司', '中信证券岳阳林纸员工持股计划1期定向资产管理计划', '刘建国', '1500000', '25000000', '48152840', '国联证券股份有限公司', '36305200', '山东省国有资产投资控股有限公司', '1292000000', '5620000', '161500000'}",16193778,0,set(),8,"{'现金', '中国纸业投资有限公司', '刘建国', '湖北新海天投资有限公司', '长沙琛远财务咨询有限公司', '山东省国有资产投资控股有限公司', '36', '国联证券股份有限公司'}",21,"{'7454000', '湖北新海天投资有限公司', '9690000', '200000000', '长沙琛远财务咨询有限公司', '现金', '581400000', '36', '90000000', '中国纸业投资有限公司', '中信证券岳阳林纸员工持股计划1期定向资产管理计划', '刘建国', '1500000', '25000000', '48152840', '国联证券股份有限公司', '36305200', '山东省国有资产投资控股有限公司', '1292000000', '5620000', '161500000'}"
13,"{'国泓资产管理有限公司', '现金', '3233830', '上银瑞金资本管理有限公司', '7393037', '定价', '5820895', '财通基金管理有限公司', '7462686', '6069651', '泰达宏利基金管理有限公司', '安徽国贸联创投资有限公司', '12'}",1679175,0,set(),8,"{'国泓资产管理有限公司', '现金', '上银瑞金资本管理有限公司', '定价', '财通基金管理有限公司', '泰达宏利基金管理有限公司', '安徽国贸联创投资有限公司', '12'}",13,"{'国泓资产管理有限公司', '3233830', '现金', '上银瑞金资本管理有限公司', '7393037', '5820895', '定价', '财通基金管理有限公司', '7462686', '6069651', '泰达宏利基金管理有限公司', '安徽国贸联创投资有限公司', '12'}"
9,"{'现金', '先锋创业', '16000000', '新余爱乐', '4500000', '竞价', '20850000', '唐进波', '36'}",1766048,1,{'竞价'},5,"{'现金', '先锋创业', '新余爱乐', '唐进波', '36'}",8,"{'现金', '先锋创业', '16000000', '新余爱乐', '4500000', '20850000', '唐进波', '36'}"
4,"{'竞价', '现金', '正邦集团', '36'}",1208208,1,{'竞价'},3,"{'现金', '正邦集团', '36'}",3,"{'现金', '正邦集团', '36'}"
16,"{'9210526', '青岛海尔创业投资有限责任公司', '现金', '10240274', '林清', '建信基金管理有限责任公司', '7494279', '17105263', '10074876', '青岛国信资本投资有限公司', '前海开源基金管理有限公司', '11441647', '泰达宏利基金管理有限公司', '9153318', '广东省铁路发展基金有限责任公司', '12'}",15813203,0,set(),9,"{'青岛海尔创业投资有限责任公司', '现金', '林清', '青岛国信资本投资有限公司', '前海开源基金管理有限公司', '泰达宏利基金管理有限公司', '建信基金管理有限责任公司', '广东省铁路发展基金有限责任公司', '12'}",16,"{'9210526', '青岛海尔创业投资有限责任公司', '现金', '10240274', '林清', '建信基金管理有限责任公司', '7494279', '17105263', '10074876', '青岛国信资本投资有限公司', '前海开源基金管理有限公司', '11441647', '泰达宏利基金管理有限公司', '9153318', '广东省铁路发展基金有限责任公司', '12'}"
12,"{'金鹰基金管理有限公司', '8717948', '现金', '鹏华资产管理有限公司', '0', '399999990', '2820513', '10256410', '皓熙股权投资管理(上海)有限公司', '339999972', '竞价', '110000007'}",15557002,2,"{'竞价', '0'}",3,"{'金鹰基金管理有限公司', '现金', '鹏华资产管理有限公司'}",10,"{'金鹰基金管理有限公司', '8717948', '现金', '鹏华资产管理有限公司', '399999990', '2820513', '10256410', '皓熙股权投资管理(上海)有限公司', '339999972', '110000007'}"
8,"{'51311069', '现金', '兴宁市金顺安投资有限公司', '46278987', '深圳市金信安投资有限公司', '27488086', '兴宁市众益福投资有限公司', '36'}",15480617,0,set(),5,"{'现金', '兴宁市金顺安投资有限公司', '深圳市金信安投资有限公司', '兴宁市众益福投资有限公司', '36'}",8,"{'51311069', '现金', '兴宁市金顺安投资有限公司', '46278987', '深圳市金信安投资有限公司', '27488086', '兴宁市众益福投资有限公司', '36'}"
18,"{'正奇投资', '现金', '16000000', '扬州尚颀', '3550000', '5847953', '36423000', '3450000', '60000000', '竞价', '4152047', '35397000', '164160000', '42600000', '万家基金—恒赢定增5号资产管理计划', '上汽投资', '万家基金—恒赢定增6号资产管理计划', '36'}",1602987,1,{'竞价'},5,"{'正奇投资', '现金', '扬州尚颀', '上汽投资', '36'}",17,"{'正奇投资', '现金', '16000000', '扬州尚颀', '3550000', '5847953', '36423000', '3450000', '60000000', '4152047', '35397000', '164160000', '42600000', '万家基金—恒赢定增5号资产管理计划', '上汽投资', '万家基金—恒赢定增6号资产管理计划', '36'}"
5,"{'现金', '60000000', '竞价', '滨州国资公司', '36'}",15920314,1,{'60000000'},4,"{'竞价', '现金', '滨州国资公司', '36'}",4,"{'竞价', '现金', '滨州国资公司', '36'}"
15,"{'孟圣喜', '张建国', '5000000', '现金', '浙江浙商产业投资基金合伙企业(有限合伙)', '12', '上海金力方长汇股权投资合伙企业(有限合伙)', '5500000', '4765900', '竞价', '浙江奥鑫控股集团有限公司', '深圳市中信联合创业投资有限公司', '3336866', '三花控股集团有限公司', '36'}",1317270,1,{'3336866'},9,"{'孟圣喜', '张建国', '现金', '12', '浙江奥鑫控股集团有限公司', '深圳市中信联合创业投资有限公司', '竞价', '三花控股集团有限公司', '36'}",14,"{'孟圣喜', '张建国', '5000000', '现金', '浙江浙商产业投资基金合伙企业(有限合伙)', '12', '上海金力方长汇股权投资合伙企业(有限合伙)', '5500000', '4765900', '浙江奥鑫控股集团有限公司', '深圳市中信联合创业投资有限公司', '竞价', '三花控股集团有限公司', '36'}"
20,"{'广发证券资产管理(广东)有限公司', '招商财富资产管理有限公司', '现金', '179999995', '350000000', '定价', '西南证券股份有限公司', '24285714', '东海基金管理有限责任公司', '210899997', '财通基金管理有限公司', '64157144', '25714285', '50000000', '30128571', '泰达宏利基金管理有限公司', '449100008', '汇添富基金管理股份有限公司', '12', '169999998'}",1562783,0,set(),9,"{'招商财富资产管理有限公司', '现金', '12', '定价', '东海基金管理有限责任公司', '财通基金管理有限公司', '泰达宏利基金管理有限公司', '汇添富基金管理股份有限公司', '西南证券股份有限公司'}",20,"{'广发证券资产管理(广东)有限公司', '招商财富资产管理有限公司', '现金', '179999995', '350000000', '定价', '西南证券股份有限公司', '24285714', '东海基金管理有限责任公司', '210899997', '财通基金管理有限公司', '64157144', '25714285', '50000000', '30128571', '泰达宏利基金管理有限公司', '449100008', '汇添富基金管理股份有限公司', '12', '169999998'}"
8,"{'现金', '国网资产管理有限公司', '653306499', '首钢总公司', '514686722', 'DEUTSCHE BANK LUXEMBOURG S.A.', '36', '691204239'}",492808,3,"{'514686722', '653306499', '691204239'}",5,"{'国网资产管理有限公司', '现金', 'DEUTSCHE BANK LUXEMBOURG S.A.', '36', '首钢总公司'}",5,"{'现金', '国网资产管理有限公司', 'DEUTSCHE BANK LUXEMBOURG S.A.', '36', '首钢总公司'}"
9,"{'30216749', '浙江宋都控股有限公司', '271950738', '定价', '深圳市平安置业投资有限公司', '12', '郭轶娟', '75541872', '36'}",1448773,0,set(),6,"{'36', '浙江宋都控股有限公司', '定价', '深圳市平安置业投资有限公司', '郭轶娟', '12'}",9,"{'30216749', '浙江宋都控股有限公司', '271950738', '12', '深圳市平安置业投资有限公司', '定价', '郭轶娟', '75541872', '36'}"
15,"{'150000000', '现金', '44722719', '福建漳龙集团有限公司', '400000000', '71556351', '定价', '200000000', '北京碧水源科技股份有限公司', '上海康融股权投资基金合伙企业(有限合伙)', '250000000', '35778175', '26833631', '珠海东方卧龙投资管理中心(有限合伙)', '36'}",1764649,10,"{'150000000', '珠海东方卧龙投资管理中心(有限合伙)', '44722719', '400000000', '71556351', '上海康融股权投资基金合伙企业(有限合伙)', '250000000', '35778175', '26833631', '200000000'}",5,"{'现金', '福建漳龙集团有限公司', '定价', '北京碧水源科技股份有限公司', '36'}",5,"{'现金', '福建漳龙集团有限公司', '定价', '北京碧水源科技股份有限公司', '36'}"
28,"{'32222037', '800000000', '29871960', '南京紫金投资集团有限责任公司', '30119602', '2500000000', '601920000', '47429081', '现金', '财通基金管理有限公司', '竞价', '955696000', '36', '124069478', '上银基金管理有限公司', '招商财富资产管理有限公司', '606910000', '兴证证券资产管理有限公司', '44000000', '886600000', '49607940', '江苏国泰国际集团有限公司', '法国巴黎银行', '649274000', '东方基金管理有限责任公司', '39702234', '12', '999600000'}",1675290,8,"{'601920000', '800000000', '606910000', '886600000', '649274000', '2500000000', '955696000', '999600000'}",12,"{'招商财富资产管理有限公司', '36', '现金', '兴证证券资产管理有限公司', '江苏国泰国际集团有限公司', '法国巴黎银行', '财通基金管理有限公司', '东方基金管理有限责任公司', '南京紫金投资集团有限责任公司', '竞价', '12', '上银基金管理有限公司'}",20,"{'招商财富资产管理有限公司', '30119602', '124069478', '47429081', '32222037', '兴证证券资产管理有限公司', '现金', '44000000', '12', '49607940', '江苏国泰国际集团有限公司', '法国巴黎银行', '29871960', '东方基金管理有限责任公司', '财通基金管理有限公司', '南京紫金投资集团有限责任公司', '竞价', '39702234', '36', '上银基金管理有限公司'}"
4,"{'现金', '浙报传媒控股集团有限公司', '200000000', '36'}",2034566,0,set(),3,"{'36', '浙报传媒控股集团有限公司', '现金'}",4,"{'现金', '浙报传媒控股集团有限公司', '200000000', '36'}"
25,"{'君证(上海)股权投资基金合伙企业(有限合伙)', '421994143', '673394875.3', '448929920.8', '上海上投资产经营有限公司', '525248004.4', '现金', '51468033', '598573223.8', '45163199', '定价', '85984522', '股权、现金', '57901537', '北京中融鼎新投资管理有限公司', '中国长城资产管理公司', '36284965', '中信证券股份有限公司', '38601025', '20120378', '上银基金管理有限公司', '999999990.9', '233999996.1', '曹文龙', '36'}",1878414,6,"{'421994143', '股权、现金', '598573223.8', '999999990.9', '448929920.8', '525248004.4'}",9,"{'现金', '定价', '北京中融鼎新投资管理有限公司', '中国长城资产管理公司', '中信证券股份有限公司', '上海上投资产经营有限公司', '曹文龙', '36', '上银基金管理有限公司'}",19,"{'君证(上海)股权投资基金合伙企业(有限合伙)', '20120378', '现金', '51468033', '45163199', '57901537', '定价', '673394875.3', '85984522', '中国长城资产管理公司', '中信证券股份有限公司', '上海上投资产经营有限公司', '北京中融鼎新投资管理有限公司', '36284965', '233999996.1', '曹文龙', '36', '上银基金管理有限公司', '38601025'}"
24,"{'35000000', '10250000', '143090000', '42900000', '488600000', '现金', '36000000', '定价', '鹏华基金管理有限公司', '华宝投资有限公司', '1675200000', '502560000', '598884000', '博时基金管理有限公司', '雅戈尔投资有限公司', '15800000', '120000000', '刘益谦', '220568000', '1116800000', '中国人寿资产管理有限公司', '泰康资产管理有限责任公司', '80000000', '12'}",1246664,13,"{'488600000', '36000000', '502560000', '598884000', '定价', '220568000', '1116800000', '15800000', '10250000', '143090000', '120000000', '1675200000', '80000000'}",2,"{'现金', '12'}",11,"{'42900000', '现金', '35000000', '博时基金管理有限公司', '雅戈尔投资有限公司', '鹏华基金管理有限公司', '中国人寿资产管理有限公司', '泰康资产管理有限责任公司', '华宝投资有限公司', '12', '刘益谦'}"
4,"{'竞价', '现金', '36', '青岛海湾集团有限公司'}",785048,1,{'竞价'},3,"{'现金', '36', '青岛海湾集团有限公司'}",3,"{'现金', '36', '青岛海湾集团有限公司'}"
22,"{'广州海印实业集团有限公司', '50100000', '12000000', '235470000', '7000000', '100200000', '6000000', '58450000', '11520000', '竞价', '东海证券股份有限公司', '平安大华基金管理有限公司', '36', '太平洋资产管理有限责任公司', '民生加银基金管理有限公司', '29160239', '深圳市吉富启瑞投资合伙企业', '96192000', '243487995.7', '融通基金管理有限公司', '28200000', '12'}",7880,2,"{'243487995.7', '竞价'}",3,"{'广州海印实业集团有限公司', '12', '36'}",20,"{'广州海印实业集团有限公司', '50100000', '太平洋资产管理有限责任公司', '12000000', '民生加银基金管理有限公司', '平安大华基金管理有限公司', '235470000', '12', '58450000', '融通基金管理有限公司', '100200000', '7000000', '11520000', '29160239', '东海证券股份有限公司', '28200000', '6000000', '深圳市吉富启瑞投资合伙企业', '96192000', '36'}"
19,"{'15561798', '49859999.19', '陆晖', '现金', '黄安定', '6224719', '290849996.6', '83100001.32', '124650002', '10374532', '黄志强', '竞价', '罗勤', '2074906', '36310861', '16619997.06', '黄生田', '36', '杨竞忠'}",352214,1,{'124650002'},9,"{'陆晖', '现金', '黄安定', '黄志强', '竞价', '罗勤', '黄生田', '36', '杨竞忠'}",18,"{'15561798', '49859999.19', '陆晖', '现金', '黄安定', '6224719', '290849996.6', '83100001.32', '10374532', '黄志强', '竞价', '罗勤', '2074906', '36310861', '16619997.06', '黄生田', '36', '杨竞忠'}"
10,"{'现金', '定价', '309597522', '1000000000', '阳煤金陵', '500000000', '金陵阳明', '36', '154798762', '金陵恒毅'}",14630207,2,"{'1000000000', '500000000'}",6,"{'现金', '定价', '阳煤金陵', '金陵阳明', '36', '金陵恒毅'}",8,"{'现金', '定价', '309597522', '阳煤金陵', '金陵阳明', '36', '154798762', '金陵恒毅'}"
15,"{'天津人保远望资产管理中心(有限合伙)', '现金', '99988800', '14070000', '启迪科技服务有限公司', '定价', '嘉实基金管理有限公司', '22520000', '49905600', '2810000', '399955200', '249883200', '36', '衡阳弘湘国有投资(控股)集团有限公司', '5630000'}",4929607,8,"{'99988800', '14070000', '22520000', '49905600', '2810000', '399955200', '249883200', '5630000'}",5,"{'现金', '启迪科技服务有限公司', '定价', '嘉实基金管理有限公司', '36'}",7,"{'天津人保远望资产管理中心(有限合伙)', '现金', '启迪科技服务有限公司', '定价', '嘉实基金管理有限公司', '36', '衡阳弘湘国有投资(控股)集团有限公司'}"
4,"{'集团公司', '竞价', '现金', '36'}",1228597,0,set(),4,"{'集团公司', '竞价', '现金', '36'}",4,"{'集团公司', '竞价', '现金', '36'}"
26,"{'华安基金管理有限公司', '74642857', '184179499', '418999996.8', '申万菱信基金管理有限公司', '31741001', '43775200', '7817000', '现金', '工银瑞信基金管理有限公司', '财通基金管理有限公司', '竞价', '中船投资发展有限公司', '国家电投集团吉林省能源交通总公司', '平安大华基金管理有限公司', '36', '74821428', '62500000', '西南证券股份有限公司', '中国电能成套设备有限公司', '第一创业证券股份有限公司', '417999999.2', '350000000', '177749605.6', '1031405194', '12'}",15604209,1,{'竞价'},4,"{'12', '现金', '36', '中国电能成套设备有限公司'}",25,"{'华安基金管理有限公司', '74642857', '184179499', '418999996.8', '申万菱信基金管理有限公司', '31741001', '43775200', '7817000', '现金', '工银瑞信基金管理有限公司', '财通基金管理有限公司', '中船投资发展有限公司', '国家电投集团吉林省能源交通总公司', '平安大华基金管理有限公司', '36', '74821428', '62500000', '西南证券股份有限公司', '中国电能成套设备有限公司', '第一创业证券股份有限公司', '417999999.2', '350000000', '177749605.6', '1031405194', '12'}"
20,"{'天津六禾碧云股权投资基金合伙企业(有限合伙)', '10228070', '兴业全球基金管理有限公司', '宁波青春投资有限公司', '定价', '博时基金管理有限公司', '24200000', '30000000', '易方达基金管理有限公司', '国泰基金管理有限公司', '48240000', '中国东方资产管理公司', '富国基金管理有限公司', '23920000', '中国人寿资产管理有限公司', '23700000', '24880000', '12', '24000000', '32060000'}",559101,4,"{'24200000', '24880000', '23920000', '32060000'}",10,"{'兴业全球基金管理有限公司', '宁波青春投资有限公司', '定价', '博时基金管理有限公司', '易方达基金管理有限公司', '国泰基金管理有限公司', '富国基金管理有限公司', '中国人寿资产管理有限公司', '12', '中国东方资产管理公司'}",16,"{'天津六禾碧云股权投资基金合伙企业(有限合伙)', '10228070', '兴业全球基金管理有限公司', '宁波青春投资有限公司', '博时基金管理有限公司', '定价', '易方达基金管理有限公司', '国泰基金管理有限公司', '48240000', '富国基金管理有限公司', '中国人寿资产管理有限公司', '23700000', '30000000', '12', '24000000', '中国东方资产管理公司'}"
17,"{'南京瑞森投资管理合伙企业(有限合伙)', '平安大华基金管理有限公司', '招商财富资产管理有限公司', '现金', '金鹰基金管理有限公司', '兴业全球基金管理有限公司', '12', '26000000', '21000000', '财通基金管理有限公司', '22000000', '竞价', '16824000', '太安堂集团', '广东中科招商创业投资管理有限责任公司', '36', '16536000'}",363248,3,"{'16824000', '兴业全球基金管理有限公司', '16536000'}",5,"{'36', '现金', '竞价', '太安堂集团', '12'}",14,"{'南京瑞森投资管理合伙企业(有限合伙)', '平安大华基金管理有限公司', '招商财富资产管理有限公司', '现金', '金鹰基金管理有限公司', '12', '26000000', '21000000', '财通基金管理有限公司', '22000000', '竞价', '太安堂集团', '广东中科招商创业投资管理有限责任公司', '36'}"
5,"{'现金', '定价', '1958480', '王冠一', '36'}",361275,0,set(),4,"{'定价', '王冠一', '现金', '36'}",5,"{'现金', '定价', '1958480', '王冠一', '36'}"
6,"{'现金', '览海投资', '竞价', '291970802', '1999999994', '36'}",2012210,2,"{'竞价', '1999999994'}",3,"{'览海投资', '现金', '36'}",4,"{'览海投资', '现金', '36', '291970802'}"
17,"{'66000000', '华安基金管理有限公司', '兴业全球基金管理有限公司', '21450000', '650000', '财通基金管理有限公司', '2000000', '900000', '99000000', '竞价', '3000000', '29700000', '621717', '20516661', '华商基金管理有限公司', '泰康资产管理有限公司', '12'}",279874,7,"{'66000000', '21450000', '650000', '竞价', '621717', '20516661', '29700000'}",6,"{'华安基金管理有限公司', '兴业全球基金管理有限公司', '财通基金管理有限公司', '华商基金管理有限公司', '泰康资产管理有限公司', '12'}",10,"{'华安基金管理有限公司', '兴业全球基金管理有限公司', '财通基金管理有限公司', '2000000', '900000', '99000000', '3000000', '华商基金管理有限公司', '泰康资产管理有限公司', '12'}"
5,"{'现金', '172000000', '厦门象屿集团有限公司', '竞价', '36'}",756768,2,"{'竞价', '172000000'}",3,"{'36', '现金', '厦门象屿集团有限公司'}",3,"{'36', '现金', '厦门象屿集团有限公司'}"
4,"{'化纤集团', '竞价', '现金', '36'}",1115417,0,set(),4,"{'化纤集团', '竞价', '现金', '36'}",4,"{'化纤集团', '竞价', '现金', '36'}"
8,"{'现金', '添富-定增35号', '3550000', '广州无线电集团', '26450000', '36', '45000000', '添富-定增36号'}",317559,0,set(),4,"{'现金', '36', '广州无线电集团', '添富-定增36号'}",8,"{'现金', '添富-定增35号', '3550000', '广州无线电集团', '26450000', '36', '45000000', '添富-定增36号'}"
19,"{'10244735', '珂澜投资', '现金', '33750711', '赫连剑茹', '淮茂投资', '10358565', '17074558', '28457598', '刚泰集团', '见乙实业', '腾讯计算机', '长信-刚泰-聚利1号资产管理计划', '六禾嘉睿', '45532157', '11383039', '南通元鼎', '13659647', '36'}",1575897,0,set(),10,"{'珂澜投资', '现金', '赫连剑茹', '淮茂投资', '刚泰集团', '见乙实业', '腾讯计算机', '六禾嘉睿', '南通元鼎', '36'}",19,"{'10244735', '珂澜投资', '现金', '33750711', '赫连剑茹', '淮茂投资', '10358565', '17074558', '28457598', '刚泰集团', '见乙实业', '腾讯计算机', '长信-刚泰-聚利1号资产管理计划', '六禾嘉睿', '45532157', '11383039', '南通元鼎', '13659647', '36'}"
22,"{'20571618', '现金', '鹏华资产管理有限公司', '11631771', '财通基金管理有限公司', '349999989.4', '竞价', '749999990.2', '399999970.7', '诺德基金管理有限公司', '699999978.8', '华宝(上海)股权投资基金管理有限公司', '民生加银基金管理有限公司', '11000335', '华融瑞通股权投资管理有限公司', '23263542', '13293452', '九泰基金管理有限公司', '24925224', '618999985.6', '331000080.2', '12'}",19304236,6,"{'349999989.4', '竞价', '749999990.2', '399999970.7', '331000080.2', '699999978.8'}",2,"{'现金', '12'}",16,"{'13293452', '华宝(上海)股权投资基金管理有限公司', '民生加银基金管理有限公司', '鹏华资产管理有限公司', '九泰基金管理有限公司', '现金', '24925224', '20571618', '11631771', '财通基金管理有限公司', '618999985.6', '11000335', '华融瑞通股权投资管理有限公司', '诺德基金管理有限公司', '12', '23263542'}"
5,"{'现金', '102040816', '定价', '重工集团有限公司', '36'}",1104713,0,set(),4,"{'重工集团有限公司', '定价', '现金', '36'}",5,"{'现金', '102040816', '定价', '重工集团有限公司', '36'}"
15,"{'293001300', '49726700', '民生加银基金管理有限公司', '华安基金管理有限公司', '李龙萍', '定价', '449999928', '财通基金管理有限公司', '505999026', '545999166', '40983600', '46083700', '方正富邦基金管理有限公司', '26685000', '12'}",2303842,4,"{'293001300', '545999166', '449999928', '505999026'}",7,"{'民生加银基金管理有限公司', '华安基金管理有限公司', '李龙萍', '定价', '财通基金管理有限公司', '方正富邦基金管理有限公司', '12'}",11,"{'49726700', '民生加银基金管理有限公司', '华安基金管理有限公司', '李龙萍', '定价', '财通基金管理有限公司', '40983600', '46083700', '方正富邦基金管理有限公司', '26685000', '12'}"
22,"{'深圳天风天成资产管理有限公司', '红土创新基金管理有限公司', '深圳市创新投资集团有限公司', '15313090', '19874940.05', '329997089.5', '499999996.8', '23201856', '威海中泰齐东蓝色并购投资中心(有限合伙)', '250127983.9', '贵州铁路发展基金管理有限公司', '上海绿联君和产业并购股权投资基金合伙企业', '18561484', '399999980.2', '11600928', '金石期货有限公司', '中国华融资产管理股份有限公司', '11606867', '249999998.4', '922271', '华安未来资产管理(上海)有限公司', '12'}",15649898,1,{'250127983.9'},8,"{'金石期货有限公司', '深圳天风天成资产管理有限公司', '红土创新基金管理有限公司', '深圳市创新投资集团有限公司', '中国华融资产管理股份有限公司', '上海绿联君和产业并购股权投资基金合伙企业', '贵州铁路发展基金管理有限公司', '12'}",21,"{'深圳天风天成资产管理有限公司', '红土创新基金管理有限公司', '深圳市创新投资集团有限公司', '15313090', '19874940.05', '329997089.5', '499999996.8', '23201856', '威海中泰齐东蓝色并购投资中心(有限合伙)', '贵州铁路发展基金管理有限公司', '上海绿联君和产业并购股权投资基金合伙企业', '18561484', '399999980.2', '11600928', '金石期货有限公司', '中国华融资产管理股份有限公司', '11606867', '249999998.4', '922271', '华安未来资产管理(上海)有限公司', '12'}"
4,"{'曹永贵', '竞价', '现金', '36'}",14663471,0,set(),4,"{'曹永贵', '竞价', '现金', '36'}",4,"{'曹永贵', '竞价', '现金', '36'}"
15,"{'3802281', '浙江海宁嘉慧投资合伙企业(有限合伙)', '79999992.24', '59999994.18', '6337135', '49999987.26', '定价', '财通基金管理有限公司', '付艳杰', '崔万涛', '3168567', '5069708', '99999990.3', '荣科科技第1期员工持股计划', '36'}",1686043,0,set(),5,"{'定价', '财通基金管理有限公司', '付艳杰', '崔万涛', '36'}",15,"{'3802281', '浙江海宁嘉慧投资合伙企业(有限合伙)', '79999992.24', '59999994.18', '6337135', '49999987.26', '定价', '财通基金管理有限公司', '付艳杰', '崔万涛', '3168567', '5069708', '99999990.3', '荣科科技第1期员工持股计划', '36'}"
5,"{'现金', '冯滨', '竞价', '郭洪斌', '36'}",1642748,1,{'竞价'},4,"{'36', '现金', '冯滨', '郭洪斌'}",4,"{'郭洪斌', '现金', '36', '冯滨'}"
9,"{'150000000', '现金', '71428571', '550000000', '定价', '宁德国投', '福建投资集团', '36', '19480519'}",2344130,4,"{'150000000', '550000000', '71428571', '19480519'}",5,"{'现金', '定价', '宁德国投', '福建投资集团', '36'}",5,"{'现金', '定价', '宁德国投', '福建投资集团', '36'}"
18,"{'12000041.6', '13529411', '27058823', '南京丰同投资中心(有限合伙)', '南京华泰瑞联并购基金二号(有限合伙)', '6764705', '367999992.8', '北京华泰新产业成长投资基金(有限合伙)', '竞价', '170000000', '招商财富-国调招商1号专项资产管理计划、招商财富-三新1号专项资产管理计划', '北信瑞丰基金黄河定增8号资产管理计划', '江苏苏豪投资集团有限公司', '12500000', '183999989.6', '882356', '91999988', '12'}",16818382,2,"{'竞价', '招商财富-国调招商1号专项资产管理计划、招商财富-三新1号专项资产管理计划'}",2,"{'12', '江苏苏豪投资集团有限公司'}",16,"{'12000041.6', '13529411', '27058823', '南京丰同投资中心(有限合伙)', '南京华泰瑞联并购基金二号(有限合伙)', '6764705', '367999992.8', '北京华泰新产业成长投资基金(有限合伙)', '170000000', '北信瑞丰基金黄河定增8号资产管理计划', '12500000', '江苏苏豪投资集团有限公司', '183999989.6', '882356', '91999988', '12'}"
8,"{'现金', '太仓德源投资管理中心(有限合伙)', '江门市君合投资有限公司', '200000000.2', '68681318', '249999997.5', '54945055', '36'}",353611,0,set(),2,"{'现金', '36'}",8,"{'现金', '太仓德源投资管理中心(有限合伙)', '江门市君合投资有限公司', '200000000.2', '68681318', '249999997.5', '54945055', '36'}"
23,"{'深圳平安大华汇通财富管理有限公司', '2492522', '199919966', '130559988.4', '中邮创业基金管理股份有限公司', '西藏自治区投资有限公司', '99999982.64', '107749963', '2685692', '4983050', '财通基金管理有限公司', '竞价', '1306707', '7477567', '3254237', '赖宗阳', '2734920', '浙江天堂硅谷久鸿股权投资合伙企业(有限合伙)', '上海珠池资产管理有限公司', '109724990.4', '52425084.84', '299999988', '12'}",1831950,1,{'竞价'},7,"{'深圳平安大华汇通财富管理有限公司', '财通基金管理有限公司', '中邮创业基金管理股份有限公司', '西藏自治区投资有限公司', '赖宗阳', '上海珠池资产管理有限公司', '12'}",22,"{'深圳平安大华汇通财富管理有限公司', '2492522', '199919966', '130559988.4', '中邮创业基金管理股份有限公司', '西藏自治区投资有限公司', '99999982.64', '107749963', '2685692', '4983050', '财通基金管理有限公司', '1306707', '7477567', '3254237', '赖宗阳', '2734920', '浙江天堂硅谷久鸿股权投资合伙企业(有限合伙)', '上海珠池资产管理有限公司', '109724990.4', '52425084.84', '299999988', '12'}"
16,"{'12000000', '兵器财务有限责任公司', '现金', '新华基金管理有限公司', '11500000', '兴业全球基金管理有限公司', '江苏瑞华投资发展有限公司', '16500000', '浙江商裕开盛创业投资合伙企业(有限合伙)', '13000000', '深圳市本是资产管理有限公司', '5500000', '竞价', '天津证大金牛股权投资基金合伙企业(有限合伙)', '30000000', '12'}",1505015,3,"{'16500000', '竞价', '30000000'}",2,"{'现金', '12'}",13,"{'12000000', '兵器财务有限责任公司', '新华基金管理有限公司', '11500000', '现金', '江苏瑞华投资发展有限公司', '兴业全球基金管理有限公司', '浙江商裕开盛创业投资合伙企业(有限合伙)', '13000000', '深圳市本是资产管理有限公司', '5500000', '天津证大金牛股权投资基金合伙企业(有限合伙)', '12'}"
20,"{'12000000', '纳爱斯浙江投资有限公司', '陈昌兰', '5100000', '5000000', '山西证券股份有限公司', '3500000', '谭惠轩', '余岳华', '定价', '15000000', '凌俊', '11000000', '贾放平', '栗萍', '林纳新', '白敏莉', '2550000', '10000000', '12'}",130321,0,set(),12,"{'纳爱斯浙江投资有限公司', '陈昌兰', '山西证券股份有限公司', '谭惠轩', '余岳华', '定价', '凌俊', '贾放平', '栗萍', '白敏莉', '林纳新', '12'}",20,"{'12000000', '纳爱斯浙江投资有限公司', '陈昌兰', '5100000', '5000000', '山西证券股份有限公司', '3500000', '谭惠轩', '余岳华', '凌俊', '15000000', '定价', '11000000', '贾放平', '栗萍', '林纳新', '白敏莉', '2550000', '10000000', '12'}"
17,"{'云南锡业集团(控股)有限责任公司', '118593648', '常州常荣创业投资有限公司', '现金', '山西证券股份有限公司', '45480000', '12', '定价', '2400000', '2000000', '绍兴润鑫股权投资合伙企业(有限合伙)', '54576000', '1191800', '27101532', '绍兴越商八期投资合伙企业(有限合伙)', '5215200', '36'}",556263,5,"{'118593648', '45480000', '54576000', '27101532', '5215200'}",6,"{'36', '常州常荣创业投资有限公司', '现金', '山西证券股份有限公司', '定价', '12'}",12,"{'云南锡业集团(控股)有限责任公司', '36', '常州常荣创业投资有限公司', '现金', '山西证券股份有限公司', '定价', '2400000', '2000000', '绍兴润鑫股权投资合伙企业(有限合伙)', '1191800', '绍兴越商八期投资合伙企业(有限合伙)', '12'}"
21,"{'3635419', '38920092.99', '2337055', '易方达基金管理有限公司', '4414437', '建信基金管理有限责任公司', '现金', '中融基金管理有限公司', '174999991.7', '长城(天津)股权投资基金管理有限责任公司', '89999988.05', '竞价', '139999985.7', '169999968.9', '深圳远致富海七号投资企业(有限合伙)', '东海基金管理有限责任公司', '1010649', '九泰基金管理有限公司', '大成基金管理有限公司', '4544274', '12'}",16521325,3,"{'竞价', '139999985.7', '169999968.9'}",8,"{'现金', '九泰基金管理有限公司', '中融基金管理有限公司', '大成基金管理有限公司', '东海基金管理有限责任公司', '易方达基金管理有限公司', '建信基金管理有限责任公司', '12'}",18,"{'现金', '九泰基金管理有限公司', '中融基金管理有限公司', '大成基金管理有限公司', '174999991.7', '3635419', '89999988.05', '长城(天津)股权投资基金管理有限责任公司', '东海基金管理有限责任公司', '2337055', '38920092.99', '易方达基金管理有限公司', '4544274', '4414437', '1010649', '深圳远致富海七号投资企业(有限合伙)', '建信基金管理有限责任公司', '12'}"
13,"{'65479211.28', '现金', '71999995.9', '140999985.6', '2979036', '竞价', '宁波梅山保税港区东旼投资合伙企业(有限合伙)', '6414922', '赣州君恺投资咨询有限公司', '长信基金管理有限责任公司', '3275705', '12', '嘉兴君重资产管理有限公司'}",16440041,3,"{'65479211.28', '140999985.6', '竞价'}",5,"{'现金', '赣州君恺投资咨询有限公司', '长信基金管理有限责任公司', '12', '嘉兴君重资产管理有限公司'}",10,"{'现金', '71999995.9', '2979036', '宁波梅山保税港区东旼投资合伙企业(有限合伙)', '6414922', '赣州君恺投资咨询有限公司', '长信基金管理有限责任公司', '3275705', '12', '嘉兴君重资产管理有限公司'}"
31,"{'华宝兴业基金管理有限公司', '华安基金管理有限公司', '1190476190', '8999999996', '1380000000', '北京国有资本经营管理中心', '合肥建翔投资有限公司', '657142857', '6000000000', '定价', '8532999999', '2499999999', '深圳市平安创新资本投资有限公司', '平安大华基金管理有限公司', '36', '4285714284', '民生加银基金管理有限公司', '重庆渝资光电产业投资有限公司', '238095238', '4999999998', '5999999998', '6300000000', '4063333333', '华融证券股份有限公司', '2380952380', '2857142857', '499999999.8', '2857142856', '重庆江北嘴中央商务区投资集团有限公司', '3000000000', '12'}",784334,2,"{'5999999998', '1380000000'}",13,"{'平安大华基金管理有限公司', '华宝兴业基金管理有限公司', '北京国有资本经营管理中心', '36', '民生加银基金管理有限公司', '华安基金管理有限公司', '合肥建翔投资有限公司', '12', '重庆渝资光电产业投资有限公司', '定价', '重庆江北嘴中央商务区投资集团有限公司', '华融证券股份有限公司', '深圳市平安创新资本投资有限公司'}",29,"{'华宝兴业基金管理有限公司', '华安基金管理有限公司', '1190476190', '8999999996', '北京国有资本经营管理中心', '合肥建翔投资有限公司', '657142857', '6000000000', '定价', '8532999999', '2499999999', '深圳市平安创新资本投资有限公司', '平安大华基金管理有限公司', '36', '4285714284', '民生加银基金管理有限公司', '重庆渝资光电产业投资有限公司', '238095238', '4999999998', '6300000000', '4063333333', '华融证券股份有限公司', '2380952380', '2857142857', '499999999.8', '2857142856', '重庆江北嘴中央商务区投资集团有限公司', '3000000000', '12'}"
13,"{'周波', '20000000', '5000000', '现金', '阮兴祥', '何旭斌', '定价', '王建峰', '阮伟祥', '金瑞浩', '姚建芳', '200000000', '36'}",9905566,0,set(),10,"{'周波', '现金', '阮兴祥', '何旭斌', '定价', '王建峰', '阮伟祥', '金瑞浩', '姚建芳', '36'}",13,"{'周波', '20000000', '5000000', '现金', '阮兴祥', '何旭斌', '定价', '王建峰', '阮伟祥', '金瑞浩', '姚建芳', '200000000', '36'}"
26,"{'800000000', '2090000000', '1275000000', '14500000000', '同方计算机', '现金', '定价', '20181063', '37721614', '国研天成', '300000000', '首期2号员工持股计划', '首期1号员工持股计划', '546963410', '中加基金', '30177291', '11316484', '78838174', '535000000', '健坤爱清', '林芝清创', '1000000000', '上海华信', '36', '紫光通信', '48095058'}",1649368,4,"{'14500000000', '2090000000', '1275000000', '535000000'}",10,"{'36', '现金', '健坤爱清', '紫光通信', '定价', '国研天成', '林芝清创', '上海华信', '中加基金', '同方计算机'}",22,"{'800000000', '同方计算机', '现金', '定价', '20181063', '37721614', '国研天成', '300000000', '首期2号员工持股计划', '首期1号员工持股计划', '546963410', '中加基金', '30177291', '11316484', '78838174', '健坤爱清', '林芝清创', '1000000000', '上海华信', '36', '紫光通信', '48095058'}"
13,"{'周波', '20000000', '5000000', '现金', '阮兴祥', '何旭斌', '定价', '王建峰', '阮伟祥', '金瑞浩', '姚建芳', '200000000', '36'}",15489622,0,set(),10,"{'周波', '现金', '阮兴祥', '何旭斌', '定价', '王建峰', '阮伟祥', '金瑞浩', '姚建芳', '36'}",13,"{'周波', '20000000', '5000000', '现金', '阮兴祥', '何旭斌', '定价', '王建峰', '阮伟祥', '金瑞浩', '姚建芳', '200000000', '36'}"
14,"{'49999985', '招商财富资产管理有限公司', '山西证券股份有限公司', '5390835', '张友明', '定价', '235999982', '99999989', '12722371', '2695417', '6041377', '112067543', '12', '上银基金管理有限公司'}",1727316,5,"{'49999985', '235999982', '99999989', '2695417', '112067543'}",6,"{'招商财富资产管理有限公司', '山西证券股份有限公司', '张友明', '定价', '12', '上银基金管理有限公司'}",9,"{'招商财富资产管理有限公司', '山西证券股份有限公司', '张友明', '5390835', '定价', '12722371', '6041377', '12', '上银基金管理有限公司'}"
5,"{'现金', '157657657', '当代科技', '2800000000', '36'}",14321532,1,{'157657657'},2,"{'当代科技', '现金'}",4,"{'现金', '当代科技', '2800000000', '36'}"
15,"{'4882500', '林彦', '兴证资管鑫众12号集合资产管理计划', '1356250', '3878875', '竞价', '陈灵巧', '9215676', '林菊香', '兴证资管鑫众-爱仕达1号定向资产管理计划', '王相荣', '10850000', '36', '陈合林', '6781250'}",4929501,1,{'竞价'},6,"{'林彦', '陈灵巧', '王相荣', '林菊香', '36', '陈合林'}",14,"{'4882500', '林彦', '兴证资管鑫众12号集合资产管理计划', '1356250', '3878875', '陈灵巧', '9215676', '林菊香', '兴证资管鑫众-爱仕达1号定向资产管理计划', '王相荣', '10850000', '36', '陈合林', '6781250'}"
20,"{'499999995.8', '广发证券资产管理(广东)有限公司', '太平洋资产管理有限责任公司', '现金', '250002000', '249999997.9', '长城(天津)股权投资基金管理有限责任公司', '财通基金管理有限公司', '48450000', '7170541', '国信国投基金管理(北京)有限公司', '竞价', '36999991.56', '50387596', '信泰人寿保险股份有限公司', '96899224', '华商基金管理有限公司', '12', '48449612', '259999995.4'}",19304774,2,"{'竞价', '259999995.4'}",3,"{'华商基金管理有限公司', '现金', '12'}",18,"{'499999995.8', '广发证券资产管理(广东)有限公司', '太平洋资产管理有限责任公司', '现金', '250002000', '249999997.9', '长城(天津)股权投资基金管理有限责任公司', '财通基金管理有限公司', '48450000', '7170541', '国信国投基金管理(北京)有限公司', '36999991.56', '50387596', '信泰人寿保险股份有限公司', '96899224', '华商基金管理有限公司', '12', '48449612'}"
4,"{'36', '现金', '120000000', '德力西集团'}",1165742,1,{'120000000'},3,"{'36', '现金', '德力西集团'}",3,"{'36', '现金', '德力西集团'}"
4,"{'竞价', '现金', '36', '南方同正'}",1152431,1,{'竞价'},3,"{'现金', '36', '南方同正'}",3,"{'现金', '36', '南方同正'}"
14,"{'4309392', '北信瑞丰基金管理有限公司', '116999992.8', '79999999.95', '西部证券股份有限公司', '753157', '2946593', '20448212.55', '申万菱信基金管理有限公司', '宝盈基金管理有限公司', '61999984.35', '2283609', '建信基金管理有限责任公司', '12'}",15526928,3,"{'79999999.95', '61999984.35', '20448212.55'}",6,"{'北信瑞丰基金管理有限公司', '西部证券股份有限公司', '申万菱信基金管理有限公司', '宝盈基金管理有限公司', '建信基金管理有限责任公司', '12'}",11,"{'4309392', '北信瑞丰基金管理有限公司', '116999992.8', '753157', '西部证券股份有限公司', '2946593', '申万菱信基金管理有限公司', '宝盈基金管理有限公司', '2283609', '建信基金管理有限责任公司', '12'}"
34,"{'中国华电集团公司', '103200000', '中国工艺(集团)公司', '106300000', '上海喜仕达电子技术有限公司', '申能股份有限公司', '93500000', '211137371', '142800000', '117600000', '现金', '628256000', '719651000', '东兴证券股份有限公司', '定价', '财通基金管理有限公司', '89900000', '698664000', '966756000', '616070000', '36', '北信瑞丰基金管理有限公司', '91000000', '632995000', '博时基金管理有限公司', '50432993.14', '深圳市融通资本财富管理有限公司', '796152000', '92800000', '7449482', '1429400002', '中国银河证券股份有限公司', '608623000', '12'}",1761258,1,{'1429400002'},5,"{'36', '中国华电集团公司', '现金', '定价', '12'}",33,"{'中国华电集团公司', '103200000', '中国工艺(集团)公司', '106300000', '上海喜仕达电子技术有限公司', '申能股份有限公司', '93500000', '211137371', '142800000', '117600000', '现金', '628256000', '719651000', '东兴证券股份有限公司', '定价', '财通基金管理有限公司', '89900000', '698664000', '966756000', '616070000', '36', '北信瑞丰基金管理有限公司', '91000000', '632995000', '博时基金管理有限公司', '50432993.14', '深圳市融通资本财富管理有限公司', '796152000', '92800000', '7449482', '中国银河证券股份有限公司', '608623000', '12'}"
27,"{'70000000', '青岛华通国有资本运营(集团)有限责任公司', '广东恒健投资控股有限公司', '376000000', '现金', '33540000', '705000000', '35460000', '150000000', '36', '67000000', '博时基金管理有限公司', '157640000', '329000000', '中国华电', '470000000', '大亚湾核电财务有限责任公司', '刘益谦', '314900000', '100000000', '嘉实基金管理有限公司', '166660000', '航天神舟投资管理有限公司', '泰康资产管理有限责任公司', '80000000', '12', '青岛国信发展(集团)有限责任公司'}",1448475,12,"{'376000000', '150000000', '33540000', '314900000', '67000000', '157640000', '329000000', '166660000', '470000000', '705000000', '35460000', '80000000'}",11,"{'泰康资产管理有限责任公司', '36', '现金', '博时基金管理有限公司', '嘉实基金管理有限公司', '中国华电', '航天神舟投资管理有限公司', '广东恒健投资控股有限公司', '大亚湾核电财务有限责任公司', '12', '刘益谦'}",15,"{'泰康资产管理有限责任公司', '36', '现金', '100000000', '70000000', '博时基金管理有限公司', '嘉实基金管理有限公司', '中国华电', '航天神舟投资管理有限公司', '广东恒健投资控股有限公司', '大亚湾核电财务有限责任公司', '青岛华通国有资本运营(集团)有限责任公司', '12', '刘益谦', '青岛国信发展(集团)有限责任公司'}"
29,"{'899885600', '启迪桑德第一期员工持股计划', '149796000', '32440000', '33010000', '3134620000', '珠海启迪绿源资本管理有限公司', '现金', '西藏桑德投资控股有限公司', '邦信资产管理有限公司', '5400000', '竞价', '珠海启迪投资管理有限公司', '启迪金控投资有限公司', '汇添富基金管理股份有限公司', '113000000', '西藏清控资产管理有限公司', '299869400', '南通金信灏海投资中心(有限合伙)', '2000054000', '21630000', '32450000', '72100000', '900163000', '嘉实基金管理有限公司', '915697400', '600016200', '10810000', '36'}",2324265,17,"{'899885600', '21630000', '299869400', '32450000', '72100000', '149796000', '900163000', '32440000', '33010000', '5400000', '竞价', '3134620000', '915697400', '600016200', '10810000', '2000054000', '113000000'}",11,"{'西藏清控资产管理有限公司', '现金', '西藏桑德投资控股有限公司', '邦信资产管理有限公司', '启迪桑德第一期员工持股计划', '嘉实基金管理有限公司', '珠海启迪投资管理有限公司', '启迪金控投资有限公司', '珠海启迪绿源资本管理有限公司', '汇添富基金管理股份有限公司', '36'}",12,"{'西藏清控资产管理有限公司', '现金', '西藏桑德投资控股有限公司', '邦信资产管理有限公司', '启迪桑德第一期员工持股计划', '嘉实基金管理有限公司', '南通金信灏海投资中心(有限合伙)', '珠海启迪投资管理有限公司', '启迪金控投资有限公司', '珠海启迪绿源资本管理有限公司', '汇添富基金管理股份有限公司', '36'}"
22,"{'20000000', '京基集团有限公司', '29000000', '272650000', '202540000', '35000000', '广发基金管理有限公司', '浙江双可达纺织有限公司', '225910000', '116850000', '28000000', '现金', '东莞市君德富创业投资有限公司', '155800000', '218120000', '15000000', '无锡均衡创业投资有限公司', '深圳市一声达通信技术有限公司', '黄仙兰', '26000000', '嘉实基金管理有限公司', '12'}",1455247,9,"{'20000000', '29000000', '218120000', '272650000', '202540000', '26000000', '225910000', '116850000', '155800000'}",10,"{'京基集团有限公司', '现金', '黄仙兰', '嘉实基金管理有限公司', '广发基金管理有限公司', '浙江双可达纺织有限公司', '无锡均衡创业投资有限公司', '东莞市君德富创业投资有限公司', '深圳市一声达通信技术有限公司', '12'}",13,"{'京基集团有限公司', '现金', '黄仙兰', '35000000', '15000000', '嘉实基金管理有限公司', '广发基金管理有限公司', '浙江双可达纺织有限公司', '无锡均衡创业投资有限公司', '28000000', '东莞市君德富创业投资有限公司', '深圳市一声达通信技术有限公司', '12'}"
19,"{'66000000', '现金', '银华基金管理有限公司', '上海颐隆投资管理有限公司', '29599995', '12', '4400000', '3300000', '14000000', '210000000', '84900000', '竞价', '深圳中欧盛世资本管理有限公司', '1973333', '庞惠民', '5660000', '36', '招商证券股份有限公司', '49500000'}",894408,1,{'竞价'},8,"{'36', '现金', '银华基金管理有限公司', '上海颐隆投资管理有限公司', '深圳中欧盛世资本管理有限公司', '庞惠民', '12', '招商证券股份有限公司'}",18,"{'现金', '66000000', '银华基金管理有限公司', '上海颐隆投资管理有限公司', '29599995', '12', '4400000', '3300000', '14000000', '210000000', '84900000', '深圳中欧盛世资本管理有限公司', '1973333', '庞惠民', '5660000', '36', '招商证券股份有限公司', '49500000'}"
9,"{'现金', '249984000', '定价', '梁伟', '梁浩东', '1680000', '36', '49996800', '8400000'}",297106,4,"{'249984000', '1680000', '49996800', '8400000'}",5,"{'现金', '定价', '梁伟', '梁浩东', '36'}",5,"{'现金', '定价', '梁伟', '梁浩东', '36'}"
19,"{'72999991.63', '现金', '龙岩市汇金永盛壹号投资合伙企业(有限合伙)', '九泰基金管理有限公司', '中意资产管理有限责任公司', '14754702', '399999971.2', '鹏华资产管理有限公司', '定价', '山东高速股份有限公司', '2692785', '3319807', '89999967.77', '768195', '四川三新创业投资有限责任公司', '73001401.35', '2692733', '20825766.45', '12'}",18274029,0,set(),8,"{'现金', '九泰基金管理有限公司', '中意资产管理有限责任公司', '鹏华资产管理有限公司', '定价', '山东高速股份有限公司', '四川三新创业投资有限责任公司', '12'}",19,"{'72999991.63', '现金', '龙岩市汇金永盛壹号投资合伙企业(有限合伙)', '九泰基金管理有限公司', '中意资产管理有限责任公司', '14754702', '399999971.2', '鹏华资产管理有限公司', '3319807', '山东高速股份有限公司', '2692785', '定价', '89999967.77', '768195', '四川三新创业投资有限责任公司', '73001401.35', '2692733', '20825766.45', '12'}"
11,"{'泓泰投资', '张振标', '1879327', '2192548', '定价', '2505769', '赵群', '钟海荣', '4573029', '36', '翁占国'}",1727204,0,set(),7,"{'泓泰投资', '张振标', '定价', '赵群', '钟海荣', '36', '翁占国'}",11,"{'泓泰投资', '张振标', '1879327', '2192548', '定价', '2505769', '赵群', '钟海荣', '4573029', '36', '翁占国'}"
15,"{'503849', '49988779.52', '12172991.84', '现金', '九泰基金管理有限公司', '1241721', '财通基金管理有限公司', '1152245', '竞价', '中国对外经济贸易信托有限公司', '2069072', '泰达宏利基金管理有限公司', '29999979.36', '12', '27838239.2'}",1774689,4,"{'49988779.52', '竞价', '12172991.84', '29999979.36'}",2,"{'现金', '12'}",11,"{'503849', '现金', '九泰基金管理有限公司', '1241721', '财通基金管理有限公司', '1152245', '中国对外经济贸易信托有限公司', '2069072', '泰达宏利基金管理有限公司', '12', '27838239.2'}"
14,"{'20000000', '5000000', '8000000', '湖南汇方投资有限公司', '杭州麦田立家泓达创业投资有限公司', '博时基金管理有限公司', '7000000', '华宝信托有限责任公司', '浙江英维特投资有限公司', '9000000', '上海证券有限责任公司', '12', '江阴西冶机械制造维修有限公司', '16400000'}",1249101,4,"{'5000000', '8000000', '7000000', '16400000'}",5,"{'杭州麦田立家泓达创业投资有限公司', '博时基金管理有限公司', '华宝信托有限责任公司', '12', '江阴西冶机械制造维修有限公司'}",10,"{'20000000', '湖南汇方投资有限公司', '杭州麦田立家泓达创业投资有限公司', '博时基金管理有限公司', '华宝信托有限责任公司', '浙江英维特投资有限公司', '9000000', '上海证券有限责任公司', '12', '江阴西冶机械制造维修有限公司'}"
13,"{'现金', '周宝淡', 'Martin Currie Investment Management.Ltd', '华夏基金管理有限公司', '7000000', '2000000', '长江证券股份有限公司', '中银基金管理有限公司', '3000000', '黎杏梅', '1000000', '上海证券有限责任公司', '12'}",1384476,3,"{'1000000', 'Martin Currie Investment Management.Ltd', '7000000'}",8,"{'现金', '周宝淡', '华夏基金管理有限公司', '长江证券股份有限公司', '中银基金管理有限公司', '黎杏梅', '上海证券有限责任公司', '12'}",10,"{'周宝淡', '现金', '华夏基金管理有限公司', '长江证券股份有限公司', '2000000', '中银基金管理有限公司', '3000000', '黎杏梅', '上海证券有限责任公司', '12'}"
17,"{'昱桥公司钢企股东', '济源钢铁', '海鑫钢铁', '18382858', '定价', '91914290', '岚山港务', '40442288', '日照港集团', '273114379', '山钢集团', '25736001', '邯钢集团', '7353143', '79993559', '股权', '36'}",554423,7,"{'18382858', '91914290', '25736001', '40442288', '273114379', '7353143', '79993559'}",10,"{'36', '昱桥公司钢企股东', '济源钢铁', '海鑫钢铁', '定价', '日照港集团', '邯钢集团', '山钢集团', '股权', '岚山港务'}",10,"{'昱桥公司钢企股东', '济源钢铁', '海鑫钢铁', '定价', '岚山港务', '日照港集团', '邯钢集团', '山钢集团', '股权', '36'}"
24,"{'中再资产管理股份有限公司', '4000000', '申万菱信(上海)资产管理有限公司', '7000000', '1195800', '64676000', '4800000', '8000000', '98420000', '4600000', '天安财产保险股份有限公司', '财通基金管理有限公司', '竞价', '59052000', '华夏人寿保险股份有限公司', '16812948', '112480000', '4200000', '56240000', '刘宏光', '东海基金管理有限公司', '渤海证券股份有限公司', '12', '67488000'}",310727,11,"{'67488000', '16812948', '112480000', '1195800', '竞价', '4200000', '59052000', '56240000', '64676000', '4800000', '98420000'}",2,"{'渤海证券股份有限公司', '12'}",13,"{'华夏人寿保险股份有限公司', '中再资产管理股份有限公司', '刘宏光', '4000000', '4600000', '申万菱信(上海)资产管理有限公司', '东海基金管理有限公司', '7000000', '天安财产保险股份有限公司', '财通基金管理有限公司', '渤海证券股份有限公司', '8000000', '12'}"
6,"{'3612000000', '南山集团', '定价', '700000000', '股权', '36'}",1531337,1,{'3612000000'},4,"{'定价', '股权', '36', '南山集团'}",5,"{'南山集团', '定价', '700000000', '股权', '36'}"
13,"{'现金', '53929122', '100000000', '华安资产', '银华资本', '700000000', '15408321', '7704160', '中新融鑫', '国华人寿', '刘伟', '200000000', '36'}",343345,6,"{'53929122', '100000000', '700000000', '15408321', '7704160', '200000000'}",7,"{'现金', '华安资产', '银华资本', '中新融鑫', '国华人寿', '刘伟', '36'}",7,"{'现金', '华安资产', '银华资本', '中新融鑫', '国华人寿', '刘伟', '36'}"
12,"{'现金', '上海伟发投资控股有限公司', '九泰基金管理有限公司', '70000000', '定价', '30000000', '365000000', '5912162', '2533783', '苏州弘泰九鼎创业投资中心(有限合伙)', '30827702', '36'}",19274647,3,"{'2533783', '365000000', '5912162'}",5,"{'现金', '上海伟发投资控股有限公司', '九泰基金管理有限公司', '定价', '36'}",9,"{'现金', '上海伟发投资控股有限公司', '九泰基金管理有限公司', '70000000', '定价', '30000000', '苏州弘泰九鼎创业投资中心(有限合伙)', '30827702', '36'}"
17,"{'平安大华基金管理有限公司', '金鹰基金管理有限公司', '九泰基金管理有限公司', '12', '宁波梅山保税港区东峪投资合伙企业', '450999999.5', '财通基金管理有限公司', '1349000037', '64935064', '亿利资源集团有限公司', '竞价', '金元顺安基金管理有限公司', '嘉兴天朗投资合伙企业', '65079365', '36', '194660900', '449999993.5'}",15707142,1,{'450999999.5'},11,"{'平安大华基金管理有限公司', '金鹰基金管理有限公司', '九泰基金管理有限公司', '12', '宁波梅山保税港区东峪投资合伙企业', '财通基金管理有限公司', '金元顺安基金管理有限公司', '亿利资源集团有限公司', '竞价', '嘉兴天朗投资合伙企业', '36'}",16,"{'平安大华基金管理有限公司', '金鹰基金管理有限公司', '九泰基金管理有限公司', '12', '宁波梅山保税港区东峪投资合伙企业', '财通基金管理有限公司', '1349000037', '64935064', '亿利资源集团有限公司', '金元顺安基金管理有限公司', '竞价', '嘉兴天朗投资合伙企业', '65079365', '36', '194660900', '449999993.5'}"
6,"{'现金', '40000000', '雪人万家资产管理计划', '竞价', '433600000', '36'}",583912,3,"{'竞价', '433600000', '40000000'}",3,"{'雪人万家资产管理计划', '现金', '36'}",3,"{'雪人万家资产管理计划', '现金', '36'}"
19,"{'150000000', '20000000', '900000000', '现金', '新疆宏昇源', '芜湖江和', '600000000', '100000000', '深圳中民', '长沙云鼎', '广西正和', '孚威天玑', '300000000', '深圳盛财', '120000000', '50000000', '180000000', '30000000', '36'}",1091764,5,"{'900000000', '600000000', '300000000', '120000000', '180000000'}",9,"{'现金', '新疆宏昇源', '芜湖江和', '深圳中民', '长沙云鼎', '广西正和', '孚威天玑', '深圳盛财', '36'}",14,"{'150000000', '20000000', '现金', '新疆宏昇源', '芜湖江和', '100000000', '深圳中民', '长沙云鼎', '广西正和', '孚威天玑', '深圳盛财', '50000000', '30000000', '36'}"
19,"{'济南沃达投资合伙企业(有限合伙)', '现金', '上海鑫脉投资管理有限公司', '300366000', '定价', '18000000', '东营广进投资合伙企业(有限合伙)', '80900000', '17100000', '15300000', '112914000', '126198000', '刘静', '东海基金资产管理计划', '40700000', '132840000', '湖南深泰虹科技有限公司', '36', '597042000'}",355784,10,"{'300366000', '18000000', '80900000', '17100000', '15300000', '112914000', '126198000', '40700000', '132840000', '597042000'}",6,"{'现金', '上海鑫脉投资管理有限公司', '定价', '刘静', '东海基金资产管理计划', '36'}",9,"{'济南沃达投资合伙企业(有限合伙)', '现金', '上海鑫脉投资管理有限公司', '定价', '东营广进投资合伙企业(有限合伙)', '刘静', '东海基金资产管理计划', '湖南深泰虹科技有限公司', '36'}"
15,"{'现金', '博时资本管理有限公司', '华安基金管理有限公司', '工银瑞信基金管理有限公司', '1.30719E+11', '定价', '财通基金管理有限公司', '易方达基金管理有限公司', '天弘基金管理有限公司', '1.63399E+11', '1.84967E+11', '2.79085E+11', '创金合信基金管理有限公司', '12', '中民华恒投资有限公司'}",1677914,4,"{'1.30719E+11', '1.63399E+11', '1.84967E+11', '2.79085E+11'}",3,"{'定价', '现金', '12'}",11,"{'现金', '博时资本管理有限公司', '华安基金管理有限公司', '工银瑞信基金管理有限公司', '定价', '财通基金管理有限公司', '易方达基金管理有限公司', '天弘基金管理有限公司', '创金合信基金管理有限公司', '12', '中民华恒投资有限公司'}"
12,"{'8523676', '岑海霞', '江苏瑞华投资发展有限公司', '同济资产', '7311977', '12', '定价', '无锡市国联发展(集团)有限公司', '11381619', '常州投资集团有限公司', '20891364', '36'}",1431813,0,set(),6,"{'江苏瑞华投资发展有限公司', '同济资产', '12', '定价', '常州投资集团有限公司', '36'}",12,"{'8523676', '岑海霞', '江苏瑞华投资发展有限公司', '同济资产', '7311977', '12', '定价', '无锡市国联发展(集团)有限公司', '11381619', '常州投资集团有限公司', '20891364', '36'}"
23,"{'20000000', '北京光裕同源投资有限公司', '长城国融投资管理有限公司', '860749998.5', '现金', '定价', '90605263', '10000000', '融通资本科技装备基金资产管理计划', '中诚信投资有限公司', '15000000', '深圳市前海华讯方舟科技有限公司', '299250000', '中航瑞广集合资产管理计划', '融通资本空天防务基金资产管理计划', '北京大丰展锐投资中心(有限合伙)', '华安资产-览盛1号资产管理计划', '31500000', '142500000', '190000000', '融捷投资控股集团有限公司', '95000000', '36'}",1669459,0,set(),11,"{'北京光裕同源投资有限公司', '融通资本科技装备基金资产管理计划', '现金', '长城国融投资管理有限公司', '中诚信投资有限公司', '定价', '深圳市前海华讯方舟科技有限公司', '中航瑞广集合资产管理计划', '融通资本空天防务基金资产管理计划', '融捷投资控股集团有限公司', '36'}",23,"{'20000000', '北京光裕同源投资有限公司', '长城国融投资管理有限公司', '860749998.5', '现金', '定价', '90605263', '10000000', '融通资本科技装备基金资产管理计划', '中诚信投资有限公司', '15000000', '深圳市前海华讯方舟科技有限公司', '299250000', '中航瑞广集合资产管理计划', '融通资本空天防务基金资产管理计划', '北京大丰展锐投资中心(有限合伙)', '华安资产-览盛1号资产管理计划', '31500000', '142500000', '190000000', '融捷投资控股集团有限公司', '95000000', '36'}"
7,"{'现金', '定价', '上海国际集团资产管理有限公司', '12305986', '33148558', '鹏华基金管理有限公司', '12'}",14043475,1,{'33148558'},3,"{'定价', '现金', '12'}",6,"{'现金', '上海国际集团资产管理有限公司', '12305986', '定价', '鹏华基金管理有限公司', '12'}"
6,"{'现金', '147012578', '富鼎电子科技(嘉善)有限公司', '郑州投资控股有限公司', '25943396', '36'}",1787208,0,set(),3,"{'36', '现金', '郑州投资控股有限公司'}",6,"{'现金', '147012578', '富鼎电子科技(嘉善)有限公司', '郑州投资控股有限公司', '25943396', '36'}"
13,"{'28732879', '现金', '陈保华', '19341536', '中航证券有限公司', '12305447', '17441150', '财通基金管理有限公司', '华泰资产管理有限公司', '19455252', '竞价', '江苏瑞华投资控股集团有限公司', '12'}",444487,0,set(),3,"{'竞价', '现金', '12'}",13,"{'28732879', '现金', '陈保华', '19341536', '中航证券有限公司', '12305447', '17441150', '财通基金管理有限公司', '华泰资产管理有限公司', '19455252', '竞价', '江苏瑞华投资控股集团有限公司', '12'}"
18,"{'兴发龙元建设', '兴发新价值4号集合资产管理计划', '蒋丽霞', '34000000', '13000000', '赖晔鋆', '7000000', '122500000', '兴发新价值1号集合资产管理计划', '赖朝辉', '11000000', '50000000', '93500000', '兴发新价值2号集合资产管理计划', '华福证券有限责任公司', '兴发新价值3号集合资产管理计划', '赖振元', '36'}",290790,0,set(),11,"{'兴发龙元建设', '兴发新价值4号集合资产管理计划', '蒋丽霞', '赖晔鋆', '兴发新价值1号集合资产管理计划', '赖朝辉', '兴发新价值2号集合资产管理计划', '华福证券有限责任公司', '兴发新价值3号集合资产管理计划', '赖振元', '36'}",18,"{'兴发龙元建设', '兴发新价值4号集合资产管理计划', '蒋丽霞', '34000000', '13000000', '赖晔鋆', '7000000', '122500000', '11000000', '赖朝辉', '兴发新价值1号集合资产管理计划', '50000000', '93500000', '兴发新价值2号集合资产管理计划', '华福证券有限责任公司', '兴发新价值3号集合资产管理计划', '赖振元', '36'}"
24,"{'12000000', '123500000', '杭州如山创业投资有限公司', '13768421', '114000000', '高运控股集团有限公司', '104500000', '现金', '12', '定价', '11000000', '深圳市合赢投资管理有限公司', '36', '博时基金管理有限公司', '15000000', '天津凯石益盛股权投资基金合伙企业(有限合伙)', '439925800', '股权', '142500000', '130799999.5', '江苏瑞华投资发展有限公司', '13000000', '美克集团', '46307978'}",498753,0,set(),11,"{'36', '现金', '杭州如山创业投资有限公司', '江苏瑞华投资发展有限公司', '定价', '美克集团', '博时基金管理有限公司', '高运控股集团有限公司', '股权', '12', '深圳市合赢投资管理有限公司'}",24,"{'12000000', '123500000', '杭州如山创业投资有限公司', '13768421', '114000000', '高运控股集团有限公司', '104500000', '现金', '12', '定价', '11000000', '深圳市合赢投资管理有限公司', '36', '博时基金管理有限公司', '15000000', '天津凯石益盛股权投资基金合伙企业(有限合伙)', '439925800', '股权', '142500000', '130799999.5', '江苏瑞华投资发展有限公司', '13000000', '美克集团', '46307978'}"
4,"{'17000000', '云南旅投', '现金', '36'}",1148303,0,set(),3,"{'现金', '云南旅投', '36'}",4,"{'17000000', '云南旅投', '现金', '36'}"
12,"{'现金', '舟山如山汇金壹号投资合伙企业(有限合伙)', '4340277', '国机财务有限责任公司', '13020833', '中广核财务有限责任公司', '西藏自治区投资有限公司', '竞价', '北京领瑞投资管理有限公司', '26041666', '17361111', '36'}",2031618,4,"{'4340277', '竞价', '17361111', '舟山如山汇金壹号投资合伙企业(有限合伙)'}",6,"{'现金', '国机财务有限责任公司', '中广核财务有限责任公司', '西藏自治区投资有限公司', '北京领瑞投资管理有限公司', '36'}",8,"{'现金', '国机财务有限责任公司', '13020833', '中广核财务有限责任公司', '西藏自治区投资有限公司', '北京领瑞投资管理有限公司', '26041666', '36'}"
6,"{'150000000', '现金', '竞价', '2000000000', '广晟公司', '36'}",9881300,1,{'竞价'},3,"{'广晟公司', '现金', '36'}",5,"{'150000000', '现金', '2000000000', '广晟公司', '36'}"
5,"{'现金', '143376952', '定价', '新世纪公司', '36'}",573479,0,set(),4,"{'新世纪公司', '现金', '定价', '36'}",5,"{'现金', '143376952', '定价', '新世纪公司', '36'}"
12,"{'现金', '定价', '78431372', '117254903', '财通基金管理有限公司', '厦门国贸资产管理有限公司', '196078431', '中信证券股份有限公司', '安信乾盛财富管理(深圳)有限公司', '泰达宏利基金管理有限公司', '196470588', '12'}",9871154,0,set(),3,"{'定价', '现金', '12'}",12,"{'现金', '定价', '78431372', '117254903', '财通基金管理有限公司', '厦门国贸资产管理有限公司', '196078431', '中信证券股份有限公司', '安信乾盛财富管理(深圳)有限公司', '泰达宏利基金管理有限公司', '196470588', '12'}"
6,"{'430000000', '现金', '竞价', '50000000', '株洲市国有资产投资控股集团有限公司', '12'}",19334507,1,{'竞价'},3,"{'现金', '株洲市国有资产投资控股集团有限公司', '12'}",5,"{'430000000', '现金', '50000000', '株洲市国有资产投资控股集团有限公司', '12'}"
18,"{'14336010', '现金', '6100000', '5800000', '12', '上海哲熙投资管理合伙企业(有限合伙)', '定价', '8847531', '易方达基金管理有限公司', '特变电工股份有限公司', '雅戈尔集团股份有限公司', '常州投资集团有限公司', '中国对外经济贸易信托有限公司', '宁波金联诚股权投资合伙企业(有限合伙)', '6000000', '5900000', '36', '上海彤卉实业有限公司'}",1488147,6,"{'14336010', '6100000', '5800000', '8847531', '6000000', '5900000'}",5,"{'现金', '12', '定价', '特变电工股份有限公司', '36'}",12,"{'36', '现金', '上海哲熙投资管理合伙企业(有限合伙)', '定价', '易方达基金管理有限公司', '特变电工股份有限公司', '雅戈尔集团股份有限公司', '常州投资集团有限公司', '中国对外经济贸易信托有限公司', '宁波金联诚股权投资合伙企业(有限合伙)', '12', '上海彤卉实业有限公司'}"
24,"{'中山证券有限责任公司', '22078239', '长城国融投资管理有限公司', '6903015', '22004889', '44009779', '现金', '定价', '财通基金管理有限公司', '179999992', '江苏新扬子造船有限公司', '华泰柏瑞基金管理有限公司', '36', '富安达基金管理有限公司', '196000039.3', '361999994', '359999992.2', '56466662.7', '180599995', '44254278', '红豆集团有限公司', '华泰证券(上海)资产管理有限公司', '12', '23960885'}",14389227,2,"{'定价', '中山证券有限责任公司'}",9,"{'富安达基金管理有限公司', '现金', '长城国融投资管理有限公司', '12', '财通基金管理有限公司', '江苏新扬子造船有限公司', '红豆集团有限公司', '36', '华泰柏瑞基金管理有限公司'}",22,"{'22078239', '长城国融投资管理有限公司', '6903015', '22004889', '44009779', '现金', '12', '财通基金管理有限公司', '179999992', '江苏新扬子造船有限公司', '华泰柏瑞基金管理有限公司', '富安达基金管理有限公司', '196000039.3', '361999994', '359999992.2', '56466662.7', '180599995', '44254278', '红豆集团有限公司', '华泰证券(上海)资产管理有限公司', '36', '23960885'}"
14,"{'2345000', '15125250', '现金', '林志强', '83850000', '30655000', '王哲林', '浔兴集团', '13000000', '2000000', '12900000', '时位投资', '197724750', '36'}",1856314,0,set(),5,"{'王哲林', '现金', '林志强', '浔兴集团', '36'}",14,"{'2345000', '15125250', '现金', '林志强', '83850000', '30655000', '王哲林', '浔兴集团', '13000000', '2000000', '12900000', '时位投资', '197724750', '36'}"
9,"{'现金', '古少波', '古少明', '竞价', '古少扬', '古朴', '东方富通', '36', '李素玉'}",15624901,1,{'竞价'},8,"{'36', '现金', '古少波', '古少明', '古少扬', '东方富通', '古朴', '李素玉'}",8,"{'现金', '古少波', '古少明', '古少扬', '古朴', '东方富通', '36', '李素玉'}"
5,"{'1440288826', '定价', '中国国电', '股权', '36'}",1497820,0,set(),4,"{'中国国电', '定价', '股权', '36'}",5,"{'1440288826', '定价', '中国国电', '股权', '36'}"
24,"{'华宝兴业基金管理有限公司', '博时资本管理有限公司', '深圳天风天成资产管理有限公司', '219999995.6', '16568944', '宋瑾珂', '现金', '330999996.6', '财通基金管理有限公司', '竞价', '东海证券股份有限公司', '266759998.4', '13664596', '16708074', '13416149', '268999991.4', '20559006', '广发证券资产管理(广东)有限公司', '金鹰基金管理有限公司', '209239995.3', '华泰证券(上海)资产管理有限公司', '12996273', '215999998.9', '12'}",12056842,0,set(),10,"{'金鹰基金管理有限公司', '华宝兴业基金管理有限公司', '现金', '博时资本管理有限公司', '深圳天风天成资产管理有限公司', '财通基金管理有限公司', '东海证券股份有限公司', '竞价', '宋瑾珂', '12'}",24,"{'华宝兴业基金管理有限公司', '博时资本管理有限公司', '深圳天风天成资产管理有限公司', '219999995.6', '16568944', '宋瑾珂', '现金', '330999996.6', '财通基金管理有限公司', '东海证券股份有限公司', '266759998.4', '13664596', '竞价', '16708074', '13416149', '268999991.4', '20559006', '广发证券资产管理(广东)有限公司', '金鹰基金管理有限公司', '209239995.3', '华泰证券(上海)资产管理有限公司', '12996273', '215999998.9', '12'}"
6,"{'现金', '4800000000', '定价', '永泰控股', '367534456', '36'}",1908699,1,{'4800000000'},4,"{'36', '定价', '现金', '永泰控股'}",5,"{'现金', '定价', '永泰控股', '367534456', '36'}"
11,"{'28106078', '现金', '红土创新基金管理有限公司', '10229081', '14238773', '竞价', '鹏华基金管理有限公司', '西藏瑞华投资发展有限公司', '12', '泓德基金管理有限公司', '13143483'}",1827191,3,"{'28106078', '竞价', '13143483'}",2,"{'现金', '12'}",8,"{'现金', '红土创新基金管理有限公司', '10229081', '14238773', '鹏华基金管理有限公司', '西藏瑞华投资发展有限公司', '12', '泓德基金管理有限公司'}"
20,"{'402999993', '中国华电集团资本控股有限公司', '752999980', '现金', '24543676', '万家基金管理有限公司', '诺安基金管理有限公司', '18252933', '9126466', '天安财产保险股份有限公司', '279999977', '13135593', '中国长城资产管理公司', '竞价', '财通基金管理有限公司', '243999973', '安信基金管理有限责任公司', '7953063', '559999984', '12'}",2371141,9,"{'402999993', '24543676', '13135593', '279999977', '竞价', '243999973', '7953063', '559999984', '752999980'}",2,"{'现金', '12'}",11,"{'中国华电集团资本控股有限公司', '现金', '万家基金管理有限公司', '诺安基金管理有限公司', '18252933', '9126466', '天安财产保险股份有限公司', '财通基金管理有限公司', '中国长城资产管理公司', '安信基金管理有限责任公司', '12'}"
4,"{'广晟公司', '竞价', '现金', '36'}",1107200,0,set(),4,"{'广晟公司', '竞价', '现金', '36'}",4,"{'广晟公司', '竞价', '现金', '36'}"
16,"{'中原信托有限公司', '16000000', '江苏瑞华投资发展有限公司', '华夏基金管理有限公司', '定价', '18000000', '长盛基金管理有限公司', '广发基金管理有限公司', '22000000', '西藏自治区投资有限公司', '江西国际信托投资股份有限公司', '8000000', '中海基金管理有限公司', '30000000', '12', '海富通基金管理有限公司'}",1173004,2,"{'22000000', '30000000'}",7,"{'华夏基金管理有限公司', '长盛基金管理有限公司', '定价', '广发基金管理有限公司', '中海基金管理有限公司', '12', '海富通基金管理有限公司'}",14,"{'中原信托有限公司', '16000000', '江苏瑞华投资发展有限公司', '华夏基金管理有限公司', '18000000', '长盛基金管理有限公司', '定价', '广发基金管理有限公司', '西藏自治区投资有限公司', '江西国际信托投资股份有限公司', '8000000', '中海基金管理有限公司', '12', '海富通基金管理有限公司'}"
30,"{'26800000', '20797227', '3000000', '张邦辉', '张雷', '王韦', '200000000', '现金', '207972', '34662045', '1200000', '田萍', '346620', '519930', '程国浩', '10000000', '10398613', '4332755', '傅衍', '60000000', '120000000', '25000000', '陆裕肖', '吴天星', '2000000', '胡来根', '1733102', '4644714', '陈能兴', '36'}",676229,8,"{'26800000', '60000000', '1200000', '3000000', '120000000', '25000000', '10000000', '200000000'}",12,"{'陆裕肖', '现金', '吴天星', '傅衍', '胡来根', '田萍', '程国浩', '张邦辉', '张雷', '王韦', '陈能兴', '36'}",22,"{'20797227', '张邦辉', '张雷', '王韦', '现金', '207972', '34662045', '田萍', '346620', '519930', '程国浩', '10398613', '4332755', '傅衍', '陆裕肖', '吴天星', '2000000', '胡来根', '1733102', '4644714', '陈能兴', '36'}"
24,"{'张晶', '205636000', '30391992.98', '8000000', '8100000', '现金', '88566000', '钱海平', '财通基金管理有限公司', '竞价', '2985461', '8700000', '87548000', '20200000', '富国基金管理有限公司', '国联证券股份有限公司', '8600000', '81440000', '北京众和成长投资中心(有限合伙)', '22000000', '安信证券股份有限公司', '82458000', '223960000', '12'}",760135,7,"{'2985461', '8700000', '8600000', '30391992.98', '22000000', '竞价', '8100000'}",2,"{'现金', '12'}",17,"{'现金', '张晶', '205636000', '88566000', '钱海平', '81440000', '财通基金管理有限公司', '北京众和成长投资中心(有限合伙)', '87548000', '20200000', '富国基金管理有限公司', '安信证券股份有限公司', '82458000', '8000000', '223960000', '12', '国联证券股份有限公司'}"
5,"{'现金', '250000000', '竞价', '36', '江苏丹化集团有限责任公司'}",1639586,1,{'250000000'},4,"{'竞价', '现金', '36', '江苏丹化集团有限责任公司'}",4,"{'竞价', '现金', '36', '江苏丹化集团有限责任公司'}"
13,"{'20000000', '166500000', '现金', '张霞', '国联鼎汉技术1号集合资产管理计划', '38500000', '竞价', '侯文奇', '顾庆伟', '25000000', '幸建平', '200000000', '36'}",9887329,7,"{'20000000', '166500000', '国联鼎汉技术1号集合资产管理计划', '38500000', '竞价', '25000000', '200000000'}",6,"{'现金', '张霞', '侯文奇', '顾庆伟', '幸建平', '36'}",6,"{'现金', '张霞', '侯文奇', '顾庆伟', '幸建平', '36'}"
19,"{'167000000', '1277550000', '现金', '32584837', '中金国泰', '立厦投资基金', '124636997.7', '299128800.6', '249274003.1', '16292418', '39101804', '竞价', '38284470', '北京中天瑞恒', '北京博维时代', '292876195.6', '睿康投资', '北京中睿北科', '36'}",1778311,2,"{'竞价', '249274003.1'}",8,"{'立厦投资基金', '现金', '中金国泰', '北京中天瑞恒', '北京博维时代', '睿康投资', '北京中睿北科', '36'}",17,"{'167000000', '1277550000', '立厦投资基金', '32584837', '中金国泰', '124636997.7', '现金', '299128800.6', '16292418', '39101804', '38284470', '北京中天瑞恒', '北京博维时代', '292876195.6', '睿康投资', '北京中睿北科', '36'}"
15,"{'曹晓春', '上海季广投资管理中心(有限合伙)', '7485030', '宁波鼎亮睿兴股权投资中心(有限合伙)', '3742515', '定价', '13473053', '100000000.8', '50000000.4', '国金涌铧价值成长定增集合资产管理计划', '叶小平', '179999988.1', '70000000.56', '36', '5239521'}",1888291,1,{'179999988.1'},5,"{'曹晓春', '定价', '叶小平', '国金涌铧价值成长定增集合资产管理计划', '36'}",14,"{'曹晓春', '上海季广投资管理中心(有限合伙)', '7485030', '宁波鼎亮睿兴股权投资中心(有限合伙)', '3742515', '定价', '13473053', '50000000.4', '国金涌铧价值成长定增集合资产管理计划', '叶小平', '100000000.8', '70000000.56', '36', '5239521'}"
23,"{'山东省文化产业投资有限公司', '华安基金管理有限公司', '183000000', '120780000', '泰达宏利基金管理有限公司', '14081184', '华夏资本管理有限公司', '124967333', '159210000', '竞价', '10000000', '142740000', '中国青旅集团公司', '8700000', '36', '民生加银基金管理有限公司', '6600000', '257685667', '6828816', '黑龙江业丰生物技术有限公司', '天弘基金管理有限公司', '7800000', '12'}",68409,10,"{'142740000', '124967333', '6600000', '183000000', '159210000', '257685667', '竞价', '120780000', '6828816', '10000000'}",3,"{'36', '中国青旅集团公司', '12'}",13,"{'中国青旅集团公司', '山东省文化产业投资有限公司', '14081184', '民生加银基金管理有限公司', '华夏资本管理有限公司', '黑龙江业丰生物技术有限公司', '8700000', '华安基金管理有限公司', '12', '天弘基金管理有限公司', '7800000', '泰达宏利基金管理有限公司', '36'}"
18,"{'金鹰基金管理有限公司', '现金', '164299852.4', '64943990.55', '15306986', '60999993.45', '申万菱信(上海)资产管理有限公司', '109999989.9', '财通基金管理有限公司', '4976551', '8429118', '西藏自治区投资有限公司', '竞价', '泰达宏利基金管理有限公司', '4674329', '12', '12590027', '199756167.3'}",1867577,4,"{'64943990.55', '竞价', '60999993.45', '164299852.4'}",6,"{'金鹰基金管理有限公司', '现金', '财通基金管理有限公司', '西藏自治区投资有限公司', '泰达宏利基金管理有限公司', '12'}",14,"{'金鹰基金管理有限公司', '现金', '15306986', '109999989.9', '申万菱信(上海)资产管理有限公司', '4976551', '财通基金管理有限公司', '泰达宏利基金管理有限公司', '8429118', '西藏自治区投资有限公司', '4674329', '12', '12590027', '199756167.3'}"
4,"{'旅游集团', '现金', '竞价', '36'}",1314019,0,set(),4,"{'旅游集团', '现金', '竞价', '36'}",4,"{'旅游集团', '现金', '竞价', '36'}"
18,"{'14030000', '400135600', '现金', '平安养老保险股份有限公司', '新华人寿保险股份有限公司', '16830000', '定价', '28060000', '上海崇蠡投资管理中心(有限合伙)', '东吴-招商-金螳螂2015员工持股计划定向资产管理计划', '上海六禾镇岳投资中心(有限合伙)', '北京国兴民和投资中心(有限合伙)', '西藏瑞华投资发展有限公司', '路雷', '479991600', '36', '800271200', '乐源财富管理有限公司'}",1670654,6,"{'14030000', '400135600', '16830000', '28060000', '479991600', '800271200'}",8,"{'现金', '平安养老保险股份有限公司', '新华人寿保险股份有限公司', '定价', '西藏瑞华投资发展有限公司', '路雷', '36', '乐源财富管理有限公司'}",12,"{'现金', '平安养老保险股份有限公司', '新华人寿保险股份有限公司', '定价', '上海六禾镇岳投资中心(有限合伙)', '东吴-招商-金螳螂2015员工持股计划定向资产管理计划', '北京国兴民和投资中心(有限合伙)', '西藏瑞华投资发展有限公司', '路雷', '36', '上海崇蠡投资管理中心(有限合伙)', '乐源财富管理有限公司'}"
4,"{'969863611', '定价', '36', '福建省能源集团有限责任公司'}",439318,0,set(),3,"{'定价', '36', '福建省能源集团有限责任公司'}",4,"{'969863611', '定价', '36', '福建省能源集团有限责任公司'}"
12,"{'12000000', '民生加银基金管理有限公司', '7000000', '208559962.1', '唐球', '682560000', '深圳新华富时资产管理有限公司', '3666666', '泰达宏利基金管理有限公司', '华富基金管理有限公司', '398160000', '36'}",2038383,1,{'208559962.1'},2,"{'唐球', '36'}",11,"{'12000000', '民生加银基金管理有限公司', '7000000', '唐球', '682560000', '深圳新华富时资产管理有限公司', '3666666', '泰达宏利基金管理有限公司', '华富基金管理有限公司', '398160000', '36'}"
4,"{'竞价', '现金', '36', '中南大学粉末冶金工程研究中心有限公司'}",574056,0,set(),4,"{'竞价', '现金', '36', '中南大学粉末冶金工程研究中心有限公司'}",4,"{'竞价', '现金', '36', '中南大学粉末冶金工程研究中心有限公司'}"
28,"{'76666666', '78888888', '709999992', '泰达宏利基金管理有限公司', '建信基金管理有限责任公司', '新华联控股有限公司', '林芝锦华投资管理有限公司', '中国泛海控股集团有限公司', '现金', '德邦创新资本有限责任公司', '财通基金管理有限公司', '竞价', '122222222', '549999999', '569999997', '862499997', '599999994', '66666666', '689999994', '63333333', '13055558', '61111111', '中国银河证券股份有限公司', '1099999998', '117500022', '华安未来资产管理(上海)有限公司', '36', '95833333'}",1881618,0,set(),11,"{'中国泛海控股集团有限公司', '现金', '德邦创新资本有限责任公司', '财通基金管理有限公司', '竞价', '中国银河证券股份有限公司', '泰达宏利基金管理有限公司', '建信基金管理有限责任公司', '新华联控股有限公司', '36', '林芝锦华投资管理有限公司'}",28,"{'76666666', '78888888', '709999992', '泰达宏利基金管理有限公司', '建信基金管理有限责任公司', '新华联控股有限公司', '林芝锦华投资管理有限公司', '中国泛海控股集团有限公司', '现金', '德邦创新资本有限责任公司', '财通基金管理有限公司', '竞价', '122222222', '549999999', '569999997', '862499997', '599999994', '66666666', '689999994', '63333333', '13055558', '61111111', '中国银河证券股份有限公司', '1099999998', '117500022', '华安未来资产管理(上海)有限公司', '36', '95833333'}"
20,"{'8222553', '现金', '武汉欣荣睿企业咨询管理有限公司', '16445106', '上海圣瀚创业投资合伙企业(有限合伙)', '王德琦', '20556382', '7400298', '侯维才', '6166914', '冯美娟', '19734127', '苏州嘉禾亿创业投资中心(有限合伙)', '上海中能企业发展(集团)有限公司', '12333829', '温晓宁', '陈晓晖', '4933532', '36', '孙利'}",1633373,8,"{'8222553', '16445106', '20556382', '7400298', '4933532', '19734127', '12333829', '6166914'}",10,"{'现金', '武汉欣荣睿企业咨询管理有限公司', '王德琦', '侯维才', '冯美娟', '上海中能企业发展(集团)有限公司', '陈晓晖', '温晓宁', '36', '孙利'}",12,"{'现金', '武汉欣荣睿企业咨询管理有限公司', '上海圣瀚创业投资合伙企业(有限合伙)', '王德琦', '侯维才', '冯美娟', '苏州嘉禾亿创业投资中心(有限合伙)', '上海中能企业发展(集团)有限公司', '陈晓晖', '温晓宁', '36', '孙利'}"
4,"{'36', '定价', '现金', '创越集团'}",241036,0,set(),4,"{'定价', '现金', '创越集团', '36'}",4,"{'36', '定价', '现金', '创越集团'}"
14,"{'平安大华基金管理有限公司', '159999924', '平安养老保险股份有限公司', '现金', '张家港市金城融创投资管理有限公司', '2142857', '张家港市金科创业投资有限公司', '139000176', '定价', '毛文灏', '1654764', '179999988', '12', '1904761'}",1688175,3,"{'139000176', '159999924', '179999988'}",3,"{'现金', '定价', '12'}",11,"{'平安大华基金管理有限公司', '张家港市金城融创投资管理有限公司', '平安养老保险股份有限公司', '张家港市金科创业投资有限公司', '现金', '2142857', '定价', '毛文灏', '1654764', '12', '1904761'}"
16,"{'天平汽车保险股份有限公司', '华夏基金管理有限公司', '中邮创业基金管理有限公司', '兴业全球基金管理有限公司', '51000000', '35600000', '中诚信托有限责任公司', '27272727', '国泰君安证券股份有限公司', '25000000', '中国人寿资产管理有限公司', '正德人寿保险股份有限公司', '8695473', '28000000', '12', '北京中商华通科贸有限公司'}",1172117,0,set(),1,{'12'},16,"{'天平汽车保险股份有限公司', '华夏基金管理有限公司', '中邮创业基金管理有限公司', '兴业全球基金管理有限公司', '51000000', '35600000', '中诚信托有限责任公司', '27272727', '国泰君安证券股份有限公司', '25000000', '中国人寿资产管理有限公司', '正德人寿保险股份有限公司', '8695473', '28000000', '12', '北京中商华通科贸有限公司'}"
24,"{'16100000', '10774676', '申万菱信(上海)资产管理有限公司', '海通证券股份有限公司', '申万菱信基金管理有限公司', '12500000', '150850500', '现金', '256070600', '定价', '17060000', '184623000', '财通基金管理有限公司', '10050000', '241661000', '161727886.8', '东海基金管理有限责任公司', '12300000', '187625000', '广发证券资产管理(广东)有限公司', '14200000', '渤海证券股份有限公司', '213142000', '12'}",1642230,1,{'161727886.8'},8,"{'现金', '定价', '东海基金管理有限责任公司', '财通基金管理有限公司', '渤海证券股份有限公司', '海通证券股份有限公司', '申万菱信基金管理有限公司', '12'}",23,"{'16100000', '10774676', '申万菱信(上海)资产管理有限公司', '海通证券股份有限公司', '申万菱信基金管理有限公司', '12500000', '150850500', '现金', '256070600', '17060000', '184623000', '定价', '财通基金管理有限公司', '10050000', '241661000', '东海基金管理有限责任公司', '12300000', '187625000', '广发证券资产管理(广东)有限公司', '14200000', '渤海证券股份有限公司', '213142000', '12'}"
7,"{'南药集团', '499999999.2', '现金', '96153846', '107691072', 'Alliance Healthcare', '36'}",1272512,2,"{'499999999.2', '96153846'}",4,"{'南药集团', 'Alliance Healthcare', '现金', '36'}",5,"{'南药集团', '现金', '107691072', 'Alliance Healthcare', '36'}"
9,"{'现金', '20400000', '定价', '王军华', '11000000', '14600000', '符冠华', '36', '苏交科第1期员工持股计划'}",356491,3,"{'14600000', '11000000', '20400000'}",5,"{'现金', '定价', '王军华', '符冠华', '36'}",6,"{'现金', '定价', '王军华', '符冠华', '36', '苏交科第1期员工持股计划'}"
8,"{'20000000', '现金', '100000000', '科创嘉源', '瀚叶财富', '银河实业', '80000000', '36'}",75240,3,"{'100000000', '20000000', '80000000'}",5,"{'现金', '科创嘉源', '瀚叶财富', '银河实业', '36'}",5,"{'现金', '科创嘉源', '瀚叶财富', '银河实业', '36'}"
6,"{'490000000', '36000000', '现金', '定价', '巴玛投资', '36'}",9188,2,"{'490000000', '36000000'}",4,"{'巴玛投资', '定价', '现金', '36'}",4,"{'巴玛投资', '定价', '现金', '36'}"
9,"{'现金', '重庆宝润私募投资1号基金', '诚达融私募投资1号基金', '3752417', '新华制药第一期员工持股计划', '20579573', '21405738', '聚赢产业基金', '36'}",14755973,5,"{'诚达融私募投资1号基金', '3752417', '20579573', '21405738', '重庆宝润私募投资1号基金'}",4,"{'聚赢产业基金', '现金', '36', '新华制药第一期员工持股计划'}",4,"{'聚赢产业基金', '现金', '36', '新华制药第一期员工持股计划'}"
28,"{'华安基金管理有限公司', '10204081', '国联安基金管理有限公司', '8673469', '广东中科招商创业投资管理有限责任公司', '现金', '武汉雷石融泰投资合伙企业(有限合伙)', '深圳市吉富启瑞投资合伙企业(有限合伙)', '定价', '财通基金管理有限公司', '69999998.6', '8265306', '816329', '84999996.2', '7142857', '14285714', '万家共赢资产管理有限公司', '71999992.4', '139999997.2', '8000024.2', '中信证券股份有限公司', '7551020', '80999998.8', '华商基金管理有限公司', '73999996', '7346938', '99999993.8', '12'}",11802,0,set(),3,"{'定价', '现金', '12'}",28,"{'华安基金管理有限公司', '10204081', '国联安基金管理有限公司', '8673469', '广东中科招商创业投资管理有限责任公司', '现金', '武汉雷石融泰投资合伙企业(有限合伙)', '深圳市吉富启瑞投资合伙企业(有限合伙)', '定价', '财通基金管理有限公司', '69999998.6', '8265306', '816329', '84999996.2', '7142857', '14285714', '万家共赢资产管理有限公司', '71999992.4', '139999997.2', '8000024.2', '中信证券股份有限公司', '7551020', '80999998.8', '华商基金管理有限公司', '73999996', '7346938', '99999993.8', '12'}"
25,"{'11657458', '119999995.4', '华泰资产管理有限公司', '99539999.75', '郑仕麟', '99999993.15', '现金', '299999997.6', '2470721', '33149171', '财通基金管理有限公司', '竞价', '北信瑞丰基金管理有限公司', '13259668', '10998895', '富国基金管理有限公司', '华鑫证券有限责任公司', '22360025.05', '银华基金管理股份有限公司', '105499994.9', '147999998.6', '项士宋', '11049723', '16353591', '12'}",16356669,3,"{'147999998.6', '竞价', '299999997.6'}",10,"{'现金', '北信瑞丰基金管理有限公司', '银华基金管理股份有限公司', '华泰资产管理有限公司', '财通基金管理有限公司', '华鑫证券有限责任公司', '富国基金管理有限公司', '项士宋', '郑仕麟', '12'}",22,"{'11657458', '119999995.4', '华泰资产管理有限公司', '99539999.75', '郑仕麟', '99999993.15', '现金', '2470721', '33149171', '财通基金管理有限公司', '北信瑞丰基金管理有限公司', '13259668', '10998895', '富国基金管理有限公司', '华鑫证券有限责任公司', '22360025.05', '银华基金管理股份有限公司', '105499994.9', '项士宋', '11049723', '16353591', '12'}"
15,"{'霍山衡胜投资管理中心(有限合伙)', '现金', '霍山衡义投资管理中心(有限合伙)', '7602808', '安徽省铁路建设投资基金有限公司', '定价', '博时基金管理有限公司', '3132100', '霍山衡顺投资管理中心(有限合伙)', '6231443', '6231448', '杜应流', '2731320', '7815222', '36'}",6099261,3,"{'霍山衡胜投资管理中心(有限合伙)', '霍山衡顺投资管理中心(有限合伙)', '霍山衡义投资管理中心(有限合伙)'}",5,"{'现金', '定价', '博时基金管理有限公司', '杜应流', '36'}",12,"{'现金', '7602808', '安徽省铁路建设投资基金有限公司', '博时基金管理有限公司', '3132100', '定价', '6231443', '6231448', '杜应流', '2731320', '7815222', '36'}"
4,"{'莱茵达控股集团', '竞价', '股权', '36'}",226367,0,set(),4,"{'莱茵达控股集团', '竞价', '股权', '36'}",4,"{'莱茵达控股集团', '竞价', '股权', '36'}"
17,"{'中国信达资产管理股份有限公司', '云南省工业投资控股集团有限责任公司', '现金', '20000000', '11100000', '上海蛙乐特投资管理合伙企业(有限合伙)', '定价', '中国大唐集团公司', '11000000', '中新融创资本管理有限公司', '海通证券股份有限公司', '31110000', '南方基金管理有限公司', '博弘数君(天津)股权投资基金合伙企业(有限合伙)', '中国长城资产管理公司', '10500000', '12'}",1323043,1,{'定价'},9,"{'中国信达资产管理股份有限公司', '云南省工业投资控股集团有限责任公司', '现金', '中国大唐集团公司', '中国长城资产管理公司', '中新融创资本管理有限公司', '海通证券股份有限公司', '南方基金管理有限公司', '12'}",16,"{'中国信达资产管理股份有限公司', '云南省工业投资控股集团有限责任公司', '现金', '20000000', '11100000', '上海蛙乐特投资管理合伙企业(有限合伙)', '中国大唐集团公司', '11000000', '中新融创资本管理有限公司', '海通证券股份有限公司', '31110000', '南方基金管理有限公司', '博弘数君(天津)股权投资基金合伙企业(有限合伙)', '中国长城资产管理公司', '10500000', '12'}"
11,"{'5899705', '现金', '27728613', '信诚基金管理有限公司', '定价', '国华人寿保险股份有限公司', '财通基金管理有限公司', '7227139', '5973451', '12', '歌斐诺宝(上海)资产管理有限公司'}",14629875,0,set(),3,"{'定价', '现金', '12'}",11,"{'5899705', '现金', '27728613', '信诚基金管理有限公司', '国华人寿保险股份有限公司', '定价', '财通基金管理有限公司', '7227139', '5973451', '12', '歌斐诺宝(上海)资产管理有限公司'}"
17,"{'82810000', '现金', '北京三才聚投资管理中心(有限合伙)', '黄卿乐', '13000000', '定价', '黄文佳', '89180000', '李文茂', '2000000', '2800000', '63700000', '黄瑞兵', '北京首航波纹管制造有限公司', '2600000', '36', '414050000'}",363419,6,"{'82810000', '13000000', '89180000', '63700000', '2600000', '414050000'}",8,"{'现金', '黄卿乐', '定价', '黄文佳', '李文茂', '黄瑞兵', '北京首航波纹管制造有限公司', '36'}",11,"{'现金', '北京三才聚投资管理中心(有限合伙)', '黄卿乐', '定价', '黄文佳', '李文茂', '2000000', '2800000', '黄瑞兵', '北京首航波纹管制造有限公司', '36'}"
24,"{'吕旭幸', '钟婉珍', '12900000', '任军', '现金', '曹蕾', '65266944', '定价', '陈尧根', '9000000', '10000000', '5448530', '269230000', '186390000', '华富资管-富鼎6号专项资产管理计划', '112839056', '沈依伊', '217455000', '3151470', '13000000', '207100000', '10500000', '267159000', '36'}",1780918,7,"{'5448530', '3151470', '13000000', '12900000', '9000000', '10500000', '10000000'}",9,"{'吕旭幸', '现金', '曹蕾', '钟婉珍', '定价', '陈尧根', '沈依伊', '任军', '36'}",17,"{'吕旭幸', '现金', '269230000', '217455000', '186390000', '曹蕾', '钟婉珍', '207100000', '65266944', '华富资管-富鼎6号专项资产管理计划', '陈尧根', '定价', '112839056', '沈依伊', '267159000', '任军', '36'}"
16,"{'2222222', '211999968', '泰康人寿保险有限责任公司投连行业配置型投资账户', '泰康人寿保险有限责任公司-万能-个险万能产品(乙)', '安大略退休金管理委员会', '1277780', '泰康人寿保险有限责任公司-分红-个人分红产品', '46000080', '79999992', '定价', '新华基金管理股份有限公司', '华能贵诚信托有限公司', '诺远资产管理有限公司', '5888888', '12', '泰康人寿保险有限责任公司投连创新动力型投资账户'}",17964184,0,set(),8,"{'泰康人寿保险有限责任公司投连行业配置型投资账户', '安大略退休金管理委员会', '定价', '新华基金管理股份有限公司', '华能贵诚信托有限公司', '诺远资产管理有限公司', '12', '泰康人寿保险有限责任公司投连创新动力型投资账户'}",16,"{'2222222', '211999968', '泰康人寿保险有限责任公司投连行业配置型投资账户', '泰康人寿保险有限责任公司-万能-个险万能产品(乙)', '安大略退休金管理委员会', '1277780', '泰康人寿保险有限责任公司-分红-个人分红产品', '46000080', '79999992', '定价', '新华基金管理股份有限公司', '华能贵诚信托有限公司', '诺远资产管理有限公司', '5888888', '12', '泰康人寿保险有限责任公司投连创新动力型投资账户'}"
12,"{'现金', '499999996.7', '国寿安保基金管理有限公司', '291262135', '云南省城市建设投资集团有限公司', '999999998.6', '财通基金管理有限公司', '1499999995', '97087378', '194174757', '36', '歌斐诺宝(上海)资产管理有限公司'}",333657,1,{'999999998.6'},5,"{'现金', '国寿安保基金管理有限公司', '云南省城市建设投资集团有限公司', '财通基金管理有限公司', '36'}",11,"{'现金', '499999996.7', '国寿安保基金管理有限公司', '291262135', '云南省城市建设投资集团有限公司', '财通基金管理有限公司', '1499999995', '97087378', '194174757', '36', '歌斐诺宝(上海)资产管理有限公司'}"
20,"{'36360000', '现金', '深圳市天寅投资有限公司', '16000000', '江苏瑞华投资发展有限公司', '7980000', '广东森泰兴投资有限公司', '96960000', '南昌中发投资咨询有限公司', '48358800', '揭东县永平机电设备贸易有限公司', '南昌德顺投资咨询有限公司', '竞价', '39390000', '6500000', '48480000', '甘肃宝信电力投资担保有限公司', '6000000', '8000000', '12'}",1258395,5,"{'36360000', '48358800', '96960000', '39390000', '48480000'}",10,"{'现金', '深圳市天寅投资有限公司', '江苏瑞华投资发展有限公司', '广东森泰兴投资有限公司', '南昌中发投资咨询有限公司', '揭东县永平机电设备贸易有限公司', '南昌德顺投资咨询有限公司', '竞价', '甘肃宝信电力投资担保有限公司', '12'}",15,"{'现金', '16000000', '深圳市天寅投资有限公司', '江苏瑞华投资发展有限公司', '7980000', '广东森泰兴投资有限公司', '南昌中发投资咨询有限公司', '揭东县永平机电设备贸易有限公司', '南昌德顺投资咨询有限公司', '竞价', '甘肃宝信电力投资担保有限公司', '6500000', '6000000', '8000000', '12'}"
18,"{'599999988', '现金', '600000043.2', '600000098.4', '财通基金管理有限公司', '东方基金管理有限责任公司', '易方达基金管理有限公司', '珠海植通投资中心(有限合伙)', '竞价', '沈阳恒信投资管理有限公司', '10869565', '12994706', '717307771.2', '8744422', '10869567', '482692094.4', '12', '10869566'}",1815832,1,{'竞价'},6,"{'现金', '财通基金管理有限公司', '东方基金管理有限责任公司', '易方达基金管理有限公司', '沈阳恒信投资管理有限公司', '12'}",17,"{'599999988', '现金', '600000043.2', '600000098.4', '财通基金管理有限公司', '东方基金管理有限责任公司', '易方达基金管理有限公司', '珠海植通投资中心(有限合伙)', '12994706', '沈阳恒信投资管理有限公司', '10869565', '8744422', '717307771.2', '10869567', '482692094.4', '12', '10869566'}"
5,"{'现金', '袁明', '218856958', '竞价', '36'}",382772,1,{'218856958'},4,"{'袁明', '竞价', '现金', '36'}",4,"{'袁明', '竞价', '现金', '36'}"
8,"{'现金', '12', '1167450000', '上海汽车工业(集团)总公司', '竞价', '3000000000', '上海汽车集团股份有限公司核心员工持股计划', '36'}",1806930,2,"{'1167450000', '3000000000'}",5,"{'现金', '12', '竞价', '上海汽车集团股份有限公司核心员工持股计划', '36'}",6,"{'现金', '12', '上海汽车工业(集团)总公司', '竞价', '上海汽车集团股份有限公司核心员工持股计划', '36'}"
4,"{'上银基金作为管理人的上银29号资管计划', '湖北新海天投资有限公司', '上银基金作为管理人的上银30号资管计划', '上银基金作为管理人的上银28号资管计划'}",1822995,0,set(),0,set(),4,"{'上银基金作为管理人的上银29号资管计划', '湖北新海天投资有限公司', '上银基金作为管理人的上银30号资管计划', '上银基金作为管理人的上银28号资管计划'}"
18,"{'38085201', '现金', '富德生命人寿', '西藏金宝藏', '西藏金桔', '111649909', '新疆嘉梦', '31390123', '石河子无极', '北京北清', '西藏九达', '37990695', '3006726', '2004484', '47516300', '宁波大有', '36', '52816457'}",2156200,0,set(),10,"{'富德生命人寿', '西藏金桔', '西藏金宝藏', '现金', '新疆嘉梦', '北京北清', '石河子无极', '西藏九达', '宁波大有', '36'}",18,"{'38085201', '现金', '富德生命人寿', '西藏金宝藏', '西藏金桔', '111649909', '新疆嘉梦', '31390123', '石河子无极', '北京北清', '西藏九达', '37990695', '3006726', '2004484', '47516300', '宁波大有', '36', '52816457'}"
6,"{'现金', '1088635990', '鲁楚平', '135066500', '定价', '36'}",358437,1,{'1088635990'},4,"{'定价', '现金', '36', '鲁楚平'}",5,"{'现金', '鲁楚平', '135066500', '定价', '36'}"
5,"{'现金', '竞价', '50000000', '36', '长沙矿冶研究院'}",1329730,1,{'50000000'},3,"{'竞价', '现金', '长沙矿冶研究院'}",4,"{'竞价', '现金', '36', '长沙矿冶研究院'}"
12,"{'萃锦投资', '26002972', '350000000', '70000000', '姚军', '赵素菲', '翰海投资', '广汇集团', '560000000', '5200594', '36', '41604755'}",16100105,3,"{'350000000', '70000000', '560000000'}",6,"{'萃锦投资', '赵素菲', '广汇集团', '姚军', '36', '翰海投资'}",9,"{'萃锦投资', '26002972', '姚军', '赵素菲', '翰海投资', '广汇集团', '5200594', '36', '41604755'}"
8,"{'760090017', '定价', '湖北省国资委', '134004836', '长江电力', '888317165', '国电集团', '36'}",1073960,1,{'134004836'},4,"{'长江电力', '国电集团', '36', '湖北省国资委'}",7,"{'760090017', '定价', '湖北省国资委', '长江电力', '888317165', '国电集团', '36'}"
15,"{'545999998.5', '长安基金管理有限公司', '现金', '北信瑞丰基金管理有限公司', '创金合信基金管理有限公司', '92747476', '建信基金管理有限责任公司', '55151515', '竞价', '549999994.5', '539999994.6', '918200012.4', '54545454', '12', '55555555'}",20278299,1,{'竞价'},6,"{'现金', '长安基金管理有限公司', '北信瑞丰基金管理有限公司', '创金合信基金管理有限公司', '建信基金管理有限责任公司', '12'}",14,"{'545999998.5', '长安基金管理有限公司', '现金', '北信瑞丰基金管理有限公司', '创金合信基金管理有限公司', '92747476', '建信基金管理有限责任公司', '55151515', '549999994.5', '539999994.6', '918200012.4', '54545454', '12', '55555555'}"
19,"{'28593718', '天津盛熙股权投资基金合伙企业(有限合伙)', 'Holchin B.V.有限责任公司', '宁波青春投资有限公司', '12', '8600000', '定价', '国华人寿保险股份有限公司', '1547013', '10345610', '山西信托有限责任公司', '10713775', '8612919', '8598857', '信达证券股份有限公司', '泰康资产管理有限责任公司', '江苏瑞华投资控股集团有限公司', '36', '51088036'}",1444987,3,"{'定价', '山西信托有限责任公司', 'Holchin B.V.有限责任公司'}",7,"{'宁波青春投资有限公司', '12', '国华人寿保险股份有限公司', '信达证券股份有限公司', '泰康资产管理有限责任公司', '江苏瑞华投资控股集团有限公司', '36'}",16,"{'36', '28593718', '天津盛熙股权投资基金合伙企业(有限合伙)', '宁波青春投资有限公司', '8600000', '国华人寿保险股份有限公司', '1547013', '10345610', '10713775', '8612919', '8598857', '信达证券股份有限公司', '泰康资产管理有限责任公司', '江苏瑞华投资控股集团有限公司', '12', '51088036'}"
5,"{'20000000', '现金', '中国光大控股有限公司', '60', '竞价'}",1194690,1,{'20000000'},4,"{'中国光大控股有限公司', '60', '竞价', '现金'}",4,"{'中国光大控股有限公司', '60', '竞价', '现金'}"
5,"{'山东银座商城股份有限公司', '竞价', '山东世界贸易中心', '股权', '36'}",1212647,2,"{'山东银座商城股份有限公司', '山东世界贸易中心'}",3,"{'竞价', '股权', '36'}",3,"{'竞价', '股权', '36'}"
22,"{'102649993.6', '武汉人和鼎钧投资管理有限公司', '104999977.9', '国联安基金管理有限公司', '申万菱信基金管理有限公司', '国投瑞银基金管理有限公司', '31200072.21', '1500214', '现金', '1466638', '定价', '2857551', '199999994.5', '2643234', '北京和聚投资管理有限公司', '445779', '184999947.7', '福建省新兴产业股权投资有限合伙企业', '4286326', '299999956.7', '12', '海富通基金管理有限公司'}",14248460,3,"{'104999977.9', '199999994.5', '184999947.7'}",3,"{'定价', '现金', '12'}",19,"{'现金', '1466638', '102649993.6', '武汉人和鼎钧投资管理有限公司', '31200072.21', '定价', '国联安基金管理有限公司', '福建省新兴产业股权投资有限合伙企业', '2857551', '4286326', '申万菱信基金管理有限公司', '2643234', '北京和聚投资管理有限公司', '国投瑞银基金管理有限公司', '445779', '299999956.7', '1500214', '12', '海富通基金管理有限公司'}"
2,"{'36', '山东金岭铁矿'}",935360,0,set(),2,"{'36', '山东金岭铁矿'}",2,"{'36', '山东金岭铁矿'}"
15,"{'四川产业振兴发展投资基金有限公司', '现金', '长安基金管理有限公司', '宋丽华', '云南能源金融控股有限公司', '11111111', '15000000', '28664021', '20224868', '竞价', '喀什思山股权投资合伙企业(有限合伙)', '新余恒道资产管理中心(有限合伙)', '20175132', '36', '45000000'}",1659978,2,"{'竞价', '喀什思山股权投资合伙企业(有限合伙)'}",6,"{'四川产业振兴发展投资基金有限公司', '现金', '长安基金管理有限公司', '宋丽华', '云南能源金融控股有限公司', '36'}",13,"{'四川产业振兴发展投资基金有限公司', '现金', '长安基金管理有限公司', '宋丽华', '云南能源金融控股有限公司', '11111111', '15000000', '28664021', '20224868', '新余恒道资产管理中心(有限合伙)', '20175132', '36', '45000000'}"
23,"{'申万菱信基金管理有限公司', '泰达宏利基金管理有限公司', '101576182', '现金', '6500012.76', '财通基金管理有限公司', '1138356', '474499995', '52539404', '博时基金管理有限公司', '899999996.2', '东海基金管理有限责任公司', '299999996.8', '57793345', '71628721', '招商财富资产管理有限公司', '157618213', '330000000', '方正富邦基金管理有限公司', '408999996.9', '83099824', '579999999.2', '12'}",95940,2,"{'330000000', '6500012.76'}",9,"{'招商财富资产管理有限公司', '现金', '方正富邦基金管理有限公司', '博时基金管理有限公司', '东海基金管理有限责任公司', '财通基金管理有限公司', '申万菱信基金管理有限公司', '泰达宏利基金管理有限公司', '12'}",21,"{'申万菱信基金管理有限公司', '泰达宏利基金管理有限公司', '101576182', '现金', '财通基金管理有限公司', '1138356', '474499995', '52539404', '博时基金管理有限公司', '899999996.2', '东海基金管理有限责任公司', '299999996.8', '57793345', '71628721', '招商财富资产管理有限公司', '157618213', '方正富邦基金管理有限公司', '408999996.9', '83099824', '579999999.2', '12'}"
19,"{'现金', '4980000', '天平汽车保险股份有限公司', '王绍林', '9500000', '12', '国机财务有限责任公司', '定价', '唐向山', '7000000', '雅戈尔投资有限公司', '上海证大投资管理有限公司', '1734838', '河北凌云工业集团有限公司', '6500000', '上海景贤投资有限公司', '6000000', '8000000', '36'}",1503817,1,{'唐向山'},11,"{'36', '现金', '天平汽车保险股份有限公司', '王绍林', '国机财务有限责任公司', '定价', '上海证大投资管理有限公司', '雅戈尔投资有限公司', '河北凌云工业集团有限公司', '上海景贤投资有限公司', '12'}",18,"{'4980000', '现金', '天平汽车保险股份有限公司', '王绍林', '9500000', '12', '国机财务有限责任公司', '定价', '7000000', '雅戈尔投资有限公司', '上海证大投资管理有限公司', '1734838', '河北凌云工业集团有限公司', '6500000', '上海景贤投资有限公司', '6000000', '8000000', '36'}"
5,"{'54800000', '现金', '竞价', '36', '吴建新'}",4920937,1,{'54800000'},4,"{'竞价', '现金', '36', '吴建新'}",4,"{'竞价', '现金', '36', '吴建新'}"
19,"{'204126013.3', '鹏华资产管理(深圳)有限公司', '现金', '金鹰基金管理有限公司', '6303915', '北信瑞丰基金管理有限公司', '379999996.2', '华泰资产管理有限公司', '竞价', '12607830', '189999998.1', '鹏华基金管理有限公司', '申万菱信基金管理有限公司', '179999998.2', '5972130', '22092700', '12', '665873978', '6772595'}",1665682,1,{'竞价'},7,"{'金鹰基金管理有限公司', '现金', '北信瑞丰基金管理有限公司', '华泰资产管理有限公司', '鹏华基金管理有限公司', '申万菱信基金管理有限公司', '12'}",18,"{'204126013.3', '鹏华资产管理(深圳)有限公司', '现金', '金鹰基金管理有限公司', '6303915', '北信瑞丰基金管理有限公司', '379999996.2', '华泰资产管理有限公司', '12607830', '189999998.1', '179999998.2', '鹏华基金管理有限公司', '申万菱信基金管理有限公司', '5972130', '22092700', '12', '665873978', '6772595'}"
19,"{'159999969.1', '143545974', '芜湖弘唯基石创业投资合伙企业(有限合伙)', '现金', '西安航天新能源产业基金投资有限公司', '2226900', '兴证证券资产管理有限公司', '2191688', '71772987', '定价', '6205398', '70638104.24', '厦门市集美区产业投资有限公司', '199999977.5', '深圳安鹏资本创新有限公司', '4453800', '4964318', '深圳远致富海七号投资企业(有限合伙)', '12'}",16558396,0,set(),3,"{'定价', '现金', '12'}",19,"{'159999969.1', '143545974', '芜湖弘唯基石创业投资合伙企业(有限合伙)', '西安航天新能源产业基金投资有限公司', '现金', '2226900', '兴证证券资产管理有限公司', '2191688', '71772987', '12', '定价', '6205398', '70638104.24', '199999977.5', '深圳安鹏资本创新有限公司', '4453800', '4964318', '深圳远致富海七号投资企业(有限合伙)', '厦门市集美区产业投资有限公司'}"
20,"{'招商财富资产管理有限公司', '2799999997', '2119999997', '现金', '2199999998', '609418282', '上海六禾丁香投资中心(有限合伙)', '617119113', '2227799998', '上海理家盈贸易有限公司', '国华人寿保险股份有限公司', '775623268', '财通基金管理有限公司', '1544399999', '1499999999', '华安资产管理(香港)有限公司', '427811634', '415512465', '36', '587257617'}",905410,3,"{'1499999999', '2227799998', '1544399999'}",6,"{'招商财富资产管理有限公司', '现金', '上海理家盈贸易有限公司', '国华人寿保险股份有限公司', '财通基金管理有限公司', '36'}",17,"{'招商财富资产管理有限公司', '2799999997', '2119999997', '现金', '2199999998', '609418282', '上海六禾丁香投资中心(有限合伙)', '617119113', '上海理家盈贸易有限公司', '国华人寿保险股份有限公司', '775623268', '财通基金管理有限公司', '华安资产管理(香港)有限公司', '427811634', '415512465', '36', '587257617'}"
16,"{'499999999.2', '招商财富资产管理有限公司', '192307693', '江信基金管理有限公司', '1499999998', '1000000004', '海通国际控股有限公司', '999999998.4', '96153846', '中国北方工业公司', '竞价', '中欧盛世资产管理(上海)有限公司', '288461538', '192307692', '华安未来资产管理(上海)有限公司', '12'}",1823054,5,"{'499999999.2', '1499999998', '1000000004', '竞价', '999999998.4'}",1,{'12'},11,"{'招商财富资产管理有限公司', '192307693', '江信基金管理有限公司', '海通国际控股有限公司', '96153846', '中国北方工业公司', '中欧盛世资产管理(上海)有限公司', '288461538', '192307692', '华安未来资产管理(上海)有限公司', '12'}"
5,"{'现金', '郭金东', '上海瀚叶财富管理顾问有限公司', '竞价', '36'}",1922248,1,{'竞价'},4,"{'现金', '36', '郭金东', '上海瀚叶财富管理顾问有限公司'}",4,"{'现金', '36', '郭金东', '上海瀚叶财富管理顾问有限公司'}"
18,"{'博时资本管理有限公司', '上海兴瀚资产管理有限公司', '217510259', '1015391705', '1559999995', '12', '定价', '138904474', '东方集团投资控股有限公司', '申万宏源证券有限公司', '339309850', '1589999993', '2057253300', '281430000', '创金合信基金管理有限公司', '36', '2480355004', '213406292'}",4923931,3,"{'1559999995', '1015391705', '2480355004'}",8,"{'36', '博时资本管理有限公司', '上海兴瀚资产管理有限公司', '定价', '东方集团投资控股有限公司', '申万宏源证券有限公司', '创金合信基金管理有限公司', '12'}",15,"{'博时资本管理有限公司', '上海兴瀚资产管理有限公司', '217510259', '12', '定价', '138904474', '东方集团投资控股有限公司', '申万宏源证券有限公司', '339309850', '1589999993', '2057253300', '281430000', '创金合信基金管理有限公司', '36', '213406292'}"
15,"{'8874000', '周叙元', '朱峰', '朱弘', '朱明', '常州高新技术产业开发区常能电器有限公司', '胡金花', '范沛菁', '金源苏', '522000', '周康直', '62640', '595080', '73080', '常州市泓丰投资管理有限公司'}",575606,5,"{'8874000', '522000', '62640', '595080', '73080'}",10,"{'周叙元', '朱弘', '朱明', '常州高新技术产业开发区常能电器有限公司', '胡金花', '范沛菁', '周康直', '金源苏', '朱峰', '常州市泓丰投资管理有限公司'}",10,"{'周叙元', '朱弘', '朱明', '常州高新技术产业开发区常能电器有限公司', '胡金花', '范沛菁', '周康直', '金源苏', '朱峰', '常州市泓丰投资管理有限公司'}"
8,"{'现金', '喜临门2015年度第一期员工持股计划', '1140000000', '1040000000', '华易投资', '74272451', '36', '81414033'}",2282118,2,"{'1040000000', '1140000000'}",4,"{'现金', '喜临门2015年度第一期员工持股计划', '36', '华易投资'}",6,"{'现金', '喜临门2015年度第一期员工持股计划', '华易投资', '74272451', '36', '81414033'}"
15,"{'现金', '邦信资产管理有限公司', '162000000', '新华人寿保险股份有限公司', '1260000', '4000000', '天津凯石益盛股权投资基金合伙企业(有限合伙', '90000000', '7200000', '28350000', '竞价', '北京淳信资本管理有限公司', '上海景贤投资有限公司', '12', '江苏开元国际集团轻工业品进出口股份有限公司'}",1276455,4,"{'28350000', '竞价', '1260000', '162000000'}",7,"{'现金', '邦信资产管理有限公司', '新华人寿保险股份有限公司', '北京淳信资本管理有限公司', '上海景贤投资有限公司', '12', '江苏开元国际集团轻工业品进出口股份有限公司'}",11,"{'现金', '邦信资产管理有限公司', '新华人寿保险股份有限公司', '4000000', '天津凯石益盛股权投资基金合伙企业(有限合伙', '90000000', '7200000', '北京淳信资本管理有限公司', '上海景贤投资有限公司', '12', '江苏开元国际集团轻工业品进出口股份有限公司'}"
14,"{'现金', '86160000', '18309000', '福建盈科创业投资有限公司', '林汝捷', '60312000', '183090000', '赵建光', '16155000', '郑志树', '陈胜', '陈存忠', '36', '66774000'}",349230,6,"{'86160000', '60312000', '16155000', '183090000', '66774000', '18309000'}",8,"{'现金', '福建盈科创业投资有限公司', '林汝捷', '赵建光', '郑志树', '陈胜', '陈存忠', '36'}",8,"{'现金', '福建盈科创业投资有限公司', '林汝捷', '赵建光', '郑志树', '陈胜', '陈存忠', '36'}"
18,"{'98674067', '中民投资本管理有限公司', '30835646', '上海国和现代服务业股权投资基金合伙企业(有限合伙)', '24668516', '交银文化(上海)股权投资基金合伙企业(有限合伙)', '长江养老保险股份有限公司', '上海上汽投资中心(有限合伙)', '定价', '招商基金管理有限公司', '15417823', '绿地金融投资控股集团有限公司', '上海文广投资管理中心(有限合伙)', '上海光控股权投资管理有限公司', '37002775', '国开金融有限责任公司', '36', '18501387'}",1643460,0,set(),7,"{'中民投资本管理有限公司', '绿地金融投资控股集团有限公司', '定价', '招商基金管理有限公司', '长江养老保险股份有限公司', '上海光控股权投资管理有限公司', '国开金融有限责任公司'}",18,"{'98674067', '中民投资本管理有限公司', '30835646', '上海国和现代服务业股权投资基金合伙企业(有限合伙)', '24668516', '交银文化(上海)股权投资基金合伙企业(有限合伙)', '长江养老保险股份有限公司', '上海上汽投资中心(有限合伙)', '定价', '招商基金管理有限公司', '15417823', '绿地金融投资控股集团有限公司', '上海文广投资管理中心(有限合伙)', '上海光控股权投资管理有限公司', '37002775', '国开金融有限责任公司', '36', '18501387'}"
55,"{'吴俊雄', '9513357', '将乐县速丰投资中心(有限合伙)', '12637841', '连巧灵', '王振阁', '林金亮', '林宇', '5712677', '1049267', '福建泰盛实业有限公司', '李志杰', '郑建华', '17487788', '62722866', '林若毅', '16321935', '5945848', '陈建煌', '李德国', '何旗', '莆田市荔城区吉顺投资中心(有限合伙)', '9909747', '7904480', '林金玉', '潘金堂', '2798046', '23317051', '12894329', '2518241', '胡娟', '6995115', '1155014016', '11658525', '吴丽萍', '林宗潘', '黄丽晖', '4663410', '邱建新', '12824378', '林耀祥', '黄光宪', '19236567', '姜秀梅', '柯文煌', '1165853', '21288467', '林文新', '莆田市荔城区泰安投资中心(有限合伙)', '何桂红', '2751412', '莆田市荔城区众诚投资中心(有限合伙)', '36', '122414516', '5829263'}",1123509,0,set(),12,"{'36', '李志杰', '姜秀梅', '林若毅', '柯文煌', '连巧灵', '吴丽萍', '林宗潘', '胡娟', '福建泰盛实业有限公司', '林金亮', '邱建新'}",55,"{'吴俊雄', '9513357', '将乐县速丰投资中心(有限合伙)', '12637841', '连巧灵', '王振阁', '林金亮', '林宇', '5712677', '1049267', '福建泰盛实业有限公司', '李志杰', '郑建华', '17487788', '62722866', '林若毅', '16321935', '5945848', '陈建煌', '李德国', '何旗', '莆田市荔城区吉顺投资中心(有限合伙)', '9909747', '7904480', '林金玉', '潘金堂', '2798046', '23317051', '12894329', '2518241', '胡娟', '6995115', '1155014016', '11658525', '吴丽萍', '林宗潘', '黄丽晖', '4663410', '邱建新', '12824378', '林耀祥', '黄光宪', '19236567', '姜秀梅', '柯文煌', '1165853', '21288467', '林文新', '莆田市荔城区泰安投资中心(有限合伙)', '何桂红', '2751412', '莆田市荔城区众诚投资中心(有限合伙)', '36', '122414516', '5829263'}"
12,"{'12870000', '平安大华基金管理有限公司', '22310000', '广发证券资产管理(广东)有限公司', '7000000', '财通基金管理有限公司', '上海证大投资管理有限公司', '竞价', '14450000', '6370000', '12', '泓德基金管理有限公司'}",1851812,4,"{'12870000', '6370000', '7000000', '14450000'}",6,"{'平安大华基金管理有限公司', '财通基金管理有限公司', '上海证大投资管理有限公司', '竞价', '12', '泓德基金管理有限公司'}",8,"{'平安大华基金管理有限公司', '22310000', '广发证券资产管理(广东)有限公司', '财通基金管理有限公司', '上海证大投资管理有限公司', '竞价', '12', '泓德基金管理有限公司'}"
11,"{'15455950', '杜宣', '民生加银基金管理有限公司', '创金合信基金管理有限公司', '23183925', '5873263', '竞价', '15069551', '中铁宝盈资产管理有限公司', '华融证券股份有限公司', '12'}",14248925,1,{'竞价'},6,"{'杜宣', '民生加银基金管理有限公司', '创金合信基金管理有限公司', '中铁宝盈资产管理有限公司', '华融证券股份有限公司', '12'}",10,"{'15455950', '杜宣', '民生加银基金管理有限公司', '创金合信基金管理有限公司', '23183925', '5873263', '15069551', '中铁宝盈资产管理有限公司', '华融证券股份有限公司', '12'}"
5,"{'现金', '四川长虹电器股份有限公司', '竞价', '300000000', '36'}",1244318,1,{'300000000'},4,"{'四川长虹电器股份有限公司', '竞价', '现金', '36'}",4,"{'四川长虹电器股份有限公司', '竞价', '现金', '36'}"
5,"{'现金', '航天投资', '上航工业', '竞价', '36'}",1667216,0,set(),5,"{'现金', '航天投资', '上航工业', '竞价', '36'}",5,"{'现金', '航天投资', '上航工业', '竞价', '36'}"
5,"{'现金', '253550000', '31225369', '横店控股', '36'}",1922474,0,set(),3,"{'现金', '36', '横店控股'}",5,"{'现金', '253550000', '31225369', '横店控股', '36'}"
18,"{'金鹰基金管理有限公司', '217799986.8', '上海航翠投资管理合伙企业(有限合伙)', '36', '551399996.6', '12053126', '9961261', '28843388', '财通基金管理有限公司', '521200021.2', '30514665', '竞价', '安信基金管理有限责任公司', '367599997.7', '179999986.3', '20343110', '山东如意科技集团有限公司', '12'}",12032406,4,"{'521200021.2', '竞价', '179999986.3', '551399996.6'}",6,"{'金鹰基金管理有限公司', '12', '财通基金管理有限公司', '安信基金管理有限责任公司', '山东如意科技集团有限公司', '36'}",14,"{'金鹰基金管理有限公司', '217799986.8', '上海航翠投资管理合伙企业(有限合伙)', '36', '12053126', '9961261', '28843388', '财通基金管理有限公司', '30514665', '安信基金管理有限责任公司', '367599997.7', '20343110', '山东如意科技集团有限公司', '12'}"
22,"{'北京弘高慧目投资有限公司', '6056935', '850000000', '12113870', '金鹰基金管理有限公司拟设立的资产管理计划', '200000000', '18170805', '现金', '400000000', '三亚新沃豪泰投资管理中心(有限合伙)', '9085402', '24227740', '竞价', '300000000', '150000000', '北京普临投资集团有限公司', '宁波厚扬方泰股权投资中心(有限合伙)', '51483949', '深圳前海宝盛伟业投资管理有限公司', '100000000', '朱登营', '36'}",1879314,11,"{'51483949', '150000000', '100000000', '6056935', '9085402', '24227740', '850000000', '竞价', '12113870', '300000000', '18170805'}",8,"{'深圳前海宝盛伟业投资管理有限公司', '现金', '北京弘高慧目投资有限公司', '北京普临投资集团有限公司', '金鹰基金管理有限公司拟设立的资产管理计划', '朱登营', '200000000', '36'}",11,"{'深圳前海宝盛伟业投资管理有限公司', '现金', '400000000', '北京弘高慧目投资有限公司', '三亚新沃豪泰投资管理中心(有限合伙)', '北京普临投资集团有限公司', '宁波厚扬方泰股权投资中心(有限合伙)', '金鹰基金管理有限公司拟设立的资产管理计划', '朱登营', '200000000', '36'}"
8,"{'梅小明', '定价', '199999990.9', '17605636', '上海宣浦股权投资基金合伙企业', '17605633', '36', '200000025'}",2117425,2,"{'199999990.9', '200000025'}",4,"{'定价', '梅小明', '上海宣浦股权投资基金合伙企业', '36'}",6,"{'梅小明', '定价', '17605636', '上海宣浦股权投资基金合伙企业', '17605633', '36'}"
15,"{'现金', '湘潭电化集团有限公司', '12', '66011400', '2176635', '2000000', '42509682', '上海莱乐客投资管理合伙企业(有限合伙)', '竞价', '3380000', '上海建铮投资管理有限公司', '博弘数君(天津)股权投资基金合伙企业(有限合伙', '中海基金管理有限公司', '36', '39060000'}",1257922,0,set(),5,"{'现金', '湘潭电化集团有限公司', '12', '竞价', '36'}",15,"{'现金', '湘潭电化集团有限公司', '12', '66011400', '2176635', '2000000', '42509682', '上海莱乐客投资管理合伙企业(有限合伙)', '竞价', '3380000', '上海建铮投资管理有限公司', '博弘数君(天津)股权投资基金合伙企业(有限合伙', '中海基金管理有限公司', '36', '39060000'}"
6,"{'现金', '其他特定投资者', '12', '竞价', '荆州市科达商贸投资有限公司', '36'}",14757149,0,set(),6,"{'现金', '其他特定投资者', '12', '竞价', '荆州市科达商贸投资有限公司', '36'}",6,"{'现金', '其他特定投资者', '12', '竞价', '荆州市科达商贸投资有限公司', '36'}"
15,"{'现金', '199999996.6', '166499999.8', '13413816', '张霞', '11167002', '19999990.71', '竞价', '侯文奇', '顾庆伟', '幸建平', '24999999.57', '1341381', '36', '1676727'}",16435881,4,"{'19999990.71', '竞价', '199999996.6', '24999999.57'}",6,"{'现金', '张霞', '侯文奇', '顾庆伟', '幸建平', '36'}",11,"{'现金', '166499999.8', '13413816', '张霞', '11167002', '侯文奇', '顾庆伟', '幸建平', '1341381', '36', '1676727'}"
3,"{'上海同盛投资(集团)有限公司', '1764379518', '36'}",1462636,0,set(),1,{'36'},3,"{'上海同盛投资(集团)有限公司', '1764379518', '36'}"
7,"{'207545680', '现金', '宁波开发投资', '158462192', '竞价', '华侨银行', '36'}",347804,3,"{'207545680', '竞价', '158462192'}",4,"{'华侨银行', '宁波开发投资', '现金', '36'}",4,"{'华侨银行', '现金', '宁波开发投资', '36'}"
4,"{'36', '竞价', '现金', '荆州市科达商贸投资有限公司'}",2359329,0,set(),4,"{'36', '竞价', '现金', '荆州市科达商贸投资有限公司'}",4,"{'36', '竞价', '现金', '荆州市科达商贸投资有限公司'}"
4,"{'浙江省铁路投资集团有限公司', '竞价', '现金', '36'}",1117514,0,set(),4,"{'浙江省铁路投资集团有限公司', '竞价', '现金', '36'}",4,"{'浙江省铁路投资集团有限公司', '竞价', '现金', '36'}"
9,"{'现金', '619802023', '招融投资', '505951852', '竞价', '河北港口', '225127284', '中远集团', '36'}",905778,3,"{'225127284', '505951852', '619802023'}",6,"{'现金', '招融投资', '竞价', '河北港口', '中远集团', '36'}",6,"{'现金', '招融投资', '竞价', '河北港口', '中远集团', '36'}"
4,"{'49900233', '现金', '36', '南方同正'}",676182,1,{'49900233'},3,"{'现金', '36', '南方同正'}",3,"{'现金', '36', '南方同正'}"
15,"{'现金', '嘉华优选', '嘉华成美', '8695652', '定价', '4000000', '九泰基金拟设立的资产管理计划', '上海原龙', '民生加银拟设立的资产管理计划', '13043478', '39478260', '21739130', '建投投资', '36', '管理团队拟设立的合伙企业'}",1675913,5,"{'8695652', '4000000', '13043478', '39478260', '21739130'}",10,"{'现金', '嘉华优选', '嘉华成美', '定价', '九泰基金拟设立的资产管理计划', '上海原龙', '民生加银拟设立的资产管理计划', '建投投资', '36', '管理团队拟设立的合伙企业'}",10,"{'现金', '嘉华优选', '嘉华成美', '定价', '九泰基金拟设立的资产管理计划', '上海原龙', '民生加银拟设立的资产管理计划', '建投投资', '36', '管理团队拟设立的合伙企业'}"
8,"{'现金', '方振淳', '西藏瑞华资本管理有限公司', '竞价', '鲲鹏资本—中瑞思创定增1号证券投资基金', '10000000', '200000000', '36'}",2370802,1,{'竞价'},5,"{'现金', '方振淳', '西藏瑞华资本管理有限公司', '鲲鹏资本—中瑞思创定增1号证券投资基金', '36'}",7,"{'现金', '方振淳', '西藏瑞华资本管理有限公司', '鲲鹏资本—中瑞思创定增1号证券投资基金', '10000000', '200000000', '36'}"
4,"{'36', '上海建工员工持股计划', '1259479998', '350830083'}",15752071,1,{'1259479998'},2,"{'上海建工员工持股计划', '36'}",3,"{'36', '上海建工员工持股计划', '350830083'}"
13,"{'69899989.5', '56400055.29', '北信瑞丰基金管理有限公司', '80899986.96', '中融基金管理有限公司', '2027850', '财通基金管理有限公司', '3988975', '2346968', '137499968.3', '鹏华资产管理(深圳)有限公司', '12', '1636207'}",14704710,3,"{'137499968.3', '56400055.29', '80899986.96'}",1,{'12'},10,"{'69899989.5', '北信瑞丰基金管理有限公司', '中融基金管理有限公司', '2027850', '财通基金管理有限公司', '3988975', '2346968', '鹏华资产管理(深圳)有限公司', '12', '1636207'}"
11,"{'15249714', '现金', '景和道', '7624857', '11437285', '青尚股权', '3812428', '深圳鼎江', '宁波中汇', '36', '深圳平湖'}",15813200,0,set(),7,"{'36', '现金', '景和道', '青尚股权', '宁波中汇', '深圳鼎江', '深圳平湖'}",11,"{'15249714', '现金', '景和道', '7624857', '11437285', '青尚股权', '3812428', '深圳鼎江', '宁波中汇', '36', '深圳平湖'}"
13,"{'现金', '3333333', '兴业财富资产管理有限公司', '定价', '财通基金管理有限公司', '易方达基金管理有限公司', '中信建投基金管理有限公司', '3743589', '3846153', '102566', '华富基金管理有限公司', '15384615', '12'}",1666779,0,set(),8,"{'现金', '兴业财富资产管理有限公司', '定价', '财通基金管理有限公司', '易方达基金管理有限公司', '中信建投基金管理有限公司', '华富基金管理有限公司', '12'}",13,"{'现金', '3333333', '兴业财富资产管理有限公司', '定价', '财通基金管理有限公司', '易方达基金管理有限公司', '中信建投基金管理有限公司', '3743589', '3846153', '102566', '华富基金管理有限公司', '15384615', '12'}"
2,"{'36', '江苏双良科技有限公司'}",954798,1,{'36'},1,{'江苏双良科技有限公司'},1,{'江苏双良科技有限公司'}
16,"{'华融证券股份有限公司浙江浙银资本管理有限公司', '现金', '31666666', '63333333', '759999996', '天津信祥企业管理合伙企业(有限合伙)', '杭州中大君悦投资有限公司', '金元顺安基金管理有限公司', '竞价', '中信证券股份有限公司', '63333336', '760000032', '华安未来资产管理(上海)有限公司', '12', '379999992', '浙江浙银资本管理有限公司'}",15032548,1,{'竞价'},6,"{'现金', '杭州中大君悦投资有限公司', '金元顺安基金管理有限公司', '中信证券股份有限公司', '12', '浙江浙银资本管理有限公司'}",15,"{'华融证券股份有限公司浙江浙银资本管理有限公司', '现金', '31666666', '63333333', '759999996', '天津信祥企业管理合伙企业(有限合伙)', '杭州中大君悦投资有限公司', '金元顺安基金管理有限公司', '中信证券股份有限公司', '63333336', '760000032', '华安未来资产管理(上海)有限公司', '12', '379999992', '浙江浙银资本管理有限公司'}"
3,"{'豫联集团', '现金', '36'}",1189260,0,set(),3,"{'豫联集团', '现金', '36'}",3,"{'豫联集团', '现金', '36'}"
4,"{'竞价', '罗邦毅', '50000000', '36'}",12047101,1,{'50000000'},3,"{'竞价', '罗邦毅', '36'}",3,"{'竞价', '罗邦毅', '36'}"
5,"{'现金', '定价', '景德镇井冈山北汽创新发展投资中心(有限合伙)', '120000000', '36'}",9268597,2,"{'120000000', '景德镇井冈山北汽创新发展投资中心(有限合伙)'}",3,"{'现金', '定价', '36'}",3,"{'定价', '现金', '36'}"
6,"{'现金', '太仓德源投资管理中心(有限合伙)', '江门市君合投资有限公司', '54347826', '36', '67934782'}",1102829,3,"{'54347826', '太仓德源投资管理中心(有限合伙)', '67934782'}",3,"{'现金', '36', '江门市君合投资有限公司'}",3,"{'现金', '36', '江门市君合投资有限公司'}"
31,"{'20000000', '泽熙增煦', '643008000', '悦达泰和', '45000000', '354600000', '现金', '81760000', '593364000', '信实资产成立并管理的信实长期价值1号基金', '竞价', '千石资本成立并管理的千石资本-盈海定增资产管理计划', '一龙伟业', '普临投资', '博龙基金', '118200000', '157600000', '华宝兴业成立并管理的华宝兴业星通定增十号专户', '197000000', '英纳威投资', '15000000', '89359200', '81600000', '25000000', '11340000', '370360000', '75300000', '47000000', '644268800', '黄伟江', '36'}",1662413,19,"{'644268800', '354600000', '643008000', '81760000', '593364000', '15000000', '89359200', '信实资产成立并管理的信实长期价值1号基金', '千石资本成立并管理的千石资本-盈海定增资产管理计划', '81600000', '竞价', '25000000', '75300000', '47000000', '11340000', '118200000', '157600000', '370360000', '197000000'}",10,"{'现金', '泽熙增煦', '悦达泰和', '英纳威投资', '华宝兴业成立并管理的华宝兴业星通定增十号专户', '一龙伟业', '普临投资', '博龙基金', '黄伟江', '36'}",12,"{'20000000', '现金', '泽熙增煦', '悦达泰和', '英纳威投资', '华宝兴业成立并管理的华宝兴业星通定增十号专户', '一龙伟业', '普临投资', '博龙基金', '黄伟江', '36', '45000000'}"
18,"{'广发证券资产管理(广东)有限公司', '招商财富资产管理有限公司', '现金', '新沃基金管理有限公司', '安信证券股份有限公司', '开源证券股份有限公司', '招商证券资产管理有限公司', '华福基金管理有限责任公司', '中信建投基金管理有限公司', '竞价', '中信证券股份有限公司', '申万菱信基金管理有限公司', '405027932', '363128491', '418994413', '825055865', '12', '460893854'}",14630341,1,{'竞价'},2,"{'现金', '12'}",17,"{'广发证券资产管理(广东)有限公司', '招商财富资产管理有限公司', '现金', '新沃基金管理有限公司', '安信证券股份有限公司', '开源证券股份有限公司', '招商证券资产管理有限公司', '华福基金管理有限责任公司', '中信建投基金管理有限公司', '中信证券股份有限公司', '申万菱信基金管理有限公司', '405027932', '363128491', '418994413', '825055865', '12', '460893854'}"
3,"{'鑫茂集团', '36', '75000000'}",580484,1,{'75000000'},2,"{'鑫茂集团', '36'}",2,"{'鑫茂集团', '36'}"
16,"{'北京航天产业投资基金(有限合伙)', '139999990.4', '现金', '6303883', '鹏华基金增发精选1号资产管理计划', '定价', '8749466', '北京泰宇德鸿投资中心(有限合伙)', '汇添富-衡水老白干酒员工持股资产管理计划', '汇添富-定增盛世添富牛37号资产管理计划', '204999988.4', '127599990.9', '5975245', '36', '147699978.7', '5446009'}",1837056,4,"{'204999988.4', '139999990.4', '127599990.9', '147699978.7'}",3,"{'定价', '现金', '36'}",12,"{'北京航天产业投资基金(有限合伙)', '现金', '6303883', '定价', '8749466', '北京泰宇德鸿投资中心(有限合伙)', '汇添富-衡水老白干酒员工持股资产管理计划', '汇添富-定增盛世添富牛37号资产管理计划', '鹏华基金增发精选1号资产管理计划', '5975245', '36', '5446009'}"
3,"{'地产集团', '竞价', '36'}",488786,0,set(),3,"{'地产集团', '竞价', '36'}",3,"{'地产集团', '竞价', '36'}"
15,"{'3060000', '67116816', '264934800', '现金', '理成殷睿', '100432800', '欣利睿投资(筹)', '6944800', '润达惠员工持股1号', '775200', '九江昊诚', '1160000', '601280784', '东营东创', '36'}",1850491,0,set(),6,"{'现金', '理成殷睿', '润达惠员工持股1号', '九江昊诚', '东营东创', '36'}",15,"{'3060000', '67116816', '264934800', '现金', '理成殷睿', '100432800', '欣利睿投资(筹)', '6944800', '润达惠员工持股1号', '775200', '九江昊诚', '1160000', '601280784', '东营东创', '36'}"
23,"{'15620000', '4000000', '3000000', '31240000', '200000000', '30729833', '24327784', '李超', '上元投资', '定价', '7103393', '240000000', '55477500', '夏传武', '王杏才', '190000000', '2000000', '25608194', '23430000', '聚睿投资', '中科祥瑞', '王卫', '36'}",10802646,6,"{'15620000', '240000000', '190000000', '23430000', '31240000', '55477500'}",9,"{'李超', '上元投资', '定价', '聚睿投资', '中科祥瑞', '夏传武', '王卫', '36', '王杏才'}",17,"{'24327784', '7103393', '王杏才', '李超', '上元投资', '4000000', '定价', '2000000', '25608194', '3000000', '聚睿投资', '中科祥瑞', '夏传武', '王卫', '200000000', '36', '30729833'}"
15,"{'中车金证投资有限公司', '现金', '199999986.5', '319999978.3', '九泰基金管理有限公司', '中融基金管理有限公司', '长城(天津)股权投资基金管理有限责任公司', '179999998.7', '定价', '易方达基金管理有限公司', '100629348.4', '177999991.2', '福建省创新电子信息产业投资发展有限公司', '12', '599999981.1'}",16726256,4,"{'179999998.7', '199999986.5', '100629348.4', '599999981.1'}",8,"{'中车金证投资有限公司', '现金', '九泰基金管理有限公司', '中融基金管理有限公司', '定价', '易方达基金管理有限公司', '福建省创新电子信息产业投资发展有限公司', '12'}",11,"{'中车金证投资有限公司', '现金', '319999978.3', '九泰基金管理有限公司', '中融基金管理有限公司', '长城(天津)股权投资基金管理有限责任公司', '定价', '易方达基金管理有限公司', '177999991.2', '福建省创新电子信息产业投资发展有限公司', '12'}"
5,"{'现金', '定价', 'KKR Poultry Investment S.àr.l.', '200000000', '36'}",370604,2,"{'200000000', 'KKR Poultry Investment S.àr.l.'}",3,"{'定价', '现金', '36'}",3,"{'现金', '定价', '36'}"
11,"{'北信瑞丰基金管理有限公司', '4708098', '100000000', '郭仁祥', '兴证资管鑫众—吉艾科技1号定向资产管理计划', '41431262', '9416195', '50000000', '440000000', '南通元鼎投资有限公司', '36'}",1900899,1,{'440000000'},4,"{'郭仁祥', '南通元鼎投资有限公司', '北信瑞丰基金管理有限公司', '36'}",10,"{'北信瑞丰基金管理有限公司', '4708098', '100000000', '郭仁祥', '兴证资管鑫众—吉艾科技1号定向资产管理计划', '41431262', '9416195', '50000000', '南通元鼎投资有限公司', '36'}"
11,"{'13837300', '江苏瑞华投资发展有限公司', '华夏基金管理有限公司', '9632700', '7400000', '12', '15000000', '竞价', '南京医药集团有限责任公司', '36', '刘少华'}",1333921,2,"{'竞价', '13837300'}",6,"{'36', '江苏瑞华投资发展有限公司', '华夏基金管理有限公司', '南京医药集团有限责任公司', '12', '刘少华'}",9,"{'江苏瑞华投资发展有限公司', '华夏基金管理有限公司', '9632700', '7400000', '12', '15000000', '南京医药集团有限责任公司', '36', '刘少华'}"
21,"{'173250000', '320000', '15750000', '现金', '5040000', '11000000', '竞价', '36', '张新学', '黄伟波', '上海国药圣礼投资管理合伙企业(有限合伙)', '平安资产管理有限责任公司', '53235000', '6300000', '嘉兴品松投资合伙企业(有限合伙)', '204750000', '13000000', '99225000', '1000000', '3380000', '陈彪'}",332027,10,"{'5040000', '53235000', '173250000', '99225000', '11000000', '竞价', '320000', '15750000', '3380000', '204750000'}",6,"{'张新学', '现金', '黄伟波', '平安资产管理有限责任公司', '36', '陈彪'}",11,"{'张新学', '现金', '黄伟波', '13000000', '上海国药圣礼投资管理合伙企业(有限合伙)', '平安资产管理有限责任公司', '6300000', '1000000', '嘉兴品松投资合伙企业(有限合伙)', '36', '陈彪'}"
9,"{'2300000000', '现金', '定价', '1500000000', '建信基金管理有限责任公司', '200000000', '上海北信瑞丰资产管理有限公司', '36', '杭州盘江汇智投资合伙企业'}",1819870,3,"{'2300000000', '200000000', '1500000000'}",6,"{'现金', '定价', '建信基金管理有限责任公司', '上海北信瑞丰资产管理有限公司', '36', '杭州盘江汇智投资合伙企业'}",6,"{'现金', '定价', '建信基金管理有限责任公司', '上海北信瑞丰资产管理有限公司', '36', '杭州盘江汇智投资合伙企业'}"
18,"{'内蒙蒙牛', '现金', '于航', '樊祥杰', '6361323', '100000000', '定价', '久泰投资', '李伟', '马伯乐', '220000000', '50000000', '108214784', '850568200', '柴琇', '36', '12722646', '27989822'}",4938577,4,"{'850568200', '220000000', '50000000', '100000000'}",10,"{'内蒙蒙牛', '现金', '于航', '樊祥杰', '定价', '久泰投资', '李伟', '马伯乐', '柴琇', '36'}",14,"{'内蒙蒙牛', '现金', '于航', '樊祥杰', '6361323', '定价', '久泰投资', '李伟', '马伯乐', '108214784', '柴琇', '36', '12722646', '27989822'}"
24,"{'1918265', '1417848', '深圳天风天成资产管理有限公司', '1946066', '任思龙', '29999987.16', '1390047', '834028', '50999992.56', '财通基金管理有限公司', '竞价', '2502085', '36', '89999997.45', '常州市新发展实业公司', '49999990.59', '69999994.02', '江苏虎甲投资有限公司', '九泰基金管理有限公司', '68999992.05', '徐海英', '叶本瑜', '12', '卢生江'}",2187945,0,set(),12,"{'36', '卢生江', '九泰基金管理有限公司', '深圳天风天成资产管理有限公司', '常州市新发展实业公司', '财通基金管理有限公司', '任思龙', '竞价', '徐海英', '叶本瑜', '12', '江苏虎甲投资有限公司'}",24,"{'1918265', '1417848', '深圳天风天成资产管理有限公司', '1946066', '任思龙', '29999987.16', '1390047', '834028', '50999992.56', '财通基金管理有限公司', '竞价', '2502085', '36', '89999997.45', '常州市新发展实业公司', '49999990.59', '69999994.02', '江苏虎甲投资有限公司', '九泰基金管理有限公司', '68999992.05', '徐海英', '叶本瑜', '12', '卢生江'}"
4,"{'竞价', '中国华电集团公司', '现金', '72'}",1101634,1,{'竞价'},3,"{'中国华电集团公司', '现金', '72'}",3,"{'中国华电集团公司', '现金', '72'}"
8,"{'113711963', '4058549', '建龙集团', '定价', '钧能实业', '107928537', '佳电厂', '36'}",917948,3,"{'113711963', '4058549', '定价'}",4,"{'钧能实业', '佳电厂', '建龙集团', '36'}",5,"{'建龙集团', '钧能实业', '107928537', '佳电厂', '36'}"
17,"{'12285012', '现金', '德威德佳', '100000000', '员工持股计划', '刘以林', '6142506', '李家权', '湘投高科', '9828009', '50000000', '唐人神控股', '温氏投资', '陈枝', '大生行', '80000000', '36'}",314953,0,set(),11,"{'36', '现金', '员工持股计划', '刘以林', '李家权', '陈枝', '温氏投资', '唐人神控股', '大生行', '湘投高科', '德威德佳'}",17,"{'12285012', '现金', '德威德佳', '100000000', '员工持股计划', '刘以林', '6142506', '李家权', '湘投高科', '9828009', '50000000', '唐人神控股', '温氏投资', '陈枝', '大生行', '80000000', '36'}"
4,"{'36', '竞价', '现金', '横店集团控股有限公司'}",1110160,0,set(),4,"{'36', '竞价', '现金', '横店集团控股有限公司'}",4,"{'36', '竞价', '现金', '横店集团控股有限公司'}"
21,"{'2896872', '硕嘉投资', '江苏聚合投资', '11587578', '3476273', '200001600', '美福景', '现金', '331947315', '天堂硅谷乐通', '60000480', '125000000', '50000013', '19232173', '长城基金', '聚网投资', '7242178', '3363267', '响道投资', '58050000', '36'}",1562061,0,set(),9,"{'现金', '响道投资', '天堂硅谷乐通', '硕嘉投资', '江苏聚合投资', '美福景', '长城基金', '36', '聚网投资'}",21,"{'2896872', '硕嘉投资', '江苏聚合投资', '11587578', '3476273', '200001600', '美福景', '现金', '331947315', '天堂硅谷乐通', '60000480', '125000000', '50000013', '19232173', '长城基金', '聚网投资', '7242178', '3363267', '响道投资', '58050000', '36'}"
6,"{'现金', '天邦投资', '100000000', '竞价', '36', '兵团国资公司'}",14999236,1,{'100000000'},5,"{'现金', '天邦投资', '竞价', '36', '兵团国资公司'}",5,"{'现金', '天邦投资', '竞价', '36', '兵团国资公司'}"
3,"{'滨海控股', '现金', '36'}",224784,0,set(),3,"{'滨海控股', '现金', '36'}",3,"{'滨海控股', '现金', '36'}"
72,"{'25619539', '弘湾资本', '25583469', '14724345', '刘雯婧', '朱一波', '杭州博润', '220429643', '2767943', '蔡鉴', '珠峰基石', '20065994', '马刚', '8923845', '7585269', '727969', '3878529', '武汉华汇', '林启龙', '常州博润', '1373645', '李洁', '周晓璐', '华商盈通', '叶英', '楚商先锋', '吉彦平', '刘健', '1669921', '李宏清', '11154807', '国林投资', '1993132', '芜湖基石', '张傲', '杨其礼', '5386844', '15779411', '5535885', '操喜姣', '田三红', '襄阳博润', '36', '8457345', '葛亚君', '1346711', '王甫', '科华银赛', '1481383', '武汉光谷', '1616053', '李文甫', '19520912', '10773687', '申燕', '30974353', '2389065', '2230961', '11527846', '4461923', '远东控股', '22309614', '杨燕冰', '2558750', '李刚', '东方国润', '许望生', '李汉华', '15810386', '周正', '12', '郭志先'}",1817478,0,set(),41,"{'弘湾资本', '刘雯婧', '朱一波', '杭州博润', '蔡鉴', '珠峰基石', '马刚', '武汉华汇', '林启龙', '常州博润', '李洁', '华商盈通', '楚商先锋', '周晓璐', '叶英', '吉彦平', '刘健', '李宏清', '国林投资', '张傲', '芜湖基石', '科华银赛', '操喜姣', '田三红', '襄阳博润', '葛亚君', '36', '王甫', '武汉光谷', '李文甫', '申燕', '远东控股', '杨燕冰', '李刚', '东方国润', '许望生', '李汉华', '杨其礼', '周正', '12', '郭志先'}",72,"{'25619539', '弘湾资本', '25583469', '14724345', '刘雯婧', '朱一波', '杭州博润', '220429643', '2767943', '蔡鉴', '珠峰基石', '20065994', '马刚', '8923845', '7585269', '727969', '3878529', '武汉华汇', '林启龙', '常州博润', '1373645', '李洁', '周晓璐', '华商盈通', '叶英', '楚商先锋', '吉彦平', '刘健', '1669921', '李宏清', '11154807', '国林投资', '1993132', '芜湖基石', '张傲', '杨其礼', '5386844', '15779411', '5535885', '操喜姣', '田三红', '襄阳博润', '36', '8457345', '葛亚君', '1346711', '王甫', '科华银赛', '1481383', '武汉光谷', '1616053', '李文甫', '19520912', '10773687', '申燕', '30974353', '2389065', '2230961', '11527846', '4461923', '远东控股', '22309614', '杨燕冰', '2558750', '李刚', '东方国润', '许望生', '李汉华', '15810386', '周正', '12', '郭志先'}"
5,"{'现金', '65000000', '定价', '36', '巨人投资'}",448406,0,set(),4,"{'36', '定价', '现金', '巨人投资'}",5,"{'现金', '65000000', '定价', '36', '巨人投资'}"
3,"{'竞价', '36', '海南航空'}",1583424,0,set(),3,"{'竞价', '36', '海南航空'}",3,"{'竞价', '36', '海南航空'}"
9,"{'现金', '43530000', '2390216400', '竞价', '运通资管计划', '139290000', '746974800', '36', '广州无线电集团'}",1779633,3,"{'竞价', '2390216400', '746974800'}",4,"{'运通资管计划', '现金', '36', '广州无线电集团'}",6,"{'现金', '43530000', '运通资管计划', '139290000', '36', '广州无线电集团'}"
24,"{'91999994.88', '6289308', '吴天舒', '申万菱信(上海)资产管理有限公司', '7232704', '12327044', '申万菱信基金管理有限公司', '79999997.76', '129999990', '6194968', '10220125', '谢雄友', '9433962', '财通基金管理有限公司', '竞价', '华泰柏瑞基金管理有限公司', '恒泰证券股份有限公司', '78799992.96', '503147', '6400029.84', '第一创业证券股份有限公司', '156799999.7', '119999996.6', '12'}",1851832,6,"{'91999994.88', '156799999.7', '78799992.96', '竞价', '6400029.84', '79999997.76'}",8,"{'第一创业证券股份有限公司', '谢雄友', '恒泰证券股份有限公司', '吴天舒', '财通基金管理有限公司', '申万菱信基金管理有限公司', '12', '华泰柏瑞基金管理有限公司'}",18,"{'6194968', '10220125', '第一创业证券股份有限公司', '谢雄友', '6289308', '恒泰证券股份有限公司', '吴天舒', '119999996.6', '9433962', '财通基金管理有限公司', '申万菱信(上海)资产管理有限公司', '7232704', '12327044', '503147', '申万菱信基金管理有限公司', '129999990', '12', '华泰柏瑞基金管理有限公司'}"
15,"{'680000000', '杭州阿里创业投资有限公司', '现金', '51550544', '106603520', '定价', '平安资产管理有限责任公司', '61755799', '4293335', '中信建投证券股份有限公司', '1533396480', '1280000000', '27386226', '36', '深圳市腾讯计算机系统有限公司'}",314396,2,"{'51550544', '61755799'}",7,"{'杭州阿里创业投资有限公司', '现金', '定价', '平安资产管理有限责任公司', '中信建投证券股份有限公司', '36', '深圳市腾讯计算机系统有限公司'}",13,"{'680000000', '杭州阿里创业投资有限公司', '现金', '定价', '平安资产管理有限责任公司', '4293335', '中信建投证券股份有限公司', '1533396480', '1280000000', '27386226', '36', '106603520', '深圳市腾讯计算机系统有限公司'}"
11,"{'现金', '34013600', '京蓝控股', '上海衢富', '楼泰投资', '信诚投资', '25510200', '127551000', '17006800', '36', '盈创嘉业'}",297274,4,"{'127551000', '17006800', '34013600', '25510200'}",7,"{'36', '现金', '京蓝控股', '上海衢富', '楼泰投资', '信诚投资', '盈创嘉业'}",7,"{'现金', '京蓝控股', '上海衢富', '楼泰投资', '信诚投资', '36', '盈创嘉业'}"
3,"{'吴潮忠', '现金', '36'}",1090568,0,set(),3,"{'吴潮忠', '现金', '36'}",3,"{'吴潮忠', '现金', '36'}"
19,"{'28600000', '现金', '6600000', '华夏基金管理有限公司', '171600000', '广发证券股份有限公司', '西部证券股份有限公司', '1700000', '1100000', '易方达基金管理有限公司', '广发基金管理有限公司', '竞价', '1500000', '3000000', '中国人寿资产管理有限公司', '39000000', '12', '44200000', '78000000'}",1063110,7,"{'28600000', '6600000', '171600000', '3000000', '39000000', '44200000', '78000000'}",9,"{'现金', '华夏基金管理有限公司', '西部证券股份有限公司', '广发证券股份有限公司', '易方达基金管理有限公司', '广发基金管理有限公司', '竞价', '中国人寿资产管理有限公司', '12'}",12,"{'现金', '华夏基金管理有限公司', '1100000', '广发证券股份有限公司', '西部证券股份有限公司', '1700000', '易方达基金管理有限公司', '广发基金管理有限公司', '1500000', '竞价', '中国人寿资产管理有限公司', '12'}"
11,"{'99999999', '19526952', '定价', '354999987.4', '299999997', '5500550', '上海东方明珠新媒体股份有限公司', '东方点石投资管理有限公司-东方点钻-东兴礡璞3号投资基金', '16501650', '同方股份有限公司', '36'}",14396127,1,{'354999987.4'},4,"{'定价', '上海东方明珠新媒体股份有限公司', '36', '同方股份有限公司'}",10,"{'99999999', '19526952', '定价', '299999997', '5500550', '上海东方明珠新媒体股份有限公司', '东方点石投资管理有限公司-东方点钻-东兴礡璞3号投资基金', '16501650', '同方股份有限公司', '36'}"
9,"{'芜湖基石股权投资基金(有限合伙)', '现金', '138119502', '999985194.5', '定价', '199982396.7', '27621878', '新华联控股有限公司', '36'}",16940738,1,{'999985194.5'},3,"{'定价', '现金', '36'}",8,"{'芜湖基石股权投资基金(有限合伙)', '现金', '138119502', '定价', '199982396.7', '27621878', '新华联控股有限公司', '36'}"
5,"{'现金', '金世旗控股', '竞价', '45380000', '36'}",716341,1,{'45380000'},4,"{'金世旗控股', '现金', '竞价', '36'}",4,"{'金世旗控股', '现金', '竞价', '36'}"
17,"{'中信证券国际投资管理(香港)有限公司', '301930000', '兴业全球基金管理有限公司', '26300522', '10017421', '20017421', '东海基金管理有限责任公司', '财通基金管理有限公司', '23465159', '竞价', '26199477', '施侃', '287000000', '115000000', '300770000', '12', '229800000'}",535716,6,"{'301930000', '竞价', '287000000', '115000000', '300770000', '229800000'}",5,"{'兴业全球基金管理有限公司', '东海基金管理有限责任公司', '财通基金管理有限公司', '施侃', '12'}",11,"{'中信证券国际投资管理(香港)有限公司', '兴业全球基金管理有限公司', '26300522', '10017421', '20017421', '东海基金管理有限责任公司', '财通基金管理有限公司', '23465159', '26199477', '施侃', '12'}"
5,"{'现金', '竞价', '14234364', '小康控股', '36'}",15558012,2,"{'竞价', '14234364'}",3,"{'现金', '小康控股', '36'}",3,"{'现金', '小康控股', '36'}"
6,"{'150000000', '现金', '吉林化纤集团有限责任公司', '60000000', '竞价', '36'}",1200498,2,"{'150000000', '60000000'}",4,"{'吉林化纤集团有限责任公司', '竞价', '现金', '36'}",4,"{'吉林化纤集团有限责任公司', '竞价', '现金', '36'}"
5,"{'现金', '定价', '中国普天信息产业股份有限公司', '77300000', '36'}",1112809,0,set(),4,"{'中国普天信息产业股份有限公司', '定价', '现金', '36'}",5,"{'现金', '定价', '中国普天信息产业股份有限公司', '77300000', '36'}"
15,"{'3060000', '67116816', '264934800', '现金', '理成殷睿', '欣利睿投资', '100432800', '6944800', '润达惠员工持股1号', '775200', '九江昊诚', '1160000', '601280784', '东营东创', '36'}",2044352,0,set(),7,"{'现金', '理成殷睿', '欣利睿投资', '润达惠员工持股1号', '九江昊诚', '东营东创', '36'}",15,"{'3060000', '67116816', '264934800', '现金', '理成殷睿', '欣利睿投资', '100432800', '6944800', '润达惠员工持股1号', '775200', '九江昊诚', '1160000', '601280784', '东营东创', '36'}"
5,"{'4977242', '汇康资产管理计划', '康缘集团', '9954330', '36'}",389333,2,"{'4977242', '9954330'}",3,"{'36', '汇康资产管理计划', '康缘集团'}",3,"{'36', '康缘集团', '汇康资产管理计划'}"
4,"{'冶金集团', '竞价', '现金', '36'}",2028423,0,set(),4,"{'冶金集团', '竞价', '现金', '36'}",4,"{'冶金集团', '竞价', '现金', '36'}"
14,"{'现金', '42246297', '770149994.3', '52950037.65', '759999986.1', '中节能资本控股有限公司', '华龙证券股份有限公司', '北京中吉金投资产管理有限公司', '2904555', '竞价', '786799982', '43159626', '中国人寿资产管理有限公司', '41689522'}",2274579,5,"{'52950037.65', '759999986.1', '2904555', '786799982', '竞价'}",5,"{'现金', '中节能资本控股有限公司', '华龙证券股份有限公司', '北京中吉金投资产管理有限公司', '中国人寿资产管理有限公司'}",9,"{'770149994.3', '42246297', '现金', '中节能资本控股有限公司', '华龙证券股份有限公司', '北京中吉金投资产管理有限公司', '43159626', '中国人寿资产管理有限公司', '41689522'}"
9,"{'湖北省长江产业投资集团有限公司', '150000000', '现金', '400000000', '35714285', '定价', '长江并购基金', '13392857', '36'}",1739353,2,"{'150000000', '400000000'}",5,"{'湖北省长江产业投资集团有限公司', '现金', '定价', '长江并购基金', '36'}",7,"{'湖北省长江产业投资集团有限公司', '现金', '35714285', '定价', '长江并购基金', '13392857', '36'}"
10,"{'现金', '沙湾聚星股权投资中心(有限合伙)', '沙湾慧达股权投资中心(有限合伙)', '1000000', '22396843', '沙湾聚合股权投资中心(有限合伙)', '1903157', '郭松森', '1015789', '36'}",444472,4,"{'1015789', '1000000', '22396843', '1903157'}",3,"{'郭松森', '现金', '36'}",6,"{'现金', '沙湾聚星股权投资中心(有限合伙)', '沙湾慧达股权投资中心(有限合伙)', '沙湾聚合股权投资中心(有限合伙)', '郭松森', '36'}"
14,"{'8700000', '102000000', '88300000', '国投瑞银基金管理有限公司', '12', '30600000', '嘉实基金管理有限公司', '3000000', '88740000', '泰康资产管理有限责任公司', '北京燕京啤酒有限公司', '10000000', '36', '900660000'}",1388766,5,"{'8700000', '102000000', '30600000', '88740000', '900660000'}",6,"{'36', '国投瑞银基金管理有限公司', '嘉实基金管理有限公司', '泰康资产管理有限责任公司', '北京燕京啤酒有限公司', '12'}",9,"{'88300000', '国投瑞银基金管理有限公司', '12', '嘉实基金管理有限公司', '3000000', '泰康资产管理有限责任公司', '北京燕京啤酒有限公司', '10000000', '36'}"
22,"{'华安基金管理有限公司', '5064145', '4726536', '1924375', '泰达宏利基金管理有限公司', '3396356', '现金', '28499993.75', '27999993.34', '69999998.16', '财通基金管理有限公司', '竞价', '西湖电子集团有限公司', '74999987.45', '36', '上海通晟资产管理有限公司', '1890614', '19999986.78', '50300032.36', '九泰基金管理有限公司', '1350438', '12'}",15638715,7,"{'50300032.36', '27999993.34', '28499993.75', '69999998.16', '竞价', '74999987.45', '19999986.78'}",9,"{'36', '现金', '华安基金管理有限公司', '九泰基金管理有限公司', '上海通晟资产管理有限公司', '财通基金管理有限公司', '西湖电子集团有限公司', '泰达宏利基金管理有限公司', '12'}",15,"{'36', '现金', '华安基金管理有限公司', '九泰基金管理有限公司', '5064145', '上海通晟资产管理有限公司', '财通基金管理有限公司', '4726536', '1890614', '1924375', '西湖电子集团有限公司', '泰达宏利基金管理有限公司', '3396356', '1350438', '12'}"
12,"{'12695725', '846381', '现金', '20000000', '国禹资管', '2115954', '池驰', '竞价', '300000000', '50000000', '丁劲松', '36'}",15544748,3,"{'竞价', '300000000', '50000000'}",5,"{'现金', '国禹资管', '池驰', '丁劲松', '36'}",9,"{'12695725', '846381', '现金', '20000000', '国禹资管', '2115954', '池驰', '丁劲松', '36'}"
11,"{'兴全定增61号特定多客户资产管理计划', '财通基金-富春72号资产管理计划', '现金', '宏图瑞利', '25293600', '定价', '兴全定增62号特定多客户资产管理计划', '13393900', '财通基金-富春71号资产管理计划', '36', '13015800'}",1666759,4,"{'13393900', '定价', '25293600', '13015800'}",3,"{'现金', '宏图瑞利', '36'}",7,"{'兴全定增61号特定多客户资产管理计划', '36', '现金', '宏图瑞利', '兴全定增62号特定多客户资产管理计划', '财通基金-富春71号资产管理计划', '财通基金-富春72号资产管理计划'}"
4,"{'竞价', '现金', '36', '东旭集团'}",1794347,0,set(),4,"{'竞价', '现金', '36', '东旭集团'}",4,"{'竞价', '现金', '36', '东旭集团'}"
22,"{'52634000', '30959000', '广发基金管理有限公司', '299992710', '399993510', '58700000', '东旭集团有限公司', '123839000', '41279000', '益民基金管理有限公司', '130031000', '1260000390', '36', '民生加银基金管理有限公司', '510023460', '华融证券股份有限公司', '1199999910', '中国国际金融有限公司', '汇添富基金管理有限公司', '568803000', '大成基金管理有限公司', '12'}",1199186,0,set(),3,"{'12', '东旭集团有限公司', '36'}",22,"{'52634000', '30959000', '广发基金管理有限公司', '299992710', '399993510', '58700000', '东旭集团有限公司', '123839000', '41279000', '益民基金管理有限公司', '130031000', '1260000390', '36', '民生加银基金管理有限公司', '510023460', '华融证券股份有限公司', '1199999910', '中国国际金融有限公司', '汇添富基金管理有限公司', '568803000', '大成基金管理有限公司', '12'}"
5,"{'370290200', '西安飞机工业(集团)有限责任公司', '定价', '资产', '36'}",815969,0,set(),3,"{'资产', '定价', '36'}",5,"{'370290200', '西安飞机工业(集团)有限责任公司', '定价', '资产', '36'}"
13,"{'现金', '17154900', '宁波梅山保税港区响道投资管理合伙企业(有限合伙)', '杭州长城股权投资基金合伙企业(有限合伙)', '宁波梅山保税港区硕嘉投资中心(有限合伙)', '江苏聚合创意新兴产业投资基金(有限合伙)', '3100800', '浙江天堂硅谷乐通股权投资合伙企业(有限合伙)', '3000000', '宁波聚网投资合伙企业(有限合伙)', '10336000', '36', '2583980'}",447198,6,"{'宁波梅山保税港区响道投资管理合伙企业(有限合伙)', '杭州长城股权投资基金合伙企业(有限合伙)', '宁波梅山保税港区硕嘉投资中心(有限合伙)', '江苏聚合创意新兴产业投资基金(有限合伙)', '浙江天堂硅谷乐通股权投资合伙企业(有限合伙)', '宁波聚网投资合伙企业(有限合伙)'}",2,"{'现金', '36'}",7,"{'现金', '17154900', '3100800', '3000000', '10336000', '36', '2583980'}"
21,"{'512035011', '5000000000', '328227571', '现金', '“九州增发二期”集合资产管理计划', '定价', '1750547046', '“中信信诚·华实金融投资1号”专项资产管理计划', '16000000000', '218818381', '547045951', '2000000000', '109409190', '“新时代华资实业定增1号”集合资产管理计划', '郁金香投资', '1000000000', '草原糖业', '4680000000', '3000000000', '“前海金鹰粤通36号”专项资产管理计划', '36'}",4948858,8,"{'16000000000', '218818381', '512035011', '547045951', '1750547046', '109409190', '4680000000', '328227571'}",7,"{'现金', '“九州增发二期”集合资产管理计划', '郁金香投资', '定价', '5000000000', '草原糖业', '36'}",13,"{'现金', '“九州增发二期”集合资产管理计划', '郁金香投资', '定价', '1000000000', '5000000000', '草原糖业', '2000000000', '3000000000', '“新时代华资实业定增1号”集合资产管理计划', '“中信信诚·华实金融投资1号”专项资产管理计划', '“前海金鹰粤通36号”专项资产管理计划', '36'}"
11,"{'惠德农牧', '定价', '青岛善诚', '青岛高智', '南方希望', '成都新望', '潍坊众慧', '李巍', '刘畅', '股权', '和之望实业'}",213009,0,set(),11,"{'惠德农牧', '定价', '青岛善诚', '李巍', '南方希望', '成都新望', '潍坊众慧', '青岛高智', '刘畅', '股权', '和之望实业'}",11,"{'惠德农牧', '定价', '青岛善诚', '青岛高智', '南方希望', '成都新望', '潍坊众慧', '李巍', '刘畅', '股权', '和之望实业'}"
20,"{'26080000', '现金', '新疆麦趣尔集团有限责任公司', '北京景瑞兴房地产开发有限公司', '1533742', '236570010.9', '德融资本管理有限公司', '39999991.36', '766871', '19999995.68', '王哲', '9999984.8', '北京达美投资有限公司', '李岩', '新疆聚和盛投资有限公司', '1000000', '彭炫皓', '9070936', '36', '383435'}",1269811,1,{'236570010.9'},10,"{'现金', '新疆麦趣尔集团有限责任公司', '北京景瑞兴房地产开发有限公司', '德融资本管理有限公司', '北京达美投资有限公司', '李岩', '新疆聚和盛投资有限公司', '王哲', '彭炫皓', '36'}",19,"{'26080000', '现金', '新疆麦趣尔集团有限责任公司', '北京景瑞兴房地产开发有限公司', '1533742', '德融资本管理有限公司', '766871', '39999991.36', '19999995.68', '王哲', '9999984.8', '北京达美投资有限公司', '李岩', '新疆聚和盛投资有限公司', '1000000', '彭炫皓', '9070936', '36', '383435'}"
4,"{'46181200', '重庆智全实业有限责任公司', '中国核工业建峰化工总厂', '48105400'}",1131739,2,"{'46181200', '48105400'}",2,"{'重庆智全实业有限责任公司', '中国核工业建峰化工总厂'}",2,"{'重庆智全实业有限责任公司', '中国核工业建峰化工总厂'}"
22,"{'168045027', '500000002.4', '394570000', '现金', '298681263', '工银瑞信基金管理有限公司', '1545374097', '681699996.8', '638571102.6', '财通基金管理有限公司', '竞价', '406677394', '1499366000', '36', '包钢集团', '国华人寿保险股份有限公司', '中国长城资产管理公司', '1134988799', '融通基金管理有限公司', '179394736', '131578948', '12'}",144492,0,set(),10,"{'现金', '工银瑞信基金管理有限公司', '12', '包钢集团', '融通基金管理有限公司', '国华人寿保险股份有限公司', '财通基金管理有限公司', '中国长城资产管理公司', '竞价', '36'}",22,"{'168045027', '500000002.4', '394570000', '298681263', '现金', '工银瑞信基金管理有限公司', '1545374097', '681699996.8', '638571102.6', '财通基金管理有限公司', '竞价', '406677394', '1499366000', '36', '包钢集团', '国华人寿保险股份有限公司', '中国长城资产管理公司', '1134988799', '融通基金管理有限公司', '179394736', '131578948', '12'}"
25,"{'18893387', '长城国融投资管理有限公司', '139999997.7', '华融融通(天津)股权投资基金合伙企业(有限合伙)', '12273212.64', '银河资本资产管理有限公司', '243068303.4', '1656304', '竞价', '32802740', '26990553', '109999997.6', '平安大华基金管理有限公司', '36', '21592442', '中信证券股份有限公司', '159999995.2', '华融证券股份有限公司', '32388663', '九泰基金管理有限公司', '199999997.7', '14844804', '239999992.8', '鸿达兴业集团', '12'}",16660627,2,"{'12273212.64', '139999997.7'}",10,"{'平安大华基金管理有限公司', '36', '九泰基金管理有限公司', '长城国融投资管理有限公司', '竞价', '中信证券股份有限公司', '华融证券股份有限公司', '鸿达兴业集团', '12', '银河资本资产管理有限公司'}",23,"{'18893387', '长城国融投资管理有限公司', '华融融通(天津)股权投资基金合伙企业(有限合伙)', '银河资本资产管理有限公司', '243068303.4', '1656304', '竞价', '32802740', '26990553', '109999997.6', '平安大华基金管理有限公司', '36', '21592442', '中信证券股份有限公司', '159999995.2', '华融证券股份有限公司', '32388663', '九泰基金管理有限公司', '199999997.7', '14844804', '239999992.8', '鸿达兴业集团', '12'}"
12,"{'36', '现金', '5691519', '中意资产管理有限责任公司', '郑靭', '25000001.6', '99999988.83', '1422880', '陈汉昭', '竞价', '前海开源基金管理有限公司', '12'}",16357058,0,set(),7,"{'现金', '中意资产管理有限责任公司', '郑靭', '12', '陈汉昭', '前海开源基金管理有限公司', '36'}",12,"{'36', '现金', '5691519', '中意资产管理有限责任公司', '郑靭', '25000001.6', '99999988.83', '1422880', '陈汉昭', '竞价', '前海开源基金管理有限公司', '12'}"
16,"{'84999992.22', '7770007', '马佳圳', '海南海药投资有限公司', '8249324', '69999994.35', '12', '106168799.9', '东海基金管理有限责任公司', '竞价', '张浩铭', '鹏华基金管理有限公司', '6604506', '99999990.09', '36', '5439005'}",16706639,4,"{'84999992.22', '99999990.09', '106168799.9', '69999994.35'}",8,"{'海南海药投资有限公司', '马佳圳', '36', '东海基金管理有限责任公司', '竞价', '张浩铭', '鹏华基金管理有限公司', '12'}",12,"{'7770007', '马佳圳', '海南海药投资有限公司', '8249324', '12', '东海基金管理有限责任公司', '竞价', '张浩铭', '鹏华基金管理有限公司', '6604506', '36', '5439005'}"
18,"{'5000000', '现金', '兵器财务有限责任公司', '中国银河金融控股有限责任公司', '12400000', '759090', '天津晟乾宝典股权投资基金合伙企业(有限合伙)', '9500000', '国都证券有限责任公司', '苏州睿石尼盛股权投资中心(有限合伙)', '4400000', '中国银河投资管理有限公司', '广发基金管理有限公司', '竞价', '4900000', '上海戴德拉投资管理合伙企业(有限合伙)', '5200000', '12'}",214689,1,{'竞价'},7,"{'兵器财务有限责任公司', '现金', '中国银河金融控股有限责任公司', '中国银河投资管理有限公司', '广发基金管理有限公司', '国都证券有限责任公司', '12'}",17,"{'5000000', '现金', '兵器财务有限责任公司', '中国银河金融控股有限责任公司', '12400000', '759090', '天津晟乾宝典股权投资基金合伙企业(有限合伙)', '9500000', '国都证券有限责任公司', '苏州睿石尼盛股权投资中心(有限合伙)', '4400000', '中国银河投资管理有限公司', '广发基金管理有限公司', '4900000', '上海戴德拉投资管理合伙企业(有限合伙)', '5200000', '12'}"
4,"{'竞价', '现金', '36', '新疆天富电力(集团)有限责任公司'}",184270,0,set(),4,"{'竞价', '现金', '36', '新疆天富电力(集团)有限责任公司'}",4,"{'竞价', '现金', '36', '新疆天富电力(集团)有限责任公司'}"
14,"{'20000000', '深圳市腾博投资有限公司', '华安财产保险股份有限公司', '北京市得利加自控技术有限公司', '无锡同诚投资担保有限公司', '深圳市瑞松投资有限公司', '北京通灵通电讯技术有限公司', '定价', '14000000', '26000000', '22000000', '深圳市聚达苑投资有限公司', '28000000', '36'}",540745,4,"{'22000000', '14000000', '28000000', '26000000'}",6,"{'北京市得利加自控技术有限公司', '北京通灵通电讯技术有限公司', '定价', '深圳市聚达苑投资有限公司', '深圳市瑞松投资有限公司', '36'}",10,"{'20000000', '深圳市腾博投资有限公司', '华安财产保险股份有限公司', '北京市得利加自控技术有限公司', '无锡同诚投资担保有限公司', '北京通灵通电讯技术有限公司', '定价', '深圳市聚达苑投资有限公司', '深圳市瑞松投资有限公司', '36'}"
19,"{'20000000', '10624100', '现金', '5000000', '湖南海利高新技术产业集团有限公司', '150600000', '福建永超投资有限公司', '招证资管-同赢之湖南海利1号员工持股计划定向资产管理计划', '13000000', '定价', '6640100', '79999500', '37650000', '49999900', '湖南国有资产经营管理有限公司', '上海尚锦置业有限公司', '97890000', '深圳市瑞丰林投资管理中心(有限合伙)', '36'}",2231523,5,"{'150600000', '79999500', '37650000', '49999900', '97890000'}",8,"{'现金', '福建永超投资有限公司', '湖南海利高新技术产业集团有限公司', '招证资管-同赢之湖南海利1号员工持股计划定向资产管理计划', '定价', '湖南国有资产经营管理有限公司', '上海尚锦置业有限公司', '36'}",14,"{'20000000', '10624100', '现金', '5000000', '湖南海利高新技术产业集团有限公司', '福建永超投资有限公司', '招证资管-同赢之湖南海利1号员工持股计划定向资产管理计划', '13000000', '6640100', '定价', '湖南国有资产经营管理有限公司', '上海尚锦置业有限公司', '深圳市瑞丰林投资管理中心(有限合伙)', '36'}"
6,"{'17818960', '竞价', '7127585', 'IDG资本管理(香港)有限公司', '36', '华住酒店管理有限公司'}",738340,1,{'竞价'},2,"{'36', '华住酒店管理有限公司'}",5,"{'17818960', '7127585', 'IDG资本管理(香港)有限公司', '36', '华住酒店管理有限公司'}"
24,"{'中再资产管理股份有限公司', '4000000', '申万菱信(上海)资产管理有限公司', '7000000', '1195800', '64676000', '4800000', '8000000', '98420000', '4600000', '定价', '天安财产保险股份有限公司', '财通基金管理有限公司', '59052000', '华夏人寿保险股份有限公司', '16812948', '112480000', '4200000', '56240000', '刘宏光', '东海基金管理有限公司', '渤海证券股份有限公司', '12', '67488000'}",311643,10,"{'67488000', '16812948', '112480000', '1195800', '4200000', '59052000', '56240000', '64676000', '4800000', '98420000'}",3,"{'渤海证券股份有限公司', '定价', '12'}",14,"{'华夏人寿保险股份有限公司', '中再资产管理股份有限公司', '刘宏光', '4000000', '4600000', '申万菱信(上海)资产管理有限公司', '东海基金管理有限公司', '7000000', '天安财产保险股份有限公司', '财通基金管理有限公司', '定价', '渤海证券股份有限公司', '8000000', '12'}"
4,"{'竞价', '现金', '上海汽车集团股份有限公司', '36'}",501199,0,set(),4,"{'竞价', '现金', '上海汽车集团股份有限公司', '36'}",4,"{'竞价', '现金', '上海汽车集团股份有限公司', '36'}"
9,"{'现金', '长港燃气', '定价', '578270000', '78811178', '521730000', '87351964', '吉能集团', '36'}",10786327,0,set(),5,"{'现金', '长港燃气', '定价', '吉能集团', '36'}",9,"{'现金', '长港燃气', '定价', '578270000', '78811178', '521730000', '87351964', '吉能集团', '36'}"
18,"{'现金', '陈建国', '444755454', '强雪忠', '申万宏源领航9号', '中欧盛世景鑫4号', '倪利锋', '定价', '齐鲁碧辰5号', '83443800', '陶永生', '26000000', '昆山创投', '138580000', '431730000', '81000000', '泰达宏利价值成长234号', '36'}",1746998,6,"{'444755454', '26000000', '83443800', '138580000', '431730000', '81000000'}",8,"{'现金', '陈建国', '倪利锋', '定价', '陶永生', '昆山创投', '强雪忠', '36'}",12,"{'现金', '陈建国', '中欧盛世景鑫4号', '申万宏源领航9号', '倪利锋', '齐鲁碧辰5号', '定价', '陶永生', '昆山创投', '强雪忠', '泰达宏利价值成长234号', '36'}"
23,"{'2957704', '1774622', '119999973.5', '国投瑞银基金管理有限公司', '21210128.73', '59999969.82', '12', '84999996.69', '竞价', '627333', '芜湖弘唯基石创业投资合伙企业(有限合伙)', '北信瑞丰基金管理有限公司', '2514049', '61999966.56', '99999972.24', '3549245', '149999992.2', '青岛国信资本投资有限公司', '中信证券股份有限公司', '中德制造业(安徽)投资基金(有限合伙)', '大成基金管理有限公司', '4436557', '1833776'}",16430027,3,"{'竞价', '149999992.2', '119999973.5'}",6,"{'北信瑞丰基金管理有限公司', '大成基金管理有限公司', '青岛国信资本投资有限公司', '中信证券股份有限公司', '国投瑞银基金管理有限公司', '12'}",20,"{'2957704', '芜湖弘唯基石创业投资合伙企业(有限合伙)', '1774622', '中德制造业(安徽)投资基金(有限合伙)', '北信瑞丰基金管理有限公司', '1833776', '2514049', '59999969.82', '大成基金管理有限公司', '61999966.56', '99999972.24', '21210128.73', '3549245', '84999996.69', '4436557', '青岛国信资本投资有限公司', '中信证券股份有限公司', '627333', '国投瑞银基金管理有限公司', '12'}"
18,"{'现金', '蒋小三', '31250000', '股权', '唐笑波', '定价', '1265625', '李先桃', '18750000', '天堂硅谷', '6250000', '48812500', '秦本军', '吴军凡', '24046875', '36', '37500000', '天堂硅谷奕新'}",1839642,7,"{'31250000', '1265625', '6250000', '48812500', '24046875', '18750000', '37500000'}",11,"{'现金', '蒋小三', '股权', '唐笑波', '定价', '李先桃', '天堂硅谷', '秦本军', '吴军凡', '36', '天堂硅谷奕新'}",11,"{'现金', '蒋小三', '股权', '唐笑波', '定价', '李先桃', '天堂硅谷', '秦本军', '吴军凡', '36', '天堂硅谷奕新'}"
6,"{'现金', '定价', '1263065900', '银河天成集团有限公司', '129147842', '36'}",7174782,2,"{'129147842', '1263065900'}",4,"{'银河天成集团有限公司', '现金', '定价', '36'}",4,"{'银河天成集团有限公司', '定价', '现金', '36'}"
15,"{'36', '北京合正普惠投资管理有限公司', '珠海富乾投资有限公司', '14211000', '1300000', '900000', '2800000', '9387091.84', '竞价', '柯荣卿', '20527000', '广州金骏投资控股有限公司', '44212000', '594496', '12'}",719671,1,{'竞价'},4,"{'珠海富乾投资有限公司', '36', '柯荣卿', '12'}",14,"{'36', '北京合正普惠投资管理有限公司', '珠海富乾投资有限公司', '14211000', '1300000', '900000', '2800000', '9387091.84', '柯荣卿', '20527000', '广州金骏投资控股有限公司', '44212000', '594496', '12'}"
5,"{'1630000000', '现金', '60', '竞价', '福建省财政厅'}",18844877,1,{'1630000000'},4,"{'竞价', '60', '现金', '福建省财政厅'}",4,"{'竞价', '60', '现金', '福建省财政厅'}"
26,"{'3999999992', '易方达基金管理有限公司', '1999999996', '现金', '12849807', '1799999996', '231065468', '兴业财富资产管理有限公司', '99999996.3', '117999998.8', '财通基金管理有限公司', '竞价', '中国航空集团公司', '36', '100099996.5', '中国航空油料集团公司', '12836970', '256739409', '385109114', '513478818', '15147625', '中国国有企业结构调整基金股份有限公司', '2999999998', '中原股权投资管理有限公司', '12', '汇安基金管理有限责任公司'}",15790159,3,"{'1799999996', '竞价', '117999998.8'}",9,"{'现金', '12', '中国航空油料集团公司', '兴业财富资产管理有限公司', '财通基金管理有限公司', '易方达基金管理有限公司', '中原股权投资管理有限公司', '36', '汇安基金管理有限责任公司'}",23,"{'3999999992', '易方达基金管理有限公司', '1999999996', '现金', '12849807', '99999996.3', '231065468', '兴业财富资产管理有限公司', '财通基金管理有限公司', '中国航空集团公司', '100099996.5', '36', '12836970', '中国航空油料集团公司', '256739409', '385109114', '513478818', '15147625', '中国国有企业结构调整基金股份有限公司', '2999999998', '中原股权投资管理有限公司', '12', '汇安基金管理有限责任公司'}"
14,"{'中信国安', '42040266', '25482862', '27715715', '市总台', '49624328', '楚天数字', '38165981', '资产', '武汉有线', '楚天襄阳', '28243633', '36', '楚天金纬'}",914221,1,{'38165981'},8,"{'36', '市总台', '楚天数字', '资产', '武汉有线', '楚天襄阳', '中信国安', '楚天金纬'}",13,"{'中信国安', '42040266', '25482862', '27715715', '市总台', '49624328', '楚天数字', '资产', '武汉有线', '楚天襄阳', '28243633', '36', '楚天金纬'}"
5,"{'现金', '鲁楚平', '1117000000', '135066500', '36'}",676360,2,"{'1117000000', '135066500'}",3,"{'现金', '36', '鲁楚平'}",3,"{'现金', '36', '鲁楚平'}"
19,"{'5000000', '现金', '上海六禾投资有限公司', '12', '上海国敏贸易有限公司', '4000000', '上海界龙发展有限公司', '16380000', '华夏基金管理有限公司-华夏大盘精选证券投资基金', '2000000', '3000000', '申银万国证券股份有限公司', '海通证券股份有限公司', '27300000', '上海聚劲投资有限公司', '21840000', '上海证券有限责任公司', '36', '中国华轻实业有限公司'}",1526295,4,"{'16380000', '21840000', '27300000', '2000000'}",5,"{'36', '现金', '上海界龙发展有限公司', '海通证券股份有限公司', '12'}",15,"{'5000000', '现金', '上海六禾投资有限公司', '12', '上海国敏贸易有限公司', '4000000', '华夏基金管理有限公司-华夏大盘精选证券投资基金', '上海界龙发展有限公司', '3000000', '申银万国证券股份有限公司', '海通证券股份有限公司', '上海聚劲投资有限公司', '上海证券有限责任公司', '36', '中国华轻实业有限公司'}"
16,"{'46560000', '3500000', '江苏瑞华投资发展有限公司', '26384000', '1700000', '54320000', '5500000', '上海德润投资有限公司', '85360000', '3000000', '139680000', '泰康资产管理有限责任公司', '江阴市长江钢管有限公司', '9000000', '12', '杨青'}",1278304,6,"{'46560000', '26384000', '54320000', '5500000', '85360000', '139680000'}",5,"{'江苏瑞华投资发展有限公司', '上海德润投资有限公司', '泰康资产管理有限责任公司', '江阴市长江钢管有限公司', '12'}",10,"{'3500000', '江苏瑞华投资发展有限公司', '1700000', '上海德润投资有限公司', '3000000', '泰康资产管理有限责任公司', '江阴市长江钢管有限公司', '9000000', '12', '杨青'}"
21,"{'曹志刚', '165698610', '550000', '现金', '杨华', '竞价', '周云志', '王海波', '海通金风1号集合资产管理计划', '吴凯', '36', '霍常宝', '17140000', '海通金风2号集合资产管理计划', '19563000', '400000', '4658500', '刘玮', '3388000', '马金儒', '145175800'}",1730426,1,{'竞价'},10,"{'36', '现金', '霍常宝', '曹志刚', '杨华', '刘玮', '周云志', '王海波', '马金儒', '吴凯'}",20,"{'550000', '现金', '145175800', '曹志刚', '霍常宝', '杨华', '刘玮', '400000', '17140000', '海通金风2号集合资产管理计划', '马金儒', '19563000', '周云志', '165698610', '4658500', '王海波', '3388000', '海通金风1号集合资产管理计划', '36', '吴凯'}"
18,"{'26465030', '现金', '113421550', '18903590', '赢盛通典', '华富基金-鸿盛14号资产管理计划', '1000000000', '丰实云兰', '37807180', '700000000', '安鹏资本', '天弘基金定增40号资产管理计划', '康得集团', '500000000', '3000000000', '11342160', '300000000', '36'}",319731,10,"{'26465030', '113421550', '18903590', '1000000000', '37807180', '11342160', '700000000', '300000000', '500000000', '3000000000'}",6,"{'现金', '赢盛通典', '安鹏资本', '丰实云兰', '康得集团', '36'}",8,"{'现金', '赢盛通典', '华富基金-鸿盛14号资产管理计划', '安鹏资本', '丰实云兰', '天弘基金定增40号资产管理计划', '康得集团', '36'}"
14,"{'景顺长城基金管理有限公司', '深圳市创新资本投资有限公司', '国金证券股份有限公司', '5940000', '4000000', '4400000', '嘉实基金管理有限公司', '易方达基金管理有限公司', '周雪钦', 'Bill&Melinda Gates Foundation Trust', '5200000', '9000000', '12', '海富通基金管理有限公司'}",1137710,0,set(),9,"{'景顺长城基金管理有限公司', '深圳市创新资本投资有限公司', '国金证券股份有限公司', '嘉实基金管理有限公司', '易方达基金管理有限公司', '周雪钦', 'Bill&Melinda Gates Foundation Trust', '12', '海富通基金管理有限公司'}",14,"{'景顺长城基金管理有限公司', '深圳市创新资本投资有限公司', '国金证券股份有限公司', '5940000', '4000000', '4400000', '嘉实基金管理有限公司', '易方达基金管理有限公司', '周雪钦', 'Bill&Melinda Gates Foundation Trust', '5200000', '9000000', '12', '海富通基金管理有限公司'}"
6,"{'现金', '138078380', '20578000', '定价', '保税科技2015年度员工持股计划', '36'}",12064600,1,{'定价'},2,"{'现金', '36'}",5,"{'现金', '138078380', '20578000', '保税科技2015年度员工持股计划', '36'}"
13,"{'17125000', '现金', '中天资产', '13062500', '猎象资本', '盛世聚金', '盛世和金', '中睿智汇', '9000000', '28500000', '36', '14250000', '合涌源发展'}",1784490,0,set(),8,"{'现金', '中天资产', '猎象资本', '盛世聚金', '中睿智汇', '盛世和金', '36', '合涌源发展'}",13,"{'17125000', '现金', '中天资产', '13062500', '猎象资本', '盛世聚金', '盛世和金', '中睿智汇', '9000000', '28500000', '36', '14250000', '合涌源发展'}"
29,"{'62162501.4', '51802076.2', '165766662.1', '69069437.7', '上海中能企业发展(集团)有限公司', '12482429', '16643239', '温晓宁', '现金', '陈晓晖', '侯维才', '定价', '20804049', '4992972', '19971887', '7489458', '上海圣瀚创业投资合伙企业(有限合伙)', '172673606.7', '苏州嘉禾亿创业投资中心(有限合伙)', '8321619', '武汉欣荣睿企业咨询管理有限公司', '王德琦', '41441667.6', '6241214', '103604160.7', '冯美娟', '36', '138138883.7', '孙利'}",1755033,0,set(),10,"{'现金', '武汉欣荣睿企业咨询管理有限公司', '王德琦', '侯维才', '定价', '冯美娟', '陈晓晖', '温晓宁', '36', '孙利'}",29,"{'62162501.4', '51802076.2', '165766662.1', '69069437.7', '上海中能企业发展(集团)有限公司', '12482429', '16643239', '温晓宁', '陈晓晖', '现金', '侯维才', '定价', '20804049', '4992972', '19971887', '7489458', '上海圣瀚创业投资合伙企业(有限合伙)', '172673606.7', '苏州嘉禾亿创业投资中心(有限合伙)', '8321619', '武汉欣荣睿企业咨询管理有限公司', '王德琦', '41441667.6', '6241214', '103604160.7', '冯美娟', '36', '138138883.7', '孙利'}"
9,"{'上银瑞金慧富15号', '20000000', '现金', '40000000', '201200000', '定价', '上银瑞金慧富16号', '402400000', '36'}",1603161,4,"{'20000000', '201200000', '40000000', '402400000'}",3,"{'定价', '现金', '36'}",5,"{'上银瑞金慧富15号', '现金', '上银瑞金慧富16号', '定价', '36'}"
21,"{'20000000', '260000000', '中国银河金融控股有限责任公司', '航天科工财务有限责任公司', '浙江天银投资有限公司', '定价', '165100000', '286000000', '12600000', '410800000', '31600000', '中新融创资本管理有限公司', '163800000', '12700000', '中国人保资产管理股份有限公司', '9770000', '华宝信托有限责任公司', '22000000', '中国人寿资产管理有限公司', '127010000', '12'}",501967,6,"{'260000000', '410800000', '165100000', '163800000', '127010000', '286000000'}",5,"{'中国人保资产管理股份有限公司', '定价', '华宝信托有限责任公司', '中国人寿资产管理有限公司', '12'}",15,"{'20000000', '12600000', '中国银河金融控股有限责任公司', '航天科工财务有限责任公司', '中国人保资产管理股份有限公司', '9770000', '浙江天银投资有限公司', '定价', '华宝信托有限责任公司', '22000000', '31600000', '中新融创资本管理有限公司', '中国人寿资产管理有限公司', '12700000', '12'}"
16,"{'现金', '北信瑞丰基金管理有限公司', '兴证证券资产管理有限公司', '财通证券资产管理有限公司', '8610872.82', '12', '74404649.55', '张洪起', '119999985.9', '竞价', '2901353', '7736943', '4797205', '44999985.03', '36', '555182'}",18275049,4,"{'8610872.82', '竞价', '74404649.55', '44999985.03'}",4,"{'36', '现金', '12', '张洪起'}",12,"{'现金', '北信瑞丰基金管理有限公司', '兴证证券资产管理有限公司', '财通证券资产管理有限公司', '12', '张洪起', '119999985.9', '2901353', '7736943', '4797205', '36', '555182'}"
3,"{'中信国安投资有限公司', '现金', '36'}",992866,0,set(),3,"{'中信国安投资有限公司', '现金', '36'}",3,"{'中信国安投资有限公司', '现金', '36'}"
24,"{'1000000003', '841448887.2', '3268300000', '现金', '12', '财通基金管理有限公司', '申能(集团)有限公司', '竞价', '上海海烟投资管理有限公司', '104356087', '70372977', '2965627000', '999999989', '国华人寿保险股份有限公司', '59215263', '70372976', '浙能资本控股有限公司', '230000000', '1482899996', '208700000', '48', '中原股权投资管理有限公司', '山西太钢投资有限公司', '36'}",18855227,2,"{'999999989', '竞价'}",10,"{'浙能资本控股有限公司', '36', '现金', '国华人寿保险股份有限公司', '财通基金管理有限公司', '48', '上海海烟投资管理有限公司', '中原股权投资管理有限公司', '山西太钢投资有限公司', '12'}",22,"{'1000000003', '841448887.2', '3268300000', '现金', '12', '财通基金管理有限公司', '申能(集团)有限公司', '上海海烟投资管理有限公司', '104356087', '70372977', '2965627000', '国华人寿保险股份有限公司', '59215263', '70372976', '浙能资本控股有限公司', '230000000', '1482899996', '208700000', '48', '中原股权投资管理有限公司', '山西太钢投资有限公司', '36'}"
19,"{'现金', '12524771', '25036818', '定价', '上海国际集团资产管理有限公司', '博时基金管理有限公司', '财通基金管理有限公司', '华泰资产管理有限公司', '7596151', '广西铁路发展二期投资基金合伙企业(有限合伙)', '江苏盛和投资有限公司', '23102209', '12528424', '北京恒宇天泽投资管理有限公司', '信达澳银基金管理有限公司', '14973453', '12524521', '12', '12607879'}",15527677,0,set(),3,"{'定价', '现金', '12'}",19,"{'现金', '12524771', '25036818', '12', '博时基金管理有限公司', '7596151', '定价', '财通基金管理有限公司', '华泰资产管理有限公司', '广西铁路发展二期投资基金合伙企业(有限合伙)', '江苏盛和投资有限公司', '23102209', '12528424', '北京恒宇天泽投资管理有限公司', '信达澳银基金管理有限公司', '14973453', '12524521', '上海国际集团资产管理有限公司', '12607879'}"
26,"{'安志钢', '50018700', '2024958', '2915940', '现金', '160400600', '申威', '6085000', '王建', '12170000', '4161290', '506240', '8322579', '朱明', '段佩璋', '13344476', '35049600', '100037400', '24340000', '郭文亮', '诺安基金', '张新育', '唐朝霞', '1012479', '周卓和', '36'}",1795002,7,"{'35049600', '160400600', '100037400', '24340000', '12170000', '6085000', '50018700'}",12,"{'现金', '申威', '郭文亮', '朱明', '诺安基金', '张新育', '安志钢', '唐朝霞', '段佩璋', '王建', '周卓和', '36'}",19,"{'1012479', '506240', '现金', '4161290', '8322579', '申威', '段佩璋', '郭文亮', '朱明', '诺安基金', '张新育', '安志钢', '唐朝霞', '13344476', '王建', '周卓和', '36', '2024958', '2915940'}"
4,"{'泰禾投资', '竞价', '现金', '36'}",14669573,0,set(),4,"{'泰禾投资', '竞价', '现金', '36'}",4,"{'泰禾投资', '竞价', '现金', '36'}"
18,"{'15972222', '32638889', '现金', '180555556', '厦门麟真', '郁金香投资', '行健资本—健康产业投资基金', '699999998.4', '2600000006', '华夏人寿', '竞价', '48611111', '光证—易联众1期', '34722222', '499999996.8', '36', '470000001.6', '229999996.8'}",2314671,1,{'竞价'},6,"{'现金', '郁金香投资', '厦门麟真', '行健资本—健康产业投资基金', '华夏人寿', '36'}",17,"{'15972222', '32638889', '现金', '180555556', '厦门麟真', '郁金香投资', '行健资本—健康产业投资基金', '699999998.4', '2600000006', '华夏人寿', '48611111', '光证—易联众1期', '34722222', '499999996.8', '36', '470000001.6', '229999996.8'}"
12,"{'20000000', '8000000', '13000000', '博时基金管理有限公司', '招商基金管理有限公司', '宋睿', '22000000', '竞价', '10000000', '深圳市平安创新资本投资有限公司', '光大永明资产管理股份有限公司', '36'}",1736264,2,"{'22000000', '竞价'}",6,"{'36', '博时基金管理有限公司', '招商基金管理有限公司', '宋睿', '光大永明资产管理股份有限公司', '深圳市平安创新资本投资有限公司'}",10,"{'20000000', '8000000', '13000000', '博时基金管理有限公司', '招商基金管理有限公司', '宋睿', '10000000', '深圳市平安创新资本投资有限公司', '光大永明资产管理股份有限公司', '36'}"
23,"{'469999792', '245850968', '杭州东方邦信赤和股权投资基金合伙企业(有限合伙)', '61718500', '504999912', '前海开源基金管理有限公司', '245639630', '126884400', '定价', '279999766', '上海泓谟资产管理有限公司', '杭州炬元彤康投资合伙企业(有限合伙)', '118090400', '金鹰基金管理有限公司', '70351700', '63067800', '61771600', '88567800', '352499844', '251009844', '金元顺安基金管理有限公司', '创金合信基金管理有限公司', '12'}",15715827,0,set(),7,"{'金鹰基金管理有限公司', '创金合信基金管理有限公司', '定价', '金元顺安基金管理有限公司', '上海泓谟资产管理有限公司', '前海开源基金管理有限公司', '12'}",23,"{'469999792', '245850968', '杭州东方邦信赤和股权投资基金合伙企业(有限合伙)', '61718500', '504999912', '前海开源基金管理有限公司', '245639630', '126884400', '定价', '279999766', '上海泓谟资产管理有限公司', '杭州炬元彤康投资合伙企业(有限合伙)', '118090400', '金鹰基金管理有限公司', '70351700', '63067800', '61771600', '88567800', '352499844', '251009844', '金元顺安基金管理有限公司', '创金合信基金管理有限公司', '12'}"
5,"{'长城科技股份有限公司', '定价', '60000000', '资产', '36'}",1129974,1,{'60000000'},4,"{'长城科技股份有限公司', '资产', '定价', '36'}",4,"{'长城科技股份有限公司', '资产', '定价', '36'}"
6,"{'现金', '定价', '28391000', '保税科技2015年度员工持股计划', '36', '190787500'}",1728295,3,"{'保税科技2015年度员工持股计划', '28391000', '190787500'}",3,"{'定价', '现金', '36'}",3,"{'定价', '现金', '36'}"
6,"{'汇康资产管理计划', '现金', '13513453', '康缘集团', '6756828', '36'}",1054275,2,"{'6756828', '13513453'}",4,"{'36', '汇康资产管理计划', '现金', '康缘集团'}",4,"{'36', '现金', '康缘集团', '汇康资产管理计划'}"
22,"{'上海南都伟峰投资管理有限公司', '50000000', '南方基金管理有限公司', '现金', '国信证券有限责任公司', '110000000', '中国平安人寿保险股份有限公司', '竞价', '华润股份有限公司', '鹏华基金管理有限公司', '31000000', '30000000', '36', '博时基金管理有限公司', '15000000', '60000000', '46000000', '富国基金管理有限公司', '13000000', '嘉实基金管理有限公司', '12', '海富通基金管理有限公司'}",920457,3,"{'13000000', '竞价', '31000000'}",13,"{'36', '现金', '国信证券有限责任公司', '上海南都伟峰投资管理有限公司', '博时基金管理有限公司', '嘉实基金管理有限公司', '中国平安人寿保险股份有限公司', '华润股份有限公司', '南方基金管理有限公司', '鹏华基金管理有限公司', '富国基金管理有限公司', '12', '海富通基金管理有限公司'}",19,"{'现金', '12', '国信证券有限责任公司', '上海南都伟峰投资管理有限公司', '博时基金管理有限公司', '嘉实基金管理有限公司', '110000000', '60000000', '中国平安人寿保险股份有限公司', '15000000', '50000000', '华润股份有限公司', '南方基金管理有限公司', '46000000', '鹏华基金管理有限公司', '富国基金管理有限公司', '30000000', '36', '海富通基金管理有限公司'}"
5,"{'现金', '世博旅游集团', '竞价', '275010000', '36'}",1848404,2,"{'竞价', '275010000'}",3,"{'现金', '36', '世博旅游集团'}",3,"{'现金', '36', '世博旅游集团'}"
18,"{'现金', '葛卫东', '100000000', '国金香港', '852000', '康哲医药', '1000000000', '张勇', '2840100', '50000000', '28401000', '上海混沌道然资产管理有限公司', '屈向军', '220000000', '1420100', '30000000', '36', '6248200'}",1908482,10,"{'100000000', '852000', '1000000000', '50000000', '2840100', '28401000', '220000000', '1420100', '30000000', '6248200'}",8,"{'现金', '葛卫东', '国金香港', '康哲医药', '张勇', '上海混沌道然资产管理有限公司', '屈向军', '36'}",8,"{'现金', '葛卫东', '国金香港', '康哲医药', '张勇', '上海混沌道然资产管理有限公司', '屈向军', '36'}"
16,"{'现金', '吴正明', '2636677', '长江证券超越理财宝9号集合资产管理计划', '定价', '38819990.44', '章锋', '9968635', '33643998.52', '127199782.6', '3042319', '13152962', '刘鹏', '167831795.1', '财通基金—玉泉91号资产管理计划', '36'}",1761844,0,set(),6,"{'现金', '吴正明', '定价', '章锋', '刘鹏', '36'}",16,"{'现金', '吴正明', '2636677', '长江证券超越理财宝9号集合资产管理计划', '定价', '38819990.44', '章锋', '9968635', '33643998.52', '127199782.6', '3042319', '13152962', '刘鹏', '167831795.1', '财通基金—玉泉91号资产管理计划', '36'}"
12,"{'8610000', '现金', '启迪科服', '定价', '95548800', '152913600', '衡阳弘湘', '嘉实基金', '5380000', '2150000', '38184000', '36'}",16218242,6,"{'8610000', '95548800', '152913600', '2150000', '5380000', '38184000'}",6,"{'现金', '启迪科服', '定价', '衡阳弘湘', '嘉实基金', '36'}",6,"{'现金', '启迪科服', '定价', '衡阳弘湘', '嘉实基金', '36'}"
19,"{'现金', '福建三安集团有限公司', '银华基金管理有限公司', '华夏基金管理有限公司', '15148623', '12', '16033055', '15147706', '27123853', '广发基金管理有限公司', '易方达基金管理有限公司', '竞价', '15151376', '富国基金管理有限公司', '南方基金管理有限公司', '32496305', '中国人寿资产管理有限公司', '15137614', '36'}",992722,6,"{'27123853', '16033055', '15147706', '竞价', '15151376', '32496305'}",11,"{'现金', '福建三安集团有限公司', '银华基金管理有限公司', '华夏基金管理有限公司', '12', '广发基金管理有限公司', '易方达基金管理有限公司', '富国基金管理有限公司', '南方基金管理有限公司', '中国人寿资产管理有限公司', '36'}",13,"{'36', '现金', '福建三安集团有限公司', '银华基金管理有限公司', '华夏基金管理有限公司', '广发基金管理有限公司', '易方达基金管理有限公司', '富国基金管理有限公司', '南方基金管理有限公司', '15148623', '中国人寿资产管理有限公司', '15137614', '12'}"
15,"{'现金', '东吴基金管理有限公司', '上海六禾投资有限公司', '兴业财富资产管理有限公司', '15931372', '24509803', '17156862', '69999996.96', '财通基金管理有限公司', '64999997.76', '竞价', '82401963', '99999996.24', '336200009', '12'}",15568021,1,{'竞价'},6,"{'东吴基金管理有限公司', '现金', '上海六禾投资有限公司', '兴业财富资产管理有限公司', '财通基金管理有限公司', '12'}",14,"{'东吴基金管理有限公司', '现金', '上海六禾投资有限公司', '兴业财富资产管理有限公司', '15931372', '24509803', '17156862', '69999996.96', '财通基金管理有限公司', '64999997.76', '82401963', '99999996.24', '336200009', '12'}"
5,"{'现金', '定价', '上银基金财富56号资产管理计划', '上银基金财富57号资产管理计划', '36'}",1705343,2,"{'上银基金财富57号资产管理计划', '上银基金财富56号资产管理计划'}",3,"{'定价', '现金', '36'}",3,"{'现金', '定价', '36'}"
18,"{'宁波开发投资集团有限公司', '南京瑞森投资管理合伙企业(有限合伙)', '现金', '华安基金管理有限公司', '2330000', '12', '东海基金管理有限责任公司', '财通基金管理有限公司', '50800000', '瞿柏寅', '周雪钦', '33000000', '70800000', '50000000', '魏胜平', '民生通惠资产管理有限公司', '30000000', '36'}",476885,0,set(),11,"{'宁波开发投资集团有限公司', '现金', '华安基金管理有限公司', '12', '东海基金管理有限责任公司', '财通基金管理有限公司', '瞿柏寅', '周雪钦', '魏胜平', '民生通惠资产管理有限公司', '36'}",18,"{'宁波开发投资集团有限公司', '南京瑞森投资管理合伙企业(有限合伙)', '现金', '华安基金管理有限公司', '2330000', '12', '东海基金管理有限责任公司', '财通基金管理有限公司', '50800000', '瞿柏寅', '周雪钦', '33000000', '70800000', '50000000', '魏胜平', '民生通惠资产管理有限公司', '30000000', '36'}"
16,"{'浙江天堂硅谷鲲鹏创业投资有限公司', '寻山集团有限公司', '现金', '新华水力发电有限公司', '20000000', '36', '定价', '15000000', '1220000', '湖北益龙创业投资有限公司', '上海星河数码投资有限公司', '青海物通(集团)实业有限公司', '5600000', '10000000', '12', '6150000'}",1498022,3,"{'寻山集团有限公司', '15000000', '1220000'}",8,"{'浙江天堂硅谷鲲鹏创业投资有限公司', '新华水力发电有限公司', '现金', '12', '定价', '湖北益龙创业投资有限公司', '上海星河数码投资有限公司', '36'}",13,"{'浙江天堂硅谷鲲鹏创业投资有限公司', '20000000', '新华水力发电有限公司', '36', '现金', '定价', '湖北益龙创业投资有限公司', '上海星河数码投资有限公司', '青海物通(集团)实业有限公司', '5600000', '10000000', '12', '6150000'}"
6,"{'400000251', '现金', '85287900', '浩物机电', '竞价', '36'}",484245,1,{'竞价'},3,"{'现金', '36', '浩物机电'}",5,"{'400000251', '现金', '85287900', '浩物机电', '36'}"
16,"{'鹏华资产管理(深圳)有限公司', '12751257', '13888887', '243293983.6', '12699423', '兴业证券资产管理有限公司', '定价', '16352201', '242304990.8', '广发乾和投资有限公司', '深圳市保腾丰利创业投资企业(有限合伙)', '311999995.1', '7612990', '汇添富基金管理股份有限公司', '12', '264999964'}",121101,3,"{'311999995.1', '243293983.6', '264999964'}",5,"{'兴业证券资产管理有限公司', '定价', '广发乾和投资有限公司', '汇添富基金管理股份有限公司', '12'}",13,"{'鹏华资产管理(深圳)有限公司', '12751257', '13888887', '12699423', '兴业证券资产管理有限公司', '16352201', '定价', '242304990.8', '广发乾和投资有限公司', '深圳市保腾丰利创业投资企业(有限合伙)', '7612990', '汇添富基金管理股份有限公司', '12'}"
20,"{'西藏山南中和投资管理中心(有限合伙)', '20964360', '杭州新域欣源投资合伙企业(有限合伙)', '现金', '2096436', '219999993.8', '99999997.2', '中钢资产管理有限责任公司', '29999999.16', '6988120', '299999991.6', '中航祥瑞集合资产管理计划', '10831586', '红土创新红人1号资产管理计划', '10482180', '149999995.8', '154999995.7', '36', '江阴市长江钢管有限公司', '15373864'}",1930392,3,"{'99999997.2', '154999995.7', '29999999.16'}",5,"{'现金', '中钢资产管理有限责任公司', '中航祥瑞集合资产管理计划', '江阴市长江钢管有限公司', '36'}",17,"{'西藏山南中和投资管理中心(有限合伙)', '20964360', '杭州新域欣源投资合伙企业(有限合伙)', '现金', '2096436', '219999993.8', '中钢资产管理有限责任公司', '6988120', '299999991.6', '中航祥瑞集合资产管理计划', '10831586', '红土创新红人1号资产管理计划', '10482180', '149999995.8', '江阴市长江钢管有限公司', '36', '15373864'}"
18,"{'20000000', '中信国安集团公司', '169779300', '12', '高志洪', '杨亚涛', '23000000', '新疆生产建设兵团投资有限责任公司', '上海盛太投资管理有限公司', '杨凯', '竞价', '33000000', '25000000', '50000000', '18779200', '1000000077', '上海证券有限责任公司', '36'}",404190,3,"{'竞价', '33000000', '1000000077'}",9,"{'中信国安集团公司', '杨凯', '12', '高志洪', '杨亚涛', '新疆生产建设兵团投资有限责任公司', '上海盛太投资管理有限公司', '上海证券有限责任公司', '36'}",15,"{'20000000', '中信国安集团公司', '169779300', '12', '高志洪', '杨亚涛', '23000000', '新疆生产建设兵团投资有限责任公司', '上海盛太投资管理有限公司', '杨凯', '25000000', '50000000', '18779200', '上海证券有限责任公司', '36'}"
16,"{'西安锐盈', '154166667', '天津大振', '定价', '21543210', '52780864', '76678241', '60763889', '上海常喜', '33391975', '86805555', '华路新材', '上海大黎', '拉萨澄怀', '拉萨观道', '12'}",1069823,0,set(),9,"{'西安锐盈', '天津大振', '定价', '上海常喜', '拉萨澄怀', '华路新材', '上海大黎', '拉萨观道', '12'}",16,"{'西安锐盈', '154166667', '天津大振', '定价', '21543210', '52780864', '76678241', '60763889', '上海常喜', '33391975', '86805555', '华路新材', '上海大黎', '拉萨澄怀', '拉萨观道', '12'}"
17,"{'百瑞信托投资有限责任公司', '现金', '12', '天津泰达科技风险投资股份有限公司', '定价', '长江证券有限责任公司', '甘肃宝能能源投资开发有限公司', '7000000', '2000000', '中国石化财务有限责任公司', '3000000', '山西信托投资有限责任公司', '中国建银投资证券有限责任公司', '天津信托投资有限责任公司', '9000000', '36', '无锡市宝联投资有限公司'}",1367491,0,set(),5,"{'36', '现金', '天津泰达科技风险投资股份有限公司', '定价', '12'}",17,"{'百瑞信托投资有限责任公司', '现金', '12', '天津泰达科技风险投资股份有限公司', '长江证券有限责任公司', '甘肃宝能能源投资开发有限公司', '定价', '7000000', '2000000', '中国石化财务有限责任公司', '3000000', '山西信托投资有限责任公司', '中国建银投资证券有限责任公司', '天津信托投资有限责任公司', '9000000', '36', '无锡市宝联投资有限公司'}"
26,"{'东吴基金管理有限公司', '87617589.51', '89199998.58', '深圳市华盛十五期股权投资企业(有限合伙)', '267599995.7', '133800007.4', '90782407.65', '前海开源基金管理有限公司', '现金', '579800000.3', '万家基金管理有限公司', '60585162', '9486145', '中广核财务有限责任公司', '9320794', '北信瑞丰基金管理有限公司', '312199995', '华仪电器集团有限公司', '9155443', '员工持股计划', '27962382', '上银基金管理有限公司', '32622779', '上海景贤投资有限公司', '13981192', '36'}",1855959,3,"{'89199998.58', '87617589.51', '90782407.65'}",11,"{'现金', '东吴基金管理有限公司', '北信瑞丰基金管理有限公司', '万家基金管理有限公司', '中广核财务有限责任公司', '员工持股计划', '上海景贤投资有限公司', '华仪电器集团有限公司', '前海开源基金管理有限公司', '36', '上银基金管理有限公司'}",23,"{'东吴基金管理有限公司', '深圳市华盛十五期股权投资企业(有限合伙)', '267599995.7', '133800007.4', '前海开源基金管理有限公司', '现金', '579800000.3', '万家基金管理有限公司', '60585162', '9486145', '中广核财务有限责任公司', '9320794', '北信瑞丰基金管理有限公司', '312199995', '华仪电器集团有限公司', '9155443', '员工持股计划', '27962382', '上银基金管理有限公司', '32622779', '上海景贤投资有限公司', '13981192', '36'}"
15,"{'绍兴县恒旭投资管理合伙企业(普通合伙)', '20000000', '现金', '海南筑华', '40000000', '上海瑞艾林投资管理合伙企业(有限合伙)', '张宇', '12', '西安长形投资管理有限合伙企业', '11000000', '竞价', '宋丽双', '10000000', '30000000', '36'}",914870,1,{'11000000'},8,"{'海南筑华', '现金', '张宇', '12', '西安长形投资管理有限合伙企业', '宋丽双', '竞价', '36'}",14,"{'绍兴县恒旭投资管理合伙企业(普通合伙)', '20000000', '现金', '海南筑华', '40000000', '上海瑞艾林投资管理合伙企业(有限合伙)', '张宇', '12', '西安长形投资管理有限合伙企业', '宋丽双', '竞价', '10000000', '30000000', '36'}"
4,"{'36', '定价', '现金', '创越集团'}",721321,0,set(),4,"{'定价', '现金', '创越集团', '36'}",4,"{'36', '定价', '现金', '创越集团'}"
17,"{'金鹰基金管理有限公司', '32442396', '戚亮', '富国资产管理(上海)有限公司', '长安基金管理有限公司', '27649769', '132000025.9', '351999996.6', '299999993.7', '12165901', '财通基金管理有限公司', '147999989.2', '金元顺安基金管理有限公司', '13640552', '399999995.2', '36866359', '12'}",15789929,3,"{'399999995.2', '299999993.7', '132000025.9'}",6,"{'金鹰基金管理有限公司', '长安基金管理有限公司', '戚亮', '财通基金管理有限公司', '金元顺安基金管理有限公司', '12'}",14,"{'金鹰基金管理有限公司', '32442396', '戚亮', '富国资产管理(上海)有限公司', '长安基金管理有限公司', '27649769', '351999996.6', '12165901', '财通基金管理有限公司', '147999989.2', '金元顺安基金管理有限公司', '13640552', '36866359', '12'}"
18,"{'山东滕铭商贸有限公司', '上海誉献投资有限公司', '18790000', '现金', '27660000', '20000000', '37155266', '36500000', '定价', '河南迪依电气设备销售有限公司', '10720000', '22040000', '深圳市德美高投资发展有限公司', '上海旭森置业有限公司', '北京世纪隆鑫投资发展有限公司', '深圳市中投国道资产管理有限公司', '深圳农银国际资产管理有限公司', '36'}",1238648,1,{'山东滕铭商贸有限公司'},10,"{'上海誉献投资有限公司', '现金', '定价', '河南迪依电气设备销售有限公司', '深圳市德美高投资发展有限公司', '上海旭森置业有限公司', '北京世纪隆鑫投资发展有限公司', '深圳市中投国道资产管理有限公司', '深圳农银国际资产管理有限公司', '36'}",17,"{'37155266', '上海誉献投资有限公司', '18790000', '现金', '27660000', '20000000', '36500000', '10720000', '河南迪依电气设备销售有限公司', '定价', '22040000', '深圳市德美高投资发展有限公司', '上海旭森置业有限公司', '北京世纪隆鑫投资发展有限公司', '深圳市中投国道资产管理有限公司', '深圳农银国际资产管理有限公司', '36'}"
24,"{'长城国融', '温氏投资', '现金', '40000000', '36000000', '2431118', '竞价', '7293354', '粤垦投资', '180000000', '30000000', '1215559', '60000000', '湛江农垦', '77499600', '现代种业', '1458670', '100000000', '4051863', '3140178', '沈汉标', '燕塘乳业1号', '1620745', '36'}",14252173,15,"{'36000000', '40000000', '77499600', '2431118', '1458670', '100000000', '4051863', '3140178', '30000000', '60000000', '竞价', '7293354', '180000000', '1620745', '1215559'}",9,"{'现金', '现代种业', '长城国融', '沈汉标', '粤垦投资', '燕塘乳业1号', '温氏投资', '湛江农垦', '36'}",9,"{'现金', '现代种业', '长城国融', '沈汉标', '粤垦投资', '燕塘乳业1号', '温氏投资', '湛江农垦', '36'}"
26,"{'62547384', '湖南广播电视产业中心', '530000012.8', '上海海通证券资产管理有限公司', '553999996', '泰达宏利基金管理有限公司', '40181957', '45489006', '新华基金管理有限公司', '790999986.9', '财通基金管理有限公司', '59969673', '36', '658999993.5', '广发证券股份有限公司', '203189232.9', '国华人寿保险股份有限公司', '42001516', '49962092', '深圳市融通资本财富管理有限公司', '15404794', '824999995', '599999989.1', '1134999988', '86050037', '12'}",1084546,4,"{'658999993.5', '790999986.9', '824999995', '203189232.9'}",10,"{'新华基金管理有限公司', '湖南广播电视产业中心', '广发证券股份有限公司', '12', '国华人寿保险股份有限公司', '上海海通证券资产管理有限公司', '财通基金管理有限公司', '泰达宏利基金管理有限公司', '深圳市融通资本财富管理有限公司', '36'}",22,"{'62547384', '湖南广播电视产业中心', '530000012.8', '上海海通证券资产管理有限公司', '553999996', '泰达宏利基金管理有限公司', '40181957', '45489006', '新华基金管理有限公司', '财通基金管理有限公司', '59969673', '36', '广发证券股份有限公司', '国华人寿保险股份有限公司', '42001516', '49962092', '深圳市融通资本财富管理有限公司', '15404794', '599999989.1', '1134999988', '86050037', '12'}"
21,"{'5162622', '刘慧', '泰达宏利基金管理有限公司', '131999983.6', '99999988.14', '红塔红土基金管理有限公司', '现金', '鹏华资产管理有限公司', '68000050.82', '宜昌城市建设投资控股集团有限公司', '竞价', '宜昌交通旅游产业发展集团有限公司', '3510586', '平安大华基金管理有限公司', '36', '宜昌高新投资开发有限公司', '宜昌国有资本投资控股集团有限公司', '云基地投资发展(北京)有限公司', '100000000', '6814661', '12'}",16781205,4,"{'竞价', '131999983.6', '99999988.14', '68000050.82'}",11,"{'平安大华基金管理有限公司', '36', '现金', '鹏华资产管理有限公司', '刘慧', '宜昌城市建设投资控股集团有限公司', '宜昌国有资本投资控股集团有限公司', '泰达宏利基金管理有限公司', '宜昌交通旅游产业发展集团有限公司', '12', '红塔红土基金管理有限公司'}",17,"{'平安大华基金管理有限公司', '3510586', '现金', '鹏华资产管理有限公司', '刘慧', '100000000', '宜昌城市建设投资控股集团有限公司', '12', '6814661', '宜昌高新投资开发有限公司', '5162622', '宜昌国有资本投资控股集团有限公司', '泰达宏利基金管理有限公司', '云基地投资发展(北京)有限公司', '宜昌交通旅游产业发展集团有限公司', '36', '红塔红土基金管理有限公司'}"
16,"{'现金', '工银瑞信基金管理有限公司', '华泰资产管理有限公司受托管理前海人寿保险股份有限公司-自有资金华泰组合', '12', '174855528.2', '15700000', '丹东东方新能源有限公司', '竞价', '26300000', '164638000', '长信基金管理有限责任公司', '23800000', '27932193', '98282000', '148988000', '36'}",1036977,2,"{'174855528.2', '竞价'}",3,"{'现金', '12', '丹东东方新能源有限公司'}",14,"{'现金', '工银瑞信基金管理有限公司', '华泰资产管理有限公司受托管理前海人寿保险股份有限公司-自有资金华泰组合', '12', '15700000', '丹东东方新能源有限公司', '26300000', '164638000', '长信基金管理有限责任公司', '23800000', '27932193', '98282000', '148988000', '36'}"
6,"{'现金', '64382795', '定价', '399817157', '36', '中国电子信息产业集团有限公司'}",1211460,2,"{'定价', '399817157'}",3,"{'现金', '36', '中国电子信息产业集团有限公司'}",4,"{'36', '64382795', '现金', '中国电子信息产业集团有限公司'}"
5,"{'宜化集团', '现金', '320000000', '竞价', '36'}",205237,1,{'320000000'},4,"{'宜化集团', '竞价', '现金', '36'}",4,"{'宜化集团', '竞价', '现金', '36'}"
4,"{'新兴际华集团', '竞价', '现金', '36'}",1823799,0,set(),4,"{'新兴际华集团', '竞价', '现金', '36'}",4,"{'新兴际华集团', '竞价', '现金', '36'}"
13,"{'36', '现金', '1026216880', '高瓴资本管理有限公司', '信诚基金管理有限公司', '37181771', '12681159', '竞价', '349999988.4', '12465733', '陈邦', '344054230.8', '12'}",18869299,1,{'1026216880'},7,"{'现金', '高瓴资本管理有限公司', '12', '信诚基金管理有限公司', '竞价', '陈邦', '36'}",12,"{'36', '现金', '高瓴资本管理有限公司', '信诚基金管理有限公司', '37181771', '12681159', '349999988.4', '竞价', '12465733', '陈邦', '344054230.8', '12'}"
3,"{'四川国栋建设集团有限公司', '现金', '36'}",409433,0,set(),3,"{'四川国栋建设集团有限公司', '现金', '36'}",3,"{'四川国栋建设集团有限公司', '现金', '36'}"
11,"{'湖南轻盐创业投资管理有限公司', '5208333', '961000', '湖南高新创投财富管理有限公司', '湖南省粮油食品进出口集团有限公司', '26041667', '长沙新翔股权投资合伙企业(有限合伙)', '长沙新翼股权投资合伙企业(有限合伙)', '湖南省天心实业集团有限公司', '52083333', '2475000'}",561960,7,"{'5208333', '961000', '26041667', '长沙新翼股权投资合伙企业(有限合伙)', '长沙新翔股权投资合伙企业(有限合伙)', '52083333', '2475000'}",4,"{'湖南省天心实业集团有限公司', '湖南轻盐创业投资管理有限公司', '湖南高新创投财富管理有限公司', '湖南省粮油食品进出口集团有限公司'}",4,"{'湖南省天心实业集团有限公司', '湖南轻盐创业投资管理有限公司', '湖南高新创投财富管理有限公司', '湖南省粮油食品进出口集团有限公司'}"
14,"{'现金', '199999996.6', '166499999.8', '13413816', '张霞', '11167002', '19999990.71', '侯文奇', '顾庆伟', '幸建平', '24999999.57', '1341381', '36', '1676727'}",16435874,3,"{'19999990.71', '199999996.6', '24999999.57'}",6,"{'现金', '张霞', '侯文奇', '顾庆伟', '幸建平', '36'}",11,"{'现金', '166499999.8', '13413816', '张霞', '11167002', '侯文奇', '顾庆伟', '幸建平', '1341381', '36', '1676727'}"
13,"{'陈慕群', '现金', '16000000', '蒋仕波', '定价', '7000000', '2000000', '长安天天向上龟龄集资产管理计划', '3000000', '长安平安富贵定坤丹资产管理计划', '财富证券-广誉远安宫清心集合资产管理计划', '重庆涪商投资控股集团股份有限公司', '36'}",1715251,2,"{'定价', '2000000'}",3,"{'长安天天向上龟龄集资产管理计划', '现金', '长安平安富贵定坤丹资产管理计划'}",11,"{'陈慕群', '现金', '16000000', '蒋仕波', '7000000', '长安天天向上龟龄集资产管理计划', '3000000', '长安平安富贵定坤丹资产管理计划', '财富证券-广誉远安宫清心集合资产管理计划', '重庆涪商投资控股集团股份有限公司', '36'}"
5,"{'现金', '长港燃气', '525700000', '79410876', '36'}",16365152,0,set(),3,"{'现金', '36', '长港燃气'}",5,"{'现金', '长港燃气', '525700000', '79410876', '36'}"
6,"{'现金', '400000000', '132013200', '定价', '广州盛景投资有限公司', '36'}",1054035,2,"{'132013200', '400000000'}",4,"{'36', '广州盛景投资有限公司', '定价', '现金'}",4,"{'广州盛景投资有限公司', '定价', '现金', '36'}"
26,"{'83644444', '213266668', '14057889', '现金', '31630252', '188200000', '华昊投资', '竞价', '298000000', '陈庚发', '625800000', '135294117', '105176470', '许锡忠', '海之门休闲', '805000000', '前海佳浩', '前海世嘉方盛', '178800000', '35843137', '蒙商基金', '167288888', '30050420', '前海富荣', '36', '28115779'}",1848900,16,"{'105176470', '178800000', '31630252', '35843137', '188200000', '83644444', '167288888', '625800000', '213266668', '30050420', '竞价', '14057889', '805000000', '298000000', '135294117', '28115779'}",10,"{'现金', '华昊投资', '蒙商基金', '许锡忠', '海之门休闲', '陈庚发', '前海富荣', '前海佳浩', '36', '前海世嘉方盛'}",10,"{'现金', '华昊投资', '蒙商基金', '许锡忠', '海之门休闲', '陈庚发', '前海富荣', '前海佳浩', '36', '前海世嘉方盛'}"
19,"{'5000000', '8000000', '18200000', '91000000', '29120000', '上海儒亿投资管理合伙企业(有限合伙)', '张新美', '刘锐', '北京电信建筑工程有限公司', '竞价', '林忠峰', '25000000', '龙建播', '罗斌', '36400000', '10000000', '连若晹', '36', '赵序宏'}",581667,5,"{'18200000', '91000000', '29120000', '竞价', '36400000'}",9,"{'张新美', '刘锐', '北京电信建筑工程有限公司', '林忠峰', '罗斌', '龙建播', '连若晹', '36', '赵序宏'}",14,"{'5000000', '8000000', '上海儒亿投资管理合伙企业(有限合伙)', '张新美', '刘锐', '北京电信建筑工程有限公司', '林忠峰', '25000000', '罗斌', '龙建播', '10000000', '连若晹', '36', '赵序宏'}"
15,"{'36', '现金', '长安基金管理有限公司', '北信瑞丰基金管理有限公司', '民生加银基金管理有限公司', '61503417', '定价', '国华人寿保险股份有限公司', '109339407', '76309794', '金元顺安基金管理有限公司', '59225512', '叶林富', '113895216', '12'}",14785333,0,set(),5,"{'现金', '12', '定价', '叶林富', '36'}",15,"{'36', '长安基金管理有限公司', '北信瑞丰基金管理有限公司', '民生加银基金管理有限公司', '61503417', '现金', '国华人寿保险股份有限公司', '109339407', '76309794', '定价', '金元顺安基金管理有限公司', '59225512', '叶林富', '113895216', '12'}"
3,"{'728685018', '36', '上海华信石油集团有限公司'}",1135701,0,set(),2,"{'36', '上海华信石油集团有限公司'}",3,"{'728685018', '36', '上海华信石油集团有限公司'}"
22,"{'107625000', '华安基金管理有限公司', '安徽省铁路建设投资基金有限公司', '10250000', '15230000', '光大金控(上海)投资中心(有限合伙)', '现金', '8638095', '财通基金管理有限公司', '竞价', '开源证券有限责任公司', '134820000', '12840000', '北信瑞丰基金管理有限公司', '159915000', '203070000', '19340000', '18690000', '196245000', '长江证券股份有限公司', '90699997.5', '12'}",341860,0,set(),8,"{'现金', '北信瑞丰基金管理有限公司', '华安基金管理有限公司', '安徽省铁路建设投资基金有限公司', '财通基金管理有限公司', '长江证券股份有限公司', '开源证券有限责任公司', '12'}",22,"{'107625000', '华安基金管理有限公司', '安徽省铁路建设投资基金有限公司', '10250000', '15230000', '光大金控(上海)投资中心(有限合伙)', '现金', '8638095', '财通基金管理有限公司', '竞价', '开源证券有限责任公司', '134820000', '12840000', '北信瑞丰基金管理有限公司', '159915000', '203070000', '19340000', '18690000', '196245000', '长江证券股份有限公司', '90699997.5', '12'}"
15,"{'现金', '玉泉400号资管计划', '100000000', '定价', '中国再生资源开发有限公司', '15082956', '200000000', '四川省物流产业股权投资基金管理有限公司', '玉泉399号资管计划', '银晟资本(天津)股权投资基金管理有限公司', '500000000', '供销集团北京鑫诚投资基金管理有限公司', '30165912', '36', '75414782'}",1813817,3,"{'75414782', '200000000', '500000000'}",6,"{'现金', '定价', '中国再生资源开发有限公司', '供销集团北京鑫诚投资基金管理有限公司', '36', '四川省物流产业股权投资基金管理有限公司'}",12,"{'现金', '玉泉400号资管计划', '100000000', '15082956', '定价', '中国再生资源开发有限公司', '四川省物流产业股权投资基金管理有限公司', '银晟资本(天津)股权投资基金管理有限公司', '供销集团北京鑫诚投资基金管理有限公司', '30165912', '36', '玉泉399号资管计划'}"
14,"{'馨羽实业', '20000000', '现金', '戴氏实业', '钱峰投资', '8600000', '驭健投资', '13000000', '宏望资产', '源进投资', '泓泽资产', '上海泓泽', '10000000', '36'}",1145053,1,{'13000000'},10,"{'馨羽实业', '现金', '戴氏实业', '钱峰投资', '驭健投资', '宏望资产', '源进投资', '泓泽资产', '上海泓泽', '36'}",13,"{'馨羽实业', '20000000', '现金', '戴氏实业', '钱峰投资', '8600000', '驭健投资', '宏望资产', '源进投资', '泓泽资产', '上海泓泽', '10000000', '36'}"
6,"{'现金', '梅小明', '楼建峰', '杭州联创投资管理有限公司', '上海宣浦股权投资基金合伙企业', '36'}",311287,0,set(),6,"{'梅小明', '现金', '楼建峰', '杭州联创投资管理有限公司', '上海宣浦股权投资基金合伙企业', '36'}",6,"{'现金', '梅小明', '楼建峰', '杭州联创投资管理有限公司', '上海宣浦股权投资基金合伙企业', '36'}"
5,"{'现金', '吕晓义', '竞价', '50000000', '36'}",1323448,1,{'50000000'},4,"{'吕晓义', '现金', '竞价', '36'}",4,"{'吕晓义', '现金', '竞价', '36'}"
4,"{'新兴际华集团', '竞价', '现金', '36'}",9898910,0,set(),4,"{'新兴际华集团', '竞价', '现金', '36'}",4,"{'新兴际华集团', '竞价', '现金', '36'}"
9,"{'现金', '广发证券股份有限公司', '695410', '中邮创业基金管理股份有限公司', '1390820', '广发基金管理有限公司', '19999991.6', '9999995.8', '12'}",1877605,0,set(),5,"{'现金', '广发证券股份有限公司', '中邮创业基金管理股份有限公司', '广发基金管理有限公司', '12'}",9,"{'现金', '广发证券股份有限公司', '695410', '中邮创业基金管理股份有限公司', '1390820', '广发基金管理有限公司', '19999991.6', '9999995.8', '12'}"
12,"{'现金', '12481644', '649999981.1', '博时基金管理有限公司', '南京华泰瑞联并购基金二号(有限合伙)', '华泰资产管理有限公司', '31815956', '竞价', '8640442', '176524230.1', '254999986.9', '12'}",16539723,3,"{'竞价', '176524230.1', '649999981.1'}",4,"{'现金', '博时基金管理有限公司', '12', '华泰资产管理有限公司'}",9,"{'现金', '12481644', '博时基金管理有限公司', '南京华泰瑞联并购基金二号(有限合伙)', '华泰资产管理有限公司', '31815956', '8640442', '254999986.9', '12'}"
6,"{'现金', '12', '竞价', '安徽国资运营公司', '中钢股份', '36'}",1260348,0,set(),6,"{'现金', '12', '竞价', '安徽国资运营公司', '中钢股份', '36'}",6,"{'36', '现金', '竞价', '安徽国资运营公司', '中钢股份', '12'}"
4,"{'36', '竞价', '现金', '呼和浩特投资有限责任公司'}",1141440,1,{'竞价'},3,"{'36', '现金', '呼和浩特投资有限责任公司'}",3,"{'36', '现金', '呼和浩特投资有限责任公司'}"
21,"{'12184230', '共青城朴海投资管理合伙企业(有限合伙)', '朔明德投资有限公司', '5414230', '920910', '99946685.8', '现金', '4333694', '224920885.8', '竞价', '常州投资集团有限公司', '69856885.8', '1625135', '16999998.6', '29999992.1', '79999991.24', '3784230', '上海爱屋企业管理有限公司', '上海趵朴投资管理有限公司', '12', '汇安基金管理有限责任公司'}",19351866,2,"{'竞价', '79999991.24'}",7,"{'现金', '上海爱屋企业管理有限公司', '上海趵朴投资管理有限公司', '朔明德投资有限公司', '常州投资集团有限公司', '12', '汇安基金管理有限责任公司'}",19,"{'1625135', '现金', '上海爱屋企业管理有限公司', '12184230', '16999998.6', '朔明德投资有限公司', '共青城朴海投资管理合伙企业(有限合伙)', '5414230', '99946685.8', '224920885.8', '汇安基金管理有限责任公司', '29999992.1', '上海趵朴投资管理有限公司', '920910', '常州投资集团有限公司', '4333694', '69856885.8', '12', '3784230'}"
11,"{'5000000', '现金', '10300000', '北京健坤投资集团有限公司', '71276000', '北京雅才投资管理有限公司', '37156647', '257124000', '泰康资产管理有限责任公司', '34600000', '12'}",1105564,3,"{'257124000', '71276000', '34600000'}",5,"{'现金', '北京健坤投资集团有限公司', '北京雅才投资管理有限公司', '泰康资产管理有限责任公司', '12'}",8,"{'5000000', '现金', '10300000', '北京健坤投资集团有限公司', '37156647', '北京雅才投资管理有限公司', '泰康资产管理有限责任公司', '12'}"
12,"{'现金', '民权中证国投创业投资基金(有限合伙)', '北京芯动能投资基金(有限合伙)', '49999992', '3982080', '财通基金管理有限公司', '79999987.2', '2488800', '3529120', '竞价', '70900020.8', '12'}",19230597,1,{'竞价'},3,"{'现金', '12', '财通基金管理有限公司'}",11,"{'现金', '民权中证国投创业投资基金(有限合伙)', '北京芯动能投资基金(有限合伙)', '49999992', '3982080', '财通基金管理有限公司', '79999987.2', '2488800', '3529120', '70900020.8', '12'}"
3,"{'东宝胜集团', '现金', '36'}",420498,0,set(),3,"{'东宝胜集团', '现金', '36'}",3,"{'东宝胜集团', '现金', '36'}"
26,"{'9072371', '安徽省铁路建设投资基金有限公司', '易方达基金管理有限公司', '8361106', '229530986.3', '泰达宏利基金管理有限公司', '8368893', '26320790', '现金', '8398418', '218399998.3', '财通基金管理有限公司', '安徽省投资集团控股有限公司', '212479975.4', '8500000', '北信瑞丰基金管理有限公司', '665915987', '8632411', '215050000', '95354055.5', '211732992.9', '211535981.8', '国泓资产管理有限公司', '山西证券股份有限公司', '3768935', '12'}",312782,0,set(),10,"{'国泓资产管理有限公司', '现金', '北信瑞丰基金管理有限公司', '山西证券股份有限公司', '安徽省铁路建设投资基金有限公司', '财通基金管理有限公司', '安徽省投资集团控股有限公司', '易方达基金管理有限公司', '泰达宏利基金管理有限公司', '12'}",26,"{'9072371', '安徽省铁路建设投资基金有限公司', '易方达基金管理有限公司', '8361106', '229530986.3', '泰达宏利基金管理有限公司', '8368893', '26320790', '现金', '8398418', '218399998.3', '财通基金管理有限公司', '安徽省投资集团控股有限公司', '212479975.4', '8500000', '北信瑞丰基金管理有限公司', '665915987', '8632411', '215050000', '95354055.5', '211732992.9', '211535981.8', '国泓资产管理有限公司', '山西证券股份有限公司', '3768935', '12'}"
19,"{'上海新源投资有限公司', '20000000', '现金', '山西国际电力集团有限公司', '宁波罗冠制衣有限公司', '新华人寿保险股份有限公司', '瑞士银行(UBS AG)', '上海潞安投资有限公司', '12', '8000000', '上投摩根基金管理有限公司', '中国电力投资集团公司', '中国人寿资产管理有限公司', '中国建银投资证券有限责任公司', '6500000', '10000000', '80085000', '60415000', '36'}",1353930,5,"{'山西国际电力集团有限公司', '瑞士银行(UBS AG)', '6500000', '80085000', '60415000'}",4,"{'36', '12', '中国电力投资集团公司', '上投摩根基金管理有限公司'}",14,"{'上海新源投资有限公司', '20000000', '现金', '8000000', '宁波罗冠制衣有限公司', '新华人寿保险股份有限公司', '上投摩根基金管理有限公司', '上海潞安投资有限公司', '12', '中国电力投资集团公司', '中国人寿资产管理有限公司', '中国建银投资证券有限责任公司', '10000000', '36'}"
6,"{'方振淳', '易方达工商银行中瑞思创定增1号资产管理计划', '4000000', '西藏瑞华投资发展有限公司', '200000000', '36'}",1657593,2,"{'4000000', '200000000'}",3,"{'36', '方振淳', '西藏瑞华投资发展有限公司'}",4,"{'36', '方振淳', '西藏瑞华投资发展有限公司', '易方达工商银行中瑞思创定增1号资产管理计划'}"
16,"{'20000000', '国金证券有限责任公司', '现金', '广州高金技术产业集团有限公司', '上海永瑞投资管理有限公司', '华夏基金管理有限公司', '上海申能资产管理有限公司', '长江证券有限责任公司', '15000000', '广西君合投资有限公司', '25000000', '富国基金管理有限公司', '10000000', '中海基金管理有限公司', '12', '海富通基金管理有限公司'}",537879,9,"{'20000000', '国金证券有限责任公司', '广州高金技术产业集团有限公司', '华夏基金管理有限公司', '25000000', '富国基金管理有限公司', '10000000', '中海基金管理有限公司', '海富通基金管理有限公司'}",2,"{'现金', '12'}",7,"{'现金', '上海永瑞投资管理有限公司', '上海申能资产管理有限公司', '长江证券有限责任公司', '15000000', '广西君合投资有限公司', '12'}"
17,"{'158999991.6', '民生加银基金管理有限公司', '18424101', '54999999.71', '易方达基金管理有限公司', '9327927', '80500010.01', '9733487', '安信基金管理有限责任公司', '宝盈基金管理有限公司', '铜陵凯华投资管理有限责任公司', '6373117', '83999992.81', '11819235', '汇添富基金管理股份有限公司', '12', '101999998.1'}",293348,1,{'101999998.1'},7,"{'民生加银基金管理有限公司', '易方达基金管理有限公司', '安信基金管理有限责任公司', '宝盈基金管理有限公司', '铜陵凯华投资管理有限责任公司', '汇添富基金管理股份有限公司', '12'}",16,"{'158999991.6', '民生加银基金管理有限公司', '18424101', '54999999.71', '易方达基金管理有限公司', '9327927', '80500010.01', '9733487', '安信基金管理有限责任公司', '宝盈基金管理有限公司', '铜陵凯华投资管理有限责任公司', '6373117', '83999992.81', '11819235', '汇添富基金管理股份有限公司', '12'}"
4,"{'竞价', '现金', '36', '周福海'}",4958589,0,set(),4,"{'竞价', '现金', '36', '周福海'}",4,"{'竞价', '现金', '36', '周福海'}"
17,"{'现金', '99960000', '16800000', '江信基金管理有限公司', '14500000', '工银瑞信基金管理有限公司', '86275000', '13000000', '212599997.4', '中广核财务有限责任公司', '北京碧水源科技股份有限公司', '泰康资产管理有限责任公司', '283815000', '77350000', '47700000', '12', '35731092'}",1097278,0,set(),3,"{'现金', '12', '北京碧水源科技股份有限公司'}",17,"{'99960000', '16800000', '江信基金管理有限公司', '14500000', '工银瑞信基金管理有限公司', '212599997.4', '86275000', '13000000', '现金', '中广核财务有限责任公司', '北京碧水源科技股份有限公司', '泰康资产管理有限责任公司', '283815000', '77350000', '47700000', '12', '35731092'}"
19,"{'55294200', '89855986.25', '第一创业证券股份有限公司', '2602080', '4786164', '宏源证券股份有限公司', '申万菱信(上海)资产管理有限公司', '东海基金管理有限责任公司', '101705985', '财通基金管理有限公司', '55200147.5', '120230587.5', '青岛嘉豪投资企业(有限合伙)', '128729015', '5657910', '4228517', '6057836', '2597654', '12'}",279842,1,{'89855986.25'},5,"{'第一创业证券股份有限公司', '宏源证券股份有限公司', '东海基金管理有限责任公司', '财通基金管理有限公司', '12'}",18,"{'55294200', '第一创业证券股份有限公司', '2602080', '4786164', '宏源证券股份有限公司', '申万菱信(上海)资产管理有限公司', '东海基金管理有限责任公司', '101705985', '财通基金管理有限公司', '55200147.5', '120230587.5', '青岛嘉豪投资企业(有限合伙)', '128729015', '5657910', '4228517', '6057836', '2597654', '12'}"
5,"{'11970619', '定价', '浙江华海药业股份有限公司2015年员工持股计划', '209007007.7', '36'}",15060776,0,set(),2,"{'定价', '36'}",5,"{'11970619', '定价', '浙江华海药业股份有限公司2015年员工持股计划', '209007007.7', '36'}"
8,"{'12000000', '北信瑞丰基金管理有限公司', '215682168.8', '新华基金管理股份有限公司', '6698204', '12', '华泰柏瑞基金管理有限公司', '386400000'}",15462575,0,set(),4,"{'华泰柏瑞基金管理有限公司', '北信瑞丰基金管理有限公司', '12', '新华基金管理股份有限公司'}",8,"{'12000000', '北信瑞丰基金管理有限公司', '215682168.8', '新华基金管理股份有限公司', '6698204', '12', '华泰柏瑞基金管理有限公司', '386400000'}"
4,"{'第一期员工持股计划', '36', '24928032', '249529600.3'}",16353426,0,set(),2,"{'第一期员工持股计划', '36'}",4,"{'第一期员工持股计划', '36', '24928032', '249529600.3'}"
4,"{'现金', '36', '20291700', 'LAL公司'}",1568440,0,set(),2,"{'现金', '36'}",4,"{'现金', '36', '20291700', 'LAL公司'}"
8,"{'现金', '10003000000', '4827000000', '国际集团', '国鑫投资', '300000000', '36', '621690490'}",1930015,2,"{'300000000', '621690490'}",4,"{'现金', '36', '国鑫投资', '国际集团'}",6,"{'现金', '10003000000', '4827000000', '国鑫投资', '36', '国际集团'}"
5,"{'379580000', '定价', '中国平安人寿保险股份有限公司', '36', '6931130800'}",1152295,1,{'6931130800'},3,"{'定价', '36', '中国平安人寿保险股份有限公司'}",4,"{'379580000', '定价', '36', '中国平安人寿保险股份有限公司'}"
7,"{'李洪国', '王宪东', '中信建投基金9号资管计划', '孙强', '竞价', '宋华', '36'}",1727766,1,{'竞价'},6,"{'李洪国', '王宪东', '中信建投基金9号资管计划', '孙强', '宋华', '36'}",6,"{'李洪国', '王宪东', '中信建投基金9号资管计划', '孙强', '宋华', '36'}"
4,"{'新疆塔城国际资源有限公司', '现金', '竞价', '36'}",1455119,0,set(),4,"{'新疆塔城国际资源有限公司', '现金', '竞价', '36'}",4,"{'新疆塔城国际资源有限公司', '现金', '竞价', '36'}"
18,"{'170499992.1', '现金', '159500013', '4555808', '杨鹏威', '定价', '博时基金管理有限公司', '4302708', '申万菱信(上海)资产管理有限公司', '4036953', '179999974.1', '120000009.1', '3037206', '4315363', '常州产业投资集团有限公司', '天治基金管理有限公司', '12', '169999993.1'}",12041431,3,"{'120000009.1', '179999974.1', '169999993.1'}",7,"{'现金', '杨鹏威', '博时基金管理有限公司', '定价', '常州产业投资集团有限公司', '天治基金管理有限公司', '12'}",15,"{'170499992.1', '159500013', '现金', '4555808', '杨鹏威', '博时基金管理有限公司', '申万菱信(上海)资产管理有限公司', '4302708', '4036953', '定价', '3037206', '4315363', '常州产业投资集团有限公司', '天治基金管理有限公司', '12'}"
21,"{'红土创新红人1号资产管理计划', '299999991.6', '现金', '219999993.8', '定价', '149999995.8', '江阴市长江钢管有限公司', '中航祥瑞集合资产管理计划', '10482180', '152650007.5', '2096436', '西藏山南中和投资管理中心(有限合伙)', '20964360', '杭州新域欣源投资合伙企业(有限合伙)', '15373864', '中钢资产管理有限责任公司', '29999999.16', '10667366', '99999997.2', '6988120', '36'}",2205504,3,"{'99999997.2', '152650007.5', '29999999.16'}",6,"{'现金', '定价', '中钢资产管理有限责任公司', '中航祥瑞集合资产管理计划', '江阴市长江钢管有限公司', '36'}",18,"{'西藏山南中和投资管理中心(有限合伙)', '20964360', '杭州新域欣源投资合伙企业(有限合伙)', '现金', '2096436', '219999993.8', '定价', '中钢资产管理有限责任公司', '6988120', '299999991.6', '中航祥瑞集合资产管理计划', '10667366', '红土创新红人1号资产管理计划', '10482180', '149999995.8', '江阴市长江钢管有限公司', '36', '15373864'}"
5,"{'现金', '竞价', '安徽国资运营公司', '中钢股份', '36'}",212675,0,set(),5,"{'现金', '竞价', '安徽国资运营公司', '中钢股份', '36'}",5,"{'现金', '竞价', '安徽国资运营公司', '中钢股份', '36'}"
14,"{'5000000', '现金', '黑龙江出版集团有限公司', '百年化妆护理品有限公司', '4000000', '定价', '五矿集团财务有限责任公司', '安徽长钢投资管理有限公司', '2915000', '上海大正投资有限公司', '杭州康帛羽绒制品有限公司', '6000000', '安徽省技术进出口股份有限公司', '12'}",1273122,1,{'2915000'},10,"{'现金', '黑龙江出版集团有限公司', '百年化妆护理品有限公司', '定价', '五矿集团财务有限责任公司', '安徽长钢投资管理有限公司', '上海大正投资有限公司', '杭州康帛羽绒制品有限公司', '安徽省技术进出口股份有限公司', '12'}",13,"{'5000000', '现金', '黑龙江出版集团有限公司', '百年化妆护理品有限公司', '4000000', '定价', '五矿集团财务有限责任公司', '安徽长钢投资管理有限公司', '上海大正投资有限公司', '杭州康帛羽绒制品有限公司', '6000000', '安徽省技术进出口股份有限公司', '12'}"
11,"{'现金', '10075443', '华贸圣佑', '403017', '定价', '探索者创业', '10684000', '聚盛万合', '精一投资', '267100000', '36'}",4945591,1,{'267100000'},7,"{'36', '现金', '华贸圣佑', '定价', '聚盛万合', '精一投资', '探索者创业'}",10,"{'现金', '10075443', '华贸圣佑', '403017', '定价', '探索者创业', '10684000', '聚盛万合', '精一投资', '36'}"
20,"{'安惊川', '5000000', '39650000', '江玉明', '中发控股集团有限公司', '12', '张宇', '李霞', '36874500', '10100000', '4540000', '80093000', '6300000', '49959000', '4650000', '信达澳银基金管理有限公司', '36002200', '36', '117364000', '14800000'}",711555,6,"{'39650000', '36874500', '80093000', '49959000', '36002200', '117364000'}",8,"{'安惊川', '36', '江玉明', '中发控股集团有限公司', '张宇', '李霞', '信达澳银基金管理有限公司', '12'}",14,"{'安惊川', '5000000', '江玉明', '中发控股集团有限公司', '12', '张宇', '李霞', '10100000', '4540000', '6300000', '4650000', '信达澳银基金管理有限公司', '36', '14800000'}"
14,"{'福能武夷', '西藏瑞香投资有限公司', '现金', '琼茅投资', '定价', '14398848', '7199424', '17998560', '21598272', '潜望商贸', '才旺鑫', '洪清平', '辜文实', '36'}",1811216,4,"{'17998560', '14398848', '21598272', '7199424'}",10,"{'福能武夷', '西藏瑞香投资有限公司', '现金', '琼茅投资', '定价', '潜望商贸', '才旺鑫', '洪清平', '辜文实', '36'}",10,"{'福能武夷', '西藏瑞香投资有限公司', '现金', '琼茅投资', '定价', '潜望商贸', '才旺鑫', '洪清平', '辜文实', '36'}"
17,"{'1536923', '平安大华基金管理有限公司', '2447307', '39959998', '37880258', '浙江浙商证券资产管理有限公司', '淮海天玺投资管理有限公司', '财通基金管理有限公司', '华宝信托有限责任公司', '125959782', '竞价', '1923076', '1456933', '49999976', '63629982', '4844607', '12'}",1625655,1,{'竞价'},2,"{'华宝信托有限责任公司', '12'}",16,"{'1536923', '平安大华基金管理有限公司', '2447307', '39959998', '37880258', '浙江浙商证券资产管理有限公司', '淮海天玺投资管理有限公司', '财通基金管理有限公司', '华宝信托有限责任公司', '125959782', '1923076', '1456933', '49999976', '63629982', '4844607', '12'}"
3,"{'第五季国际', '现金', '36'}",1171799,0,set(),3,"{'第五季国际', '现金', '36'}",3,"{'第五季国际', '现金', '36'}"
20,"{'唐山港口实业集团有限公司', '现金', '17391304', '30956521', '25217391', '上银瑞金资本管理有限公司', '长石投资有限公司', '12', '定价', '博时基金管理有限公司', '申万菱信(上海)资产管理有限公司', '财通基金管理有限公司', '57130434', '22695652', '22608695', '36521739', '创金合信基金管理有限公司', '5565220', '汇添富基金管理股份有限公司', '36'}",1652338,0,set(),11,"{'36', '唐山港口实业集团有限公司', '现金', '上银瑞金资本管理有限公司', '长石投资有限公司', '博时基金管理有限公司', '定价', '财通基金管理有限公司', '创金合信基金管理有限公司', '汇添富基金管理股份有限公司', '12'}",20,"{'唐山港口实业集团有限公司', '现金', '17391304', '30956521', '25217391', '上银瑞金资本管理有限公司', '长石投资有限公司', '12', '博时基金管理有限公司', '申万菱信(上海)资产管理有限公司', '定价', '财通基金管理有限公司', '57130434', '22695652', '22608695', '36521739', '创金合信基金管理有限公司', '5565220', '汇添富基金管理股份有限公司', '36'}"
16,"{'48148146', '金鹰基金管理有限公司', '平安大华基金管理有限公司', '现金', '华夏人寿保险股份有限公司', '华安基金管理有限公司', '北京泰生鸿明投资中心(有限合伙)', '26936023', '53872053', '竞价', '26936026', '武汉光谷新技术产业投资有限公司', '宝盈基金管理有限公司', '28619525', '57912470', '12'}",1867869,4,"{'28619525', '竞价', '26936023', '48148146'}",8,"{'平安大华基金管理有限公司', '金鹰基金管理有限公司', '华夏人寿保险股份有限公司', '现金', '华安基金管理有限公司', '武汉光谷新技术产业投资有限公司', '宝盈基金管理有限公司', '12'}",12,"{'平安大华基金管理有限公司', '金鹰基金管理有限公司', '华夏人寿保险股份有限公司', '现金', '华安基金管理有限公司', '北京泰生鸿明投资中心(有限合伙)', '53872053', '26936026', '武汉光谷新技术产业投资有限公司', '宝盈基金管理有限公司', '57912470', '12'}"
21,"{'59510588', '200000000', '定价', '天津信锐', '26472885.3', '华亿投资', '561779953.2', '9358417', '36', '神码软件', '2804331', '中新创投', '21186440', '499909383', '52956503', '88343455.5', '申昌科技', '194770055', '南京汇庆', '1838629323', '12'}",1081355,1,{'定价'},8,"{'36', '天津信锐', '神码软件', '申昌科技', '华亿投资', '中新创投', '南京汇庆', '12'}",20,"{'9358417', '499909383', '59510588', '12', '52956503', '天津信锐', '神码软件', '26472885.3', '88343455.5', '华亿投资', '561779953.2', '中新创投', '194770055', '2804331', '申昌科技', '南京汇庆', '200000000', '1838629323', '36', '21186440'}"
14,"{'36', '现金', '4574246', '博时基金管理有限公司', '116069951.5', '郑州宝益达贸易有限公司', '11000000', '上海莱乐客投资管理合伙企业(有限合伙)', '河南黄河实业集团股份有限公司', '156310000', '8168188', '博弘数君(天津)股权投资基金合伙企业(有限合伙)', '65000035.66', '12'}",1463302,1,{'116069951.5'},6,"{'现金', '12', '博时基金管理有限公司', '郑州宝益达贸易有限公司', '河南黄河实业集团股份有限公司', '36'}",13,"{'36', '4574246', '现金', '博时基金管理有限公司', '郑州宝益达贸易有限公司', '11000000', '上海莱乐客投资管理合伙企业(有限合伙)', '河南黄河实业集团股份有限公司', '156310000', '8168188', '博弘数君(天津)股权投资基金合伙企业(有限合伙)', '65000035.66', '12'}"
5,"{'现金', '国家集成电路基金', '竞价', '1400000000', '36'}",16870869,2,"{'竞价', '1400000000'}",3,"{'现金', '国家集成电路基金', '36'}",3,"{'现金', '国家集成电路基金', '36'}"
5,"{'现金', '330000000', '华远集团', '竞价', '36'}",894756,1,{'330000000'},4,"{'竞价', '现金', '华远集团', '36'}",4,"{'竞价', '现金', '华远集团', '36'}"
5,"{'现金', '1200000000', '63157894', '巨化集团', '36'}",1010941,1,{'1200000000'},3,"{'现金', '36', '巨化集团'}",4,"{'63157894', '现金', '36', '巨化集团'}"
14,"{'海淀科技', '现金', '31300000', '400020400', '699868000', '4470000', '定价', '京泽永兴', '17890000', '刘雷', '林科', '海淀国投', '99949200', '36'}",307129,6,"{'31300000', '400020400', '699868000', '4470000', '17890000', '99949200'}",8,"{'海淀科技', '现金', '定价', '京泽永兴', '刘雷', '林科', '海淀国投', '36'}",8,"{'海淀科技', '现金', '定价', '京泽永兴', '刘雷', '林科', '海淀国投', '36'}"
6,"{'中国信达资产管理股份有限公司', '现金', '1899999998', '定价', '36', '353159851'}",15706227,0,set(),4,"{'36', '中国信达资产管理股份有限公司', '定价', '现金'}",6,"{'中国信达资产管理股份有限公司', '现金', '定价', '1899999998', '36', '353159851'}"
6,"{'现金', '盛屯集团', '94900000', '竞价', '1108432000', '36'}",1875442,3,"{'竞价', '1108432000', '94900000'}",3,"{'36', '盛屯集团', '现金'}",3,"{'现金', '盛屯集团', '36'}"
14,"{'现金', '宋丽华', '振兴基金', '11111111', '新余恒道', '15000000', '28664021', '20224868', '云能金融', '长安基金', '喀什思山', '30000000', '36', '45000000'}",379665,6,"{'11111111', '15000000', '28664021', '20224868', '30000000', '45000000'}",8,"{'现金', '宋丽华', '振兴基金', '新余恒道', '云能金融', '长安基金', '喀什思山', '36'}",8,"{'现金', '宋丽华', '振兴基金', '新余恒道', '云能金融', '长安基金', '喀什思山', '36'}"
17,"{'中国信达资产管理股份有限公司', '20000000', '35331594', '华安基金管理有限公司', '华夏基金管理有限公司', '47984644', '47900000', '47980000', '定价', '英大基金管理有限公司', '57580000', '汇祥田源(天津)投资合伙企业(有限合伙)', '重庆信飞投资管理有限合伙企业(有限合伙)', '57000000', '深圳市平安创新资本投资有限公司', '12', '汇添富基金管理有限公司'}",152602,0,set(),8,"{'中国信达资产管理股份有限公司', '华安基金管理有限公司', '华夏基金管理有限公司', '定价', '英大基金管理有限公司', '深圳市平安创新资本投资有限公司', '12', '汇添富基金管理有限公司'}",17,"{'中国信达资产管理股份有限公司', '20000000', '35331594', '华安基金管理有限公司', '华夏基金管理有限公司', '47984644', '47900000', '47980000', '英大基金管理有限公司', '定价', '57580000', '汇祥田源(天津)投资合伙企业(有限合伙)', '重庆信飞投资管理有限合伙企业(有限合伙)', '57000000', '深圳市平安创新资本投资有限公司', '12', '汇添富基金管理有限公司'}"
9,"{'长信基金-曙光1号', '现金', '定价', '6639000', '48640915', '46406610', '中能投资', '340000000', '36'}",14107594,2,"{'46406610', '340000000'}",5,"{'长信基金-曙光1号', '现金', '定价', '中能投资', '36'}",7,"{'长信基金-曙光1号', '现金', '定价', '6639000', '48640915', '中能投资', '36'}"
2,"{'36', '北京兴诚旺实业有限公司'}",1136183,0,set(),2,"{'36', '北京兴诚旺实业有限公司'}",2,"{'36', '北京兴诚旺实业有限公司'}"
4,"{'竞价', '上海市北高新(集团)有限公司', '36', '股权'}",1787681,0,set(),3,"{'竞价', '股权', '36'}",4,"{'竞价', '上海市北高新(集团)有限公司', '36', '股权'}"
17,"{'576972500', '华安基金管理有限公司', '21650000', '14000000', '374432500', '重庆新丰佳贸易有限公司', '财通基金管理有限公司', '国联安基金管理有限公司', '375765000', '165230000', '竞价', '6200000', '14050000', '373100000', '12', '14100000', '杭州三赢实业有限公司'}",78891,1,{'竞价'},6,"{'华安基金管理有限公司', '国联安基金管理有限公司', '重庆新丰佳贸易有限公司', '财通基金管理有限公司', '12', '杭州三赢实业有限公司'}",16,"{'576972500', '华安基金管理有限公司', '21650000', '14000000', '374432500', '重庆新丰佳贸易有限公司', '财通基金管理有限公司', '国联安基金管理有限公司', '375765000', '165230000', '6200000', '14050000', '373100000', '12', '14100000', '杭州三赢实业有限公司'}"
16,"{'34533930', '24327784', '现金', '7103393', '李超', '上元投资', '4000000', '2000000', '3000000', '21804097', '聚睿投资', '中科祥瑞', '夏传武', '王卫', '36', '王杏才'}",15794527,1,{'34533930'},9,"{'现金', '李超', '上元投资', '聚睿投资', '中科祥瑞', '夏传武', '王卫', '36', '王杏才'}",15,"{'24327784', '7103393', '现金', '李超', '上元投资', '4000000', '2000000', '3000000', '21804097', '聚睿投资', '中科祥瑞', '夏传武', '王卫', '36', '王杏才'}"
17,"{'448949994.9', '15244482', '现金', '上海锦江国际酒店(集团)股份有限公司', '77196290', '20325976', '2273430741', '定价', '上海国际集团资产管理有限公司', '中国长城资产管理公司', '598599993.2', '弘毅(上海)股权投资基金中心(有限合伙)', '10162988', '华安未来资产管理(上海)有限公司', '36', '上海国盛集团投资有限公司', '299299996.6'}",12000193,1,{'2273430741'},6,"{'现金', '定价', '上海国际集团资产管理有限公司', '中国长城资产管理公司', '36', '上海国盛集团投资有限公司'}",16,"{'448949994.9', '15244482', '现金', '上海锦江国际酒店(集团)股份有限公司', '77196290', '20325976', '上海国际集团资产管理有限公司', '定价', '中国长城资产管理公司', '598599993.2', '弘毅(上海)股权投资基金中心(有限合伙)', '10162988', '华安未来资产管理(上海)有限公司', '36', '上海国盛集团投资有限公司', '299299996.6'}"
15,"{'121515996.4', '金鹰基金管理有限公司', '295260000', '127946000', '浙江浙商证券资产管理有限公司', '29302987', '9100000', '定价', '8642674', '财通基金管理有限公司', '21000000', '马跃平', '中科沃土基金管理有限公司', '411999997.2', '12'}",18286630,0,set(),7,"{'金鹰基金管理有限公司', '浙江浙商证券资产管理有限公司', '定价', '财通基金管理有限公司', '马跃平', '中科沃土基金管理有限公司', '12'}",15,"{'121515996.4', '金鹰基金管理有限公司', '295260000', '127946000', '浙江浙商证券资产管理有限公司', '29302987', '9100000', '定价', '8642674', '财通基金管理有限公司', '21000000', '马跃平', '中科沃土基金管理有限公司', '411999997.2', '12'}"
11,"{'19999994.04', '牧原食品股份有限公司第一期员工持股计划', '现金', '300000001.9', '秦英林', '657462', '679999979.9', '22353714', '钱瑛', '9861933', '36'}",1854124,3,"{'19999994.04', '679999979.9', '300000001.9'}",5,"{'牧原食品股份有限公司第一期员工持股计划', '现金', '秦英林', '钱瑛', '36'}",8,"{'牧原食品股份有限公司第一期员工持股计划', '现金', '秦英林', '657462', '22353714', '钱瑛', '9861933', '36'}"
5,"{'现金', '深圳长城汇理资产服务企业(有限合伙)', '365750000', '95000000', '36'}",992734,3,"{'365750000', '95000000', '深圳长城汇理资产服务企业(有限合伙)'}",2,"{'现金', '36'}",2,"{'现金', '36'}"
6,"{'现金', '东吴基金', '建信基金', '9933774', '8278145', '36'}",473668,2,"{'8278145', '9933774'}",4,"{'建信基金', '现金', '36', '东吴基金'}",4,"{'建信基金', '现金', '36', '东吴基金'}"
5,"{'现金', '799713000', '深圳秋石拟筹建和管理的股权投资基金', '109700000', '36'}",312110,1,{'799713000'},3,"{'深圳秋石拟筹建和管理的股权投资基金', '现金', '36'}",4,"{'深圳秋石拟筹建和管理的股权投资基金', '现金', '109700000', '36'}"
5,"{'现金', '北方华锦化学工业集团有限公司', '竞价', '1500000000', '36'}",965026,1,{'1500000000'},4,"{'36', '竞价', '北方华锦化学工业集团有限公司', '现金'}",4,"{'北方华锦化学工业集团有限公司', '竞价', '现金', '36'}"
4,"{'竞价', '上海世茂建设有限公司', '股权', '36'}",1933052,0,set(),4,"{'竞价', '上海世茂建设有限公司', '股权', '36'}",4,"{'竞价', '上海世茂建设有限公司', '股权', '36'}"
20,"{'平安大华基金管理有限公司', '12000000', '36', '浙江浙商证券资产管理有限公司', '兴业全球基金管理有限公司', '定价', '招商基金管理有限公司', '114900000', '天弘基金管理有限公司', '7781984', '11070496', '211999998.4', '124475000', '6500000', '149024993.6', '成都博瑞投资控股集团有限公司', '6000000', '12', '229800000', '太平资产管理有限公司'}",395500,3,"{'12000000', '7781984', '11070496'}",3,"{'36', '定价', '12'}",17,"{'平安大华基金管理有限公司', '36', '浙江浙商证券资产管理有限公司', '兴业全球基金管理有限公司', '定价', '招商基金管理有限公司', '114900000', '天弘基金管理有限公司', '211999998.4', '124475000', '6500000', '149024993.6', '成都博瑞投资控股集团有限公司', '6000000', '12', '229800000', '太平资产管理有限公司'}"
24,"{'37230568', '15676028', '31098461', '560882584.9', '兴业全球基金管理有限公司', '定价', '16982364', '财通基金管理有限公司', '569999996.1', '德邦基金管理有限公司', '21097322', '36', '上海市北高新(集团)有限公司', '诺安基金管理有限公司', '光大保德信基金管理有限公司', '银河基金管理有限公司', '322999999.8', '36635048', '239999988.7', '476117437.9', '269999994.9', '259999992.8', '17635532', '12'}",14253324,3,"{'239999988.7', '560882584.9', '569999996.1'}",9,"{'36', '兴业全球基金管理有限公司', '诺安基金管理有限公司', '定价', '财通基金管理有限公司', '光大保德信基金管理有限公司', '银河基金管理有限公司', '德邦基金管理有限公司', '12'}",21,"{'37230568', '15676028', '31098461', '兴业全球基金管理有限公司', '16982364', '定价', '财通基金管理有限公司', '德邦基金管理有限公司', '21097322', '36', '上海市北高新(集团)有限公司', '诺安基金管理有限公司', '光大保德信基金管理有限公司', '银河基金管理有限公司', '322999999.8', '36635048', '476117437.9', '269999994.9', '259999992.8', '17635532', '12'}"
4,"{'海航商业控股', '竞价', '现金', '36'}",204125,0,set(),4,"{'海航商业控股', '竞价', '现金', '36'}",4,"{'海航商业控股', '竞价', '现金', '36'}"
20,"{'71225000', '华基丰收(天津)投资合伙企业(有限合伙)', '现金', '昆明盈鑫叁玖投资中心(有限合伙)', '99067500', '7650000', '华夏基金管理有限公司', '浙江天堂硅谷久盈股权投资合伙企业(有限合伙)', '6850000', '4000000', '88707500', '51800000', '5500000', '天津硅谷天堂嘉鹏股权投资基金合伙企业(有限合伙)', '103600000', '竞价', '国都证券有限责任公司', '8000000', '12', '汇添富基金管理有限公司'}",1309631,7,"{'71225000', '88707500', '99067500', '51800000', '5500000', '103600000', '竞价'}",5,"{'现金', '华夏基金管理有限公司', '国都证券有限责任公司', '12', '汇添富基金管理有限公司'}",13,"{'华基丰收(天津)投资合伙企业(有限合伙)', '现金', '昆明盈鑫叁玖投资中心(有限合伙)', '7650000', '华夏基金管理有限公司', '浙江天堂硅谷久盈股权投资合伙企业(有限合伙)', '6850000', '4000000', '天津硅谷天堂嘉鹏股权投资基金合伙企业(有限合伙)', '国都证券有限责任公司', '8000000', '12', '汇添富基金管理有限公司'}"
3,"{'现金', '新鸿鹄科技', '36'}",1804805,0,set(),3,"{'36', '新鸿鹄科技', '现金'}",3,"{'现金', '新鸿鹄科技', '36'}"
4,"{'前海开源基金管理有限公司', '现金', '富邦人寿保险股份有限公司', '36'}",311550,0,set(),4,"{'前海开源基金管理有限公司', '现金', '富邦人寿保险股份有限公司', '36'}",4,"{'前海开源基金管理有限公司', '现金', '富邦人寿保险股份有限公司', '36'}"
6,"{'5000000', '中航地产', '深圳中航', '28000000', '股权', '36'}",961823,1,{'28000000'},4,"{'中航地产', '深圳中航', '股权', '36'}",5,"{'5000000', '中航地产', '深圳中航', '股权', '36'}"
4,"{'东方新能源', '现金', '竞价', '36'}",184163,0,set(),4,"{'东方新能源', '现金', '竞价', '36'}",4,"{'东方新能源', '现金', '竞价', '36'}"
9,"{'现金', '安信-苏宁2号', '淘宝(中国)软件', '28232537000', '1861076927', '1000000000', '65919578', '竞价', '36'}",4933068,3,"{'1000000000', '竞价', '28232537000'}",2,"{'现金', '36'}",6,"{'现金', '安信-苏宁2号', '淘宝(中国)软件', '1861076927', '65919578', '36'}"
29,"{'25080000', '华安基金管理有限公司', '33000000', '593670000', '6000000', '299999998.7', '现金', '财通基金管理有限公司', '竞价', '东海证券股份有限公司', '107940000', '13118399', '291438000', '东海基金管理有限责任公司', '中信证券股份有限公司', '北京海胜航信投资合伙企业(有限合伙)', '99999987.57', '16675931', '华商基金管理有限公司', '5558643', '303671200', '兴证证券资产管理有限公司', '北京泰隆华胜科技有限公司', '16880000', '16200000', '451189200', '中国人寿资产管理有限公司', '235999998', '12'}",356465,2,"{'299999998.7', '99999987.57'}",4,"{'兴证证券资产管理有限公司', '竞价', '现金', '12'}",27,"{'25080000', '华安基金管理有限公司', '33000000', '593670000', '6000000', '现金', '财通基金管理有限公司', '东海证券股份有限公司', '竞价', '107940000', '13118399', '291438000', '东海基金管理有限责任公司', '中信证券股份有限公司', '北京海胜航信投资合伙企业(有限合伙)', '16675931', '华商基金管理有限公司', '5558643', '303671200', '兴证证券资产管理有限公司', '北京泰隆华胜科技有限公司', '16880000', '16200000', '451189200', '中国人寿资产管理有限公司', '235999998', '12'}"
13,"{'现金', '17154900', '浙江天堂硅谷乐通股权投资合伙企业', '杭州长城股权投资基金合伙企业', '宁波梅山保税港区响道投资管理合伙企业(有限合伙)', '3100800', '3000000', '宁波聚网投资合伙企业(有限合伙)', '10336000', '宁波梅山保税港区硕嘉投资中心', '江苏聚合创意新兴产业投资基金', '36', '2583980'}",313583,2,"{'宁波聚网投资合伙企业(有限合伙)', '宁波梅山保税港区响道投资管理合伙企业(有限合伙)'}",6,"{'现金', '浙江天堂硅谷乐通股权投资合伙企业', '杭州长城股权投资基金合伙企业', '宁波梅山保税港区硕嘉投资中心', '江苏聚合创意新兴产业投资基金', '36'}",11,"{'现金', '17154900', '浙江天堂硅谷乐通股权投资合伙企业', '杭州长城股权投资基金合伙企业', '3100800', '3000000', '10336000', '宁波梅山保税港区硕嘉投资中心', '江苏聚合创意新兴产业投资基金', '36', '2583980'}"
7,"{'现金', '合肥建翔', '国管中心', '重庆渝资', '竞价', '6300000000', '36'}",1133046,2,"{'竞价', '6300000000'}",5,"{'现金', '合肥建翔', '国管中心', '重庆渝资', '36'}",5,"{'现金', '合肥建翔', '国管中心', '重庆渝资', '36'}"
6,"{'上海均瑶(集团)有限公司', '现金', '239130434', '2200000000', '竞价', '36'}",10803373,3,"{'239130434', '竞价', '2200000000'}",2,"{'现金', '36'}",3,"{'上海均瑶(集团)有限公司', '现金', '36'}"
4,"{'天津药业集团有限公司', '竞价', '现金', '36'}",171564,0,set(),4,"{'天津药业集团有限公司', '竞价', '现金', '36'}",4,"{'天津药业集团有限公司', '竞价', '现金', '36'}"
10,"{'现金', '宁波梅山保税港区愈丰股权投资合伙企业(有限合伙)', '400000000', '100000000', '当代集团', '竞价', '蒋立章', '36', '22234574', '5558643'}",14879053,6,"{'宁波梅山保税港区愈丰股权投资合伙企业(有限合伙)', '400000000', '100000000', '竞价', '5558643', '22234574'}",4,"{'现金', '蒋立章', '36', '当代集团'}",4,"{'现金', '蒋立章', '36', '当代集团'}"
9,"{'210800005', '23105589', '何启强', '现金', '409199981', '竞价', '11902880', '麦正辉', '36'}",2255989,1,{'竞价'},4,"{'36', '何启强', '现金', '麦正辉'}",8,"{'210800005', '23105589', '何启强', '现金', '409199981', '11902880', '麦正辉', '36'}"
25,"{'晋西工业集团有限责任公司', '199980000', '易方达基金管理有限公司', '迪瑞资产管理(杭州)有限公司', '198899998', '36413181', '18081818', '现金', '9090000', '工银瑞信基金管理有限公司', '10454545', '114999995', '中国银河投资管理有限公司', '竞价', '99990000', '7242726', '上海诚鼎二期股权投资基金合伙企业(有限合伙)', '36', '北京瑞昌信达资本管理中心(有限合伙)', '400544991', '17810454', '18180000', '195914994', '12', '79669986'}",408848,1,{'竞价'},7,"{'晋西工业集团有限责任公司', '现金', '工银瑞信基金管理有限公司', '12', '中国银河投资管理有限公司', '易方达基金管理有限公司', '36'}",24,"{'晋西工业集团有限责任公司', '199980000', '易方达基金管理有限公司', '迪瑞资产管理(杭州)有限公司', '198899998', '36413181', '18081818', '现金', '9090000', '工银瑞信基金管理有限公司', '10454545', '114999995', '中国银河投资管理有限公司', '99990000', '7242726', '上海诚鼎二期股权投资基金合伙企业(有限合伙)', '36', '北京瑞昌信达资本管理中心(有限合伙)', '400544991', '17810454', '18180000', '195914994', '12', '79669986'}"
4,"{'竞价', '现金', '36', '医药投资'}",14792635,1,{'竞价'},3,"{'现金', '36', '医药投资'}",3,"{'现金', '36', '医药投资'}"
4,"{'现金', '竞价', '昆钢控股', '36'}",1154194,0,set(),4,"{'36', '竞价', '昆钢控股', '现金'}",4,"{'现金', '竞价', '昆钢控股', '36'}"
30,"{'299999409.8', '59760000', '泰通投资', '200000040.3', '200000007.1', '90361268', '现金', '18000000', '60240976', '17180728', '亚祥投资', '苏州上达', '西域3号', '10000000', '259036148', '张宇', '弘晟投资', '鸿众投资', '999999995.8', '义乌上达', '860000011.4', '33200000', '金鹰穗通5号', '60240966', '96385548', '301204818', '长城一号', '57040016.96', '36', '320000019.4'}",1553195,4,"{'320000019.4', '299999409.8', '860000011.4', '999999995.8'}",10,"{'现金', '张宇', '弘晟投资', '义乌上达', '鸿众投资', '亚祥投资', '泰通投资', '苏州上达', '长城一号', '36'}",26,"{'59760000', '泰通投资', '200000040.3', '200000007.1', '90361268', '现金', '18000000', '60240976', '17180728', '亚祥投资', '苏州上达', '西域3号', '10000000', '259036148', '张宇', '弘晟投资', '鸿众投资', '义乌上达', '33200000', '金鹰穗通5号', '60240966', '96385548', '301204818', '长城一号', '57040016.96', '36'}"
3,"{'苏高新集团', '现金', '36'}",1018832,0,set(),3,"{'苏高新集团', '现金', '36'}",3,"{'苏高新集团', '现金', '36'}"
17,"{'胡惠康', '现金', '5555556', '长航联合', '厦门华鑫丰', '7407407', '87777777', '当代文化', '13888889', '吕桧瑛', '南方资本-当代东方定向增发专项资产管理计划', '50925926', '4629630', '先锋亚太', '9259259', '36', '厦门旭熙'}",1571267,7,"{'5555556', '7407407', '87777777', '13888889', '50925926', '4629630', '9259259'}",9,"{'胡惠康', '现金', '长航联合', '厦门华鑫丰', '当代文化', '吕桧瑛', '先锋亚太', '36', '厦门旭熙'}",10,"{'胡惠康', '现金', '长航联合', '厦门华鑫丰', '当代文化', '吕桧瑛', '南方资本-当代东方定向增发专项资产管理计划', '先锋亚太', '36', '厦门旭熙'}"
15,"{'150000000', '现金', '600000000', '350000000', '定价', '200000000', '47021943', '62695924', '延万华', '黄山海慧科技投资有限公司', '109717868', '新华联控股有限公司', '36', '杜玉岱', '188087774'}",16923903,4,"{'150000000', '350000000', '200000000', '600000000'}",7,"{'现金', '定价', '延万华', '黄山海慧科技投资有限公司', '新华联控股有限公司', '36', '杜玉岱'}",11,"{'现金', '47021943', '定价', '62695924', '延万华', '黄山海慧科技投资有限公司', '109717868', '新华联控股有限公司', '36', '杜玉岱', '188087774'}"
5,"{'好当家集团', '现金', '竞价', '120000000', '36'}",1461555,1,{'120000000'},4,"{'好当家集团', '竞价', '现金', '36'}",4,"{'好当家集团', '竞价', '现金', '36'}"
14,"{'平安大华基金管理有限公司', '南京瑞森投资管理合伙企业(有限合伙)', '东海瑞京资产管理(上海)有限公司', '25984251', '深圳市吉富启瑞投资合伙企业(有限合伙)', '宝盈基金管理有限公司', '中广核财务有限责任公司', '财通基金管理有限公司', '23622049', '竞价', '12598425', '13385826', '25196850', '12'}",570798,3,"{'23622049', '25984251', '竞价'}",1,{'12'},11,"{'平安大华基金管理有限公司', '南京瑞森投资管理合伙企业(有限合伙)', '东海瑞京资产管理(上海)有限公司', '深圳市吉富启瑞投资合伙企业(有限合伙)', '宝盈基金管理有限公司', '中广核财务有限责任公司', '财通基金管理有限公司', '12598425', '13385826', '25196850', '12'}"
22,"{'盈峰投资控股集团有限公司', '曹国路', '张杏芝', '申万菱信基金管理有限公司', '51527995.2', '现金', '37973520', '85999996.8', '7156666', '竞价', '54999993.6', '5274100', '54749995.2', '149999997.6', '36', '北京东信文金投资有限责任公司', '20833333', '11944444', '融通基金管理有限公司', '7604166', '7638888', '12'}",442134,0,set(),10,"{'36', '现金', '北京东信文金投资有限责任公司', '融通基金管理有限公司', '盈峰投资控股集团有限公司', '曹国路', '竞价', '张杏芝', '申万菱信基金管理有限公司', '12'}",22,"{'盈峰投资控股集团有限公司', '曹国路', '张杏芝', '申万菱信基金管理有限公司', '51527995.2', '现金', '37973520', '85999996.8', '7156666', '竞价', '54999993.6', '5274100', '54749995.2', '149999997.6', '36', '北京东信文金投资有限责任公司', '20833333', '11944444', '融通基金管理有限公司', '7604166', '7638888', '12'}"
6,"{'现金', '海航集团有限公司', '297619047', '海南省发展控股有限公司', '竞价', '36'}",416769,1,{'竞价'},4,"{'海南省发展控股有限公司', '现金', '36', '海航集团有限公司'}",5,"{'现金', '海航集团有限公司', '297619047', '海南省发展控股有限公司', '36'}"
23,"{'1059547', '220297973.6', '110471365.3', '4668319', '申万菱信基金管理有限公司', '129961590.3', '124375096.6', '朱烨东', '2340991', '财通基金管理有限公司', '竞价', '青岛城投金融控股集团有限公司', '2635624', '36', '4180080', '197257975.2', '139635965', '2754007', '华融国际信托有限责任公司', '2959016', '50000022.93', '凯银投资管理有限公司', '12'}",1924145,3,"{'124375096.6', '竞价', '110471365.3'}",8,"{'36', '凯银投资管理有限公司', '朱烨东', '财通基金管理有限公司', '青岛城投金融控股集团有限公司', '申万菱信基金管理有限公司', '华融国际信托有限责任公司', '12'}",20,"{'50000022.93', '凯银投资管理有限公司', '1059547', '4180080', '220297973.6', '12', '朱烨东', '2340991', '财通基金管理有限公司', '197257975.2', '139635965', '4668319', '青岛城投金融控股集团有限公司', '申万菱信基金管理有限公司', '2754007', '华融国际信托有限责任公司', '129961590.3', '2959016', '36', '2635624'}"
5,"{'54800000', '现金', '竞价', '36', '吴建新'}",4936840,1,{'54800000'},4,"{'竞价', '现金', '36', '吴建新'}",4,"{'竞价', '现金', '36', '吴建新'}"
8,"{'24330900', '湖南兴湘创富投资有限公司', '15000000', '7299200', '湖南金霞粮食产业有限公司', '50693501', '湘江产业投资有限责任公司', '湖南发展投资集团有限公司'}",134590,4,"{'24330900', '50693501', '15000000', '7299200'}",4,"{'湖南金霞粮食产业有限公司', '湖南兴湘创富投资有限公司', '湘江产业投资有限责任公司', '湖南发展投资集团有限公司'}",4,"{'湖南金霞粮食产业有限公司', '湖南兴湘创富投资有限公司', '湘江产业投资有限责任公司', '湖南发展投资集团有限公司'}"
18,"{'24800000', '20000000', '山西证券股份有限公司', '兴业全球基金管理有限公司', '华安基金管理有限公司', '26400000', '12', '定价', '32000000', '财通基金管理有限公司', '上海浦东发展(集团)有限公司', '31100000', '上海星河数码投资有限公司', '中国人寿资产管理有限公司', '长信基金管理有限责任公司', '18100000', '24300000', '36'}",143157,3,"{'31100000', '32000000', '26400000'}",10,"{'山西证券股份有限公司', '兴业全球基金管理有限公司', '华安基金管理有限公司', '12', '定价', '财通基金管理有限公司', '上海星河数码投资有限公司', '中国人寿资产管理有限公司', '长信基金管理有限责任公司', '36'}",15,"{'24800000', '36', '20000000', '山西证券股份有限公司', '兴业全球基金管理有限公司', '华安基金管理有限公司', '定价', '财通基金管理有限公司', '上海浦东发展(集团)有限公司', '上海星河数码投资有限公司', '中国人寿资产管理有限公司', '长信基金管理有限责任公司', '18100000', '24300000', '12'}"
3,"{'桐昆控股', '300000000', '现金'}",1676666,1,{'300000000'},2,"{'桐昆控股', '现金'}",2,"{'桐昆控股', '现金'}"
12,"{'深圳平安大华汇通财富管理有限公司', '现金', '10064914', '定价', '16778523', '179960662.3', '财通基金管理有限公司', '13500838', '中信建投基金管理有限公司', '299999991.2', '12', '241394983.4'}",4931452,1,{'定价'},5,"{'深圳平安大华汇通财富管理有限公司', '现金', '财通基金管理有限公司', '中信建投基金管理有限公司', '12'}",11,"{'深圳平安大华汇通财富管理有限公司', '现金', '10064914', '16778523', '179960662.3', '财通基金管理有限公司', '13500838', '中信建投基金管理有限公司', '299999991.2', '12', '241394983.4'}"
4,"{'新力达集团', '竞价', '现金', '36'}",1735166,0,set(),4,"{'新力达集团', '竞价', '现金', '36'}",4,"{'新力达集团', '竞价', '现金', '36'}"
3,"{'资产、现金', '1800000000', '南航集团'}",16842919,2,"{'资产、现金', '1800000000'}",1,{'南航集团'},1,{'南航集团'}
15,"{'吴光明', '上海云锋新创股权投资中心(有限合伙)', '现金', '上海盛宇股权投资中心(有限合伙)', '3975014', '宋文雷', '定价', '西藏瑞华资本管理有限公司', '5110732', '上海朱雀投资发展中心(有限合伙)', '5678591', '华润万东医疗装备股份有限公司2015年度员工持股计划', '1703581', '36', '2839295'}",1874747,0,set(),6,"{'吴光明', '现金', '定价', '西藏瑞华资本管理有限公司', '宋文雷', '36'}",15,"{'吴光明', '上海云锋新创股权投资中心(有限合伙)', '上海盛宇股权投资中心(有限合伙)', '3975014', '现金', '宋文雷', '定价', '西藏瑞华资本管理有限公司', '5110732', '上海朱雀投资发展中心(有限合伙)', '5678591', '华润万东医疗装备股份有限公司2015年度员工持股计划', '1703581', '36', '2839295'}"
6,"{'现金', '100000000', '焦阳洋', '竞价', '宝泰隆集团', '36'}",711368,1,{'100000000'},5,"{'现金', '焦阳洋', '竞价', '宝泰隆集团', '36'}",5,"{'现金', '焦阳洋', '竞价', '宝泰隆集团', '36'}"
8,"{'现金', '杜宣', '赵剑', '2800000', '竞价', '李结义', '徐岷波', '36'}",723219,2,"{'2800000', '竞价'}",6,"{'杜宣', '现金', '赵剑', '李结义', '徐岷波', '36'}",6,"{'现金', '杜宣', '赵剑', '李结义', '徐岷波', '36'}"
14,"{'87360000', '现金', '47040000', '四川省水电投资经营集团有限公司', '13000000', '定价', '24600000', '7000000', '165312000', '华宝信托有限责任公司', '山西信托有限责任公司', '王中琼', '泰康资产管理有限责任公司', '12'}",496957,3,"{'87360000', '165312000', '47040000'}",5,"{'现金', '四川省水电投资经营集团有限公司', '定价', '王中琼', '12'}",11,"{'现金', '四川省水电投资经营集团有限公司', '13000000', '定价', '24600000', '7000000', '华宝信托有限责任公司', '山西信托有限责任公司', '王中琼', '泰康资产管理有限责任公司', '12'}"
17,"{'5000000', '现金', '天津凯石富利股权投资基金合伙企业(有限合伙)', '天平汽车保险股份有限公司', '宁波景隆融方股权投资基金合伙企业(有限合伙)', '西安长首投资管理有限合伙企业', '周欣', '长城证券有限责任公司', '上海国泰君安证券资产管理有限公司', '竞价', '郝昌兰', '1234818', '西藏瑞华投资发展有限公司', '4850000', '8000000', '12', '太平资产管理有限公司'}",1185833,3,"{'1234818', '8000000', '竞价'}",6,"{'现金', '天平汽车保险股份有限公司', '上海国泰君安证券资产管理有限公司', '长城证券有限责任公司', '12', '太平资产管理有限公司'}",14,"{'5000000', '现金', '天津凯石富利股权投资基金合伙企业(有限合伙)', '天平汽车保险股份有限公司', '宁波景隆融方股权投资基金合伙企业(有限合伙)', '西安长首投资管理有限合伙企业', '周欣', '郝昌兰', '上海国泰君安证券资产管理有限公司', '西藏瑞华投资发展有限公司', '4850000', '长城证券有限责任公司', '12', '太平资产管理有限公司'}"
5,"{'现金', '华晨集团', '518000000', '200000000', '36'}",2140770,0,set(),3,"{'华晨集团', '现金', '36'}",5,"{'现金', '华晨集团', '518000000', '200000000', '36'}"
3,"{'422798480', '36', '卧龙投资'}",1112259,0,set(),2,"{'36', '卧龙投资'}",3,"{'422798480', '36', '卧龙投资'}"
5,"{'现金', '泰格林纸集团股份有限公司', '竞价', '200000000', '36'}",151306,1,{'竞价'},2,"{'现金', '泰格林纸集团股份有限公司'}",4,"{'现金', '200000000', '泰格林纸集团股份有限公司', '36'}"
17,"{'240000010.1', '现金', '深圳前海金迪投资合伙企业(有限合伙)', '152999998.9', '13496932', '创金合信基金管理有限公司', '76999977.5', '60000006.6', '9386503', '3680982', '鹏华基金管理有限公司', '4723925', '珠海横琴大一资产管理有限公司', '泰达宏利基金管理有限公司', '14723927', '12', '219999991.6'}",1863714,3,"{'9386503', '3680982', '13496932'}",2,"{'现金', '12'}",14,"{'240000010.1', '现金', '深圳前海金迪投资合伙企业(有限合伙)', '152999998.9', '创金合信基金管理有限公司', '76999977.5', '60000006.6', '鹏华基金管理有限公司', '4723925', '珠海横琴大一资产管理有限公司', '泰达宏利基金管理有限公司', '14723927', '12', '219999991.6'}"
25,"{'17163334', '454999984.3', '14711429', '180200001.9', '118800058.3', '现金', '定价', '财通基金管理有限公司', '4481330', '179999983.9', '烽火科技集团有限公司', '36', '北信瑞丰基金管理有限公司', '信诚基金管理有限公司', '6797435', '中信证券股份有限公司', '6789890', '389999982.8', '237999993.4', '九泰基金管理有限公司', '8977744', '嘉实基金管理有限公司', '239999987.4', '12', '9053187'}",16725135,3,"{'239999987.4', '180200001.9', '389999982.8'}",5,"{'烽火科技集团有限公司', '现金', '12', '定价', '36'}",22,"{'17163334', '454999984.3', '14711429', '118800058.3', '现金', '12', '定价', '财通基金管理有限公司', '4481330', '179999983.9', '烽火科技集团有限公司', '北信瑞丰基金管理有限公司', '信诚基金管理有限公司', '6797435', '中信证券股份有限公司', '6789890', '237999993.4', '九泰基金管理有限公司', '8977744', '嘉实基金管理有限公司', '36', '9053187'}"
26,"{'20000000', '酒泉钢铁(集团)有限责任公司', '66800000', '1617291000', '15200000', '1797588000', '揭阳市信宏资产管理中心(有限合伙)', '兴业全球基金管理有限公司', '工银瑞信基金管理有限公司', '定价', '30000000', '409032000', '60100000', '1614600000', '中国电子科技集团公司', '60000000', '807300000', '安徽华茂纺织股份有限公司', '538200000', '华商基金管理有限公司', '汇添富基金管理有限公司', '华夏基金管理有限公司', '551655000', '上海海博鑫惠国际贸易有限公司', '20500000', '12'}",1225313,10,"{'1797588000', '60100000', '1614600000', '551655000', '1617291000', '807300000', '20500000', '538200000', '15200000', '409032000'}",3,"{'安徽华茂纺织股份有限公司', '定价', '12'}",16,"{'20000000', '酒泉钢铁(集团)有限责任公司', '揭阳市信宏资产管理中心(有限合伙)', '兴业全球基金管理有限公司', '工银瑞信基金管理有限公司', '66800000', '华夏基金管理有限公司', '定价', '中国电子科技集团公司', '上海海博鑫惠国际贸易有限公司', '60000000', '安徽华茂纺织股份有限公司', '华商基金管理有限公司', '30000000', '12', '汇添富基金管理有限公司'}"
7,"{'现金', '威海国有资产经营(集团)有限公司( SS)', '威海北洋电气集团股份有限公司', '鲁信创晟股权投资有限公司( SS)', '17881944', '5642361', '7986111'}",1646053,5,"{'7986111', '鲁信创晟股权投资有限公司( SS)', '17881944', '5642361', '威海国有资产经营(集团)有限公司( SS)'}",2,"{'威海北洋电气集团股份有限公司', '现金'}",2,"{'威海北洋电气集团股份有限公司', '现金'}"
18,"{'北京首都开发控股(集团)有限公司', '800037996.8', '33755274', '国寿安保基金管理有限公司', '12', '定价', '399999996.9', '67508253', '1399969606', '安邦资产管理有限责任公司', '申万宏源证券有限公司', '50634565', '118140895', '67513755', '600019595.3', '建信基金管理有限责任公司', '799972798.1', '36'}",6344302,4,"{'600019595.3', '1399969606', '799972798.1', '800037996.8'}",3,"{'36', '定价', '12'}",14,"{'北京首都开发控股(集团)有限公司', '33755274', '国寿安保基金管理有限公司', '12', '399999996.9', '67508253', '定价', '安邦资产管理有限责任公司', '申万宏源证券有限公司', '50634565', '118140895', '67513755', '建信基金管理有限责任公司', '36'}"
16,"{'招商财富资产管理有限公司', '鹏华资产管理(深圳)有限公司', '现金', '572999976.1', '申万菱信(上海)资产管理有限公司', '5151515', '华宝信托有限责任公司', '2910687', '竞价', '73000029.96', '129199996.2', '22846889', '银河基金管理有限公司', '四川富润志合投资有限责任公司', '华安未来资产管理(上海)有限公司', '12'}",1589141,1,{'竞价'},6,"{'招商财富资产管理有限公司', '现金', '华宝信托有限责任公司', '银河基金管理有限公司', '四川富润志合投资有限责任公司', '12'}",15,"{'招商财富资产管理有限公司', '鹏华资产管理(深圳)有限公司', '现金', '572999976.1', '申万菱信(上海)资产管理有限公司', '5151515', '华宝信托有限责任公司', '2910687', '73000029.96', '129199996.2', '22846889', '银河基金管理有限公司', '四川富润志合投资有限责任公司', '华安未来资产管理(上海)有限公司', '12'}"
4,"{'精工控股集团(浙江)投资有限公司', '现金', '300000000', '36'}",15856580,1,{'精工控股集团(浙江)投资有限公司'},2,"{'现金', '36'}",3,"{'现金', '300000000', '36'}"
5,"{'招商局蛇口工业区有限公司', '2300000000', '定价', '110736639', '36'}",820427,0,set(),3,"{'招商局蛇口工业区有限公司', '定价', '36'}",5,"{'招商局蛇口工业区有限公司', '2300000000', '定价', '110736639', '36'}"
28,"{'15620000', '启迪桑德第一期员工持股计划', '149796000', '58410000', '珠海启迪绿源资本管理有限公司', '现金', '西藏桑德投资控股有限公司', '邦信资产管理有限公司', '433021400', '17060000', '34700000', '5400000', '竞价', '珠海启迪投资管理有限公司', '5200000', '汇添富基金管理股份有限公司', '西藏清控资产管理有限公司', '1620293400', '144248000', '433298800', '南通金信灏海投资中心(有限合伙)', '288773400', '962578000', '15610000', '嘉实基金管理有限公司', '10410000', '36', '473244400'}",15501787,17,"{'15620000', '962578000', '1620293400', '433021400', '17060000', '149796000', '15610000', '34700000', '5400000', '144248000', '竞价', '433298800', '58410000', '10410000', '288773400', '5200000', '473244400'}",10,"{'西藏清控资产管理有限公司', '现金', '西藏桑德投资控股有限公司', '邦信资产管理有限公司', '启迪桑德第一期员工持股计划', '嘉实基金管理有限公司', '珠海启迪投资管理有限公司', '珠海启迪绿源资本管理有限公司', '汇添富基金管理股份有限公司', '36'}",11,"{'西藏清控资产管理有限公司', '现金', '西藏桑德投资控股有限公司', '邦信资产管理有限公司', '启迪桑德第一期员工持股计划', '嘉实基金管理有限公司', '南通金信灏海投资中心(有限合伙)', '珠海启迪投资管理有限公司', '珠海启迪绿源资本管理有限公司', '汇添富基金管理股份有限公司', '36'}"
9,"{'股权', '定价', '武陵源旅游公司', '19151949', '森林公园管理处', '经投集团', '51407863', '36', '30239920'}",883987,1,{'51407863'},6,"{'定价', '武陵源旅游公司', '森林公园管理处', '经投集团', '股权', '36'}",8,"{'定价', '武陵源旅游公司', '19151949', '森林公园管理处', '经投集团', '股权', '36', '30239920'}"
3,"{'中国平安保险(集团)股份有限公司', '现金', '36'}",676967,1,{'中国平安保险(集团)股份有限公司'},2,"{'现金', '36'}",2,"{'现金', '36'}"
16,"{'兵器财务有限责任公司', '现金', '兴业全球基金管理有限公司', '中债信用增进投资股份有限公司', '江苏瑞华投资发展有限公司', '13000000', '定价', '23000000', '18000000', '15000000', '陈章银', '海通证券股份有限公司', '青海天诚信用担保有限责任公司', '方正证券有限责任公司', '中融汇投资担保有限公司', '12'}",1497552,0,set(),5,"{'现金', '兴业全球基金管理有限公司', '定价', '海通证券股份有限公司', '12'}",16,"{'兵器财务有限责任公司', '现金', '兴业全球基金管理有限公司', '中债信用增进投资股份有限公司', '江苏瑞华投资发展有限公司', '13000000', '18000000', '23000000', '15000000', '陈章银', '定价', '海通证券股份有限公司', '青海天诚信用担保有限责任公司', '方正证券有限责任公司', '中融汇投资担保有限公司', '12'}"
5,"{'好当家集团', '现金', '竞价', '120000000', '36'}",1463315,0,set(),4,"{'好当家集团', '竞价', '现金', '36'}",5,"{'好当家集团', '现金', '竞价', '120000000', '36'}"
11,"{'23041400', '现金', '陈福泉', '重庆信三威', '安徽铁投', '京投公司', '15360900', '建投投资', '36', '15361000', '7680500'}",338692,4,"{'23041400', '15361000', '15360900', '7680500'}",7,"{'现金', '陈福泉', '重庆信三威', '安徽铁投', '京投公司', '建投投资', '36'}",7,"{'现金', '陈福泉', '重庆信三威', '安徽铁投', '京投公司', '建投投资', '36'}"
24,"{'12000000', '123500000', '杭州如山创业投资有限公司', '13768421', '美克投资集团有限公司', '114000000', '高运控股集团有限公司', '104500000', '现金', '12', '定价', '11000000', '深圳市合赢投资管理有限公司', '36', '博时基金管理有限公司', '15000000', '天津凯石益盛股权投资基金合伙企业(有限合伙)', '439925800', '股权', '142500000', '130799999.5', '江苏瑞华投资发展有限公司', '13000000', '46307978'}",1502837,1,{'杭州如山创业投资有限公司'},10,"{'现金', '江苏瑞华投资发展有限公司', '12', '美克投资集团有限公司', '博时基金管理有限公司', '定价', '高运控股集团有限公司', '股权', '36', '深圳市合赢投资管理有限公司'}",23,"{'12000000', '123500000', '13768421', '美克投资集团有限公司', '114000000', '高运控股集团有限公司', '104500000', '现金', '12', '定价', '11000000', '深圳市合赢投资管理有限公司', '36', '博时基金管理有限公司', '15000000', '天津凯石益盛股权投资基金合伙企业(有限合伙)', '439925800', '股权', '142500000', '130799999.5', '江苏瑞华投资发展有限公司', '13000000', '46307978'}"
15,"{'浙江天圣控股集团有限公司', '5000000', '现金', '上海柴油机股份有限公司', '4800000', '浙江宋都控股有限公司', '厦门菲翔贸易有限公司', '三一集团有限公司', '红塔证券股份有限公司', '竞价', '6000000', '8000000', '6631373', '新理益集团有限公司', '12'}",1363938,1,{'竞价'},9,"{'浙江天圣控股集团有限公司', '上海柴油机股份有限公司', '现金', '浙江宋都控股有限公司', '三一集团有限公司', '红塔证券股份有限公司', '厦门菲翔贸易有限公司', '新理益集团有限公司', '12'}",14,"{'浙江天圣控股集团有限公司', '5000000', '上海柴油机股份有限公司', '4800000', '现金', '浙江宋都控股有限公司', '厦门菲翔贸易有限公司', '三一集团有限公司', '红塔证券股份有限公司', '6000000', '8000000', '6631373', '新理益集团有限公司', '12'}"
25,"{'胡卫红', '广州瑞德金晟投资管理合伙企业(有限合伙)', '9100000', '7000000', '3000000', '19000000', '何琳', '现金', '江德湖', '3900000', '152500000', '竞价', '10000000', '59475000', '东莞市长久创业投资行(有限合伙)', '45750000', '翁华银', '广州卡奴迪路服饰股份有限公司第一期员工持股计划', '梁美玲', '138775000', '李恩平', '289750000', '106750000', '寇凤英', '36'}",1662776,12,"{'45750000', '9100000', '3900000', '152500000', '竞价', '3000000', '10000000', '106750000', '138775000', '59475000', '289750000', '19000000'}",10,"{'何琳', '胡卫红', '现金', '翁华银', '江德湖', '广州卡奴迪路服饰股份有限公司第一期员工持股计划', '梁美玲', '寇凤英', '李恩平', '36'}",13,"{'何琳', '东莞市长久创业投资行(有限合伙)', '胡卫红', '现金', '广州瑞德金晟投资管理合伙企业(有限合伙)', '翁华银', '江德湖', '广州卡奴迪路服饰股份有限公司第一期员工持股计划', '7000000', '梁美玲', '寇凤英', '李恩平', '36'}"
5,"{'现金', '中国化工农化总公司', '7000000', '竞价', '36'}",1349829,1,{'竞价'},3,"{'中国化工农化总公司', '现金', '36'}",4,"{'中国化工农化总公司', '现金', '36', '7000000'}"
12,"{'新疆天弘旗实业有限公司', '20000000', '现金', '四川裕嘉阁酒店管理有限公司', '70000000', '定价', '四川大耀实业有限责任公司', '杨林', '蒋涛', '50000000', '广安神龙投资有限公司', '36'}",1761392,3,"{'20000000', '70000000', '50000000'}",9,"{'新疆天弘旗实业有限公司', '现金', '四川裕嘉阁酒店管理有限公司', '定价', '四川大耀实业有限责任公司', '杨林', '蒋涛', '广安神龙投资有限公司', '36'}",9,"{'新疆天弘旗实业有限公司', '现金', '四川裕嘉阁酒店管理有限公司', '定价', '四川大耀实业有限责任公司', '杨林', '蒋涛', '广安神龙投资有限公司', '36'}"
4,"{'创元投资', '竞价', '现金', '36'}",1175722,1,{'竞价'},3,"{'创元投资', '现金', '36'}",3,"{'创元投资', '现金', '36'}"
12,"{'现金', '甘肃兴陇资本管理有限公司', '财通基金管理有限公司', '31800000', '竞价', '23800000', '7967154', '8000000', '兰州永新大贸贸易有限责任公司', '八冶建设集团有限公司', '12', '华融证券股份有限公司'}",1860987,1,{'竞价'},2,"{'现金', '12'}",11,"{'现金', '甘肃兴陇资本管理有限公司', '财通基金管理有限公司', '31800000', '23800000', '7967154', '8000000', '兰州永新大贸贸易有限责任公司', '八冶建设集团有限公司', '12', '华融证券股份有限公司'}"
26,"{'535263400', '深圳名正', '上海喜待', '上海爽达', '130277495', '玉环捷瑞', '191165500', '宁波裕盛', '现金', '定价', '30343730', '上海哲萱', '78044087', '443504000', '宁波雨博', '820748200', '70397457', '宁波骏和', '60687475', '491677700', '宁波万福', '36412485', '229398700', '382331100', '84962452', '36'}",15311118,7,"{'191165500', '535263400', '491677700', '229398700', '382331100', '443504000', '820748200'}",12,"{'宁波裕盛', '现金', '深圳名正', '宁波骏和', '上海喜待', '定价', '宁波雨博', '宁波万福', '上海爽达', '上海哲萱', '玉环捷瑞', '36'}",19,"{'宁波裕盛', '现金', '深圳名正', '70397457', '宁波骏和', '60687475', '上海喜待', '定价', '30343730', '宁波雨博', '78044087', '36412485', '上海爽达', '宁波万福', '上海哲萱', '130277495', '84962452', '玉环捷瑞', '36'}"
22,"{'67200000', '226928895', '444192000', '449480000', '816996000', '现金', '工银瑞信基金管理有限公司', '新疆凯迪投资有限责任公司', '12', '61800000', '33871105', '34000000', '2999999992', '平安资产管理有限责任公司', '888384000', '中国长城资产管理公司', '中国建银投资有限责任公司', '447776008.1', '华夏基金管理有限公司', '中国人保资产管理股份有限公司', '33600000', '东兴证券股份有限公司'}",1320320,10,"{'816996000', '226928895', '34000000', '2999999992', '888384000', '444192000', '449480000', '447776008.1', '61800000', '33600000'}",3,"{'中国建银投资有限责任公司', '现金', '12'}",12,"{'67200000', '现金', '工银瑞信基金管理有限公司', '华夏基金管理有限公司', '中国人保资产管理股份有限公司', '新疆凯迪投资有限责任公司', '东兴证券股份有限公司', '平安资产管理有限责任公司', '中国长城资产管理公司', '中国建银投资有限责任公司', '33871105', '12'}"
12,"{'770149994.3', '42246297', '759999986.1', '中节能资本控股有限公司', '华龙证券股份有限公司', '北京中吉金投资产管理有限公司', '2904555', '786799982', '竞价', '43159626', '中国人寿资产管理有限公司', '41689522'}",2330929,4,"{'2904555', '786799982', '竞价', '759999986.1'}",4,"{'中节能资本控股有限公司', '华龙证券股份有限公司', '北京中吉金投资产管理有限公司', '中国人寿资产管理有限公司'}",8,"{'770149994.3', '42246297', '中节能资本控股有限公司', '华龙证券股份有限公司', '北京中吉金投资产管理有限公司', '43159626', '中国人寿资产管理有限公司', '41689522'}"
22,"{'易方达基金管理有限公司', '103000031.7', '现金', '中融基金管理有限公司', '定价', '财通基金管理有限公司', '深圳市融通资本管理股份有限公司', '10706864', '平安大华基金管理有限公司', '1002999997', '北信瑞丰基金管理有限公司', '45530145', '50207900', '长城国泰(舟山)产业并购重组基金合伙企业', '600999995.4', '第一创业证券股份有限公司', '天津和澜商贸有限公司', '437999994.9', '104261954', '482999998', '12', '62474012'}",15699488,1,{'103000031.7'},11,"{'平安大华基金管理有限公司', '现金', '北信瑞丰基金管理有限公司', '第一创业证券股份有限公司', '天津和澜商贸有限公司', '中融基金管理有限公司', '定价', '财通基金管理有限公司', '易方达基金管理有限公司', '深圳市融通资本管理股份有限公司', '12'}",21,"{'易方达基金管理有限公司', '现金', '中融基金管理有限公司', '定价', '财通基金管理有限公司', '深圳市融通资本管理股份有限公司', '10706864', '平安大华基金管理有限公司', '1002999997', '北信瑞丰基金管理有限公司', '45530145', '50207900', '长城国泰(舟山)产业并购重组基金合伙企业', '600999995.4', '第一创业证券股份有限公司', '天津和澜商贸有限公司', '437999994.9', '104261954', '482999998', '12', '62474012'}"
16,"{'45330000', '3560000', '53791600', '华夏基金管理有限公司', '赵东明', '4600000', '4000000', '中国银河投资管理有限公司', '竞价', '常州投资集团有限公司', '3000000', '苏州盛商共赢创业投资中心(有限合伙)', '69506000', '60440000', '12', '江苏开元国际集团轻工业品进出口股份有限公司'}",1324676,5,"{'45330000', '53791600', '竞价', '60440000', '69506000'}",7,"{'赵东明', '华夏基金管理有限公司', '中国银河投资管理有限公司', '常州投资集团有限公司', '苏州盛商共赢创业投资中心(有限合伙)', '12', '江苏开元国际集团轻工业品进出口股份有限公司'}",11,"{'3560000', '赵东明', '华夏基金管理有限公司', '4600000', '4000000', '中国银河投资管理有限公司', '常州投资集团有限公司', '3000000', '苏州盛商共赢创业投资中心(有限合伙)', '12', '江苏开元国际集团轻工业品进出口股份有限公司'}"
18,"{'深圳平安大华汇通财富管理有限公司', '杭州融新航电子商务发展有限公司', '现金', '长城国瑞证券有限公司', '15873015', '20952380', '660000000', '定价', '90000000', '肖文革', '2857142', '1000000000', '250000000', '31746031', '500000000', '7936507', '上海佑开投资管理中心(有限合伙)', '36'}",1859756,5,"{'90000000', '1000000000', '250000000', '500000000', '660000000'}",7,"{'深圳平安大华汇通财富管理有限公司', '杭州融新航电子商务发展有限公司', '现金', '长城国瑞证券有限公司', '定价', '肖文革', '36'}",13,"{'深圳平安大华汇通财富管理有限公司', '杭州融新航电子商务发展有限公司', '现金', '长城国瑞证券有限公司', '15873015', '20952380', '定价', '肖文革', '2857142', '31746031', '7936507', '上海佑开投资管理中心(有限合伙)', '36'}"
12,"{'北京中商荣盛贸易有限公司', '现金', '深圳天风天成资产管理有限公司', '26478375', '定价', '199999992.5', '8826125', '中植产业投资有限公司', '599999977.5', '12', '200000015.2', '8826126'}",1710793,1,{'200000015.2'},6,"{'北京中商荣盛贸易有限公司', '现金', '深圳天风天成资产管理有限公司', '定价', '中植产业投资有限公司', '12'}",11,"{'北京中商荣盛贸易有限公司', '现金', '深圳天风天成资产管理有限公司', '26478375', '定价', '199999992.5', '8826125', '中植产业投资有限公司', '599999977.5', '12', '8826126'}"
21,"{'99999999', '140560305.6', '149999995.2', '99000000', '竞价', '21297016', '华宝投资有限公司', '上海并购股权投资基金合伙企业(有限合伙)', '宏信证券有限责任公司', '安徽中安资本管理有限公司', '22727272', '15000000', '12121212', '75999996.6', '79999999.2', '大成基金管理有限公司', '11515151', '15151515', '贵州铁路人保壹期壹号股权投资基金中心(有限合伙)', '12', '汇安基金管理有限责任公司'}",16407396,2,"{'11515151', '12121212'}",7,"{'宏信证券有限责任公司', '安徽中安资本管理有限公司', '大成基金管理有限公司', '竞价', '华宝投资有限公司', '12', '汇安基金管理有限责任公司'}",19,"{'宏信证券有限责任公司', '安徽中安资本管理有限公司', '22727272', '99999999', '大成基金管理有限公司', '140560305.6', '15151515', '15000000', '149999995.2', '汇安基金管理有限责任公司', '99000000', '21297016', '竞价', '75999996.6', '华宝投资有限公司', '贵州铁路人保壹期壹号股权投资基金中心(有限合伙)', '12', '79999999.2', '上海并购股权投资基金合伙企业(有限合伙)'}"
3,"{'现金', '36', '西湖电子集团'}",1873169,0,set(),3,"{'现金', '36', '西湖电子集团'}",3,"{'现金', '36', '西湖电子集团'}"
7,"{'现金', '1620000', '惠州中京电子科技股份有限公司2015年度员工持股计划', '杨林', '30740000', '竞价', '36'}",1598068,4,"{'竞价', '1620000', '惠州中京电子科技股份有限公司2015年度员工持股计划', '30740000'}",3,"{'现金', '36', '杨林'}",3,"{'现金', '36', '杨林'}"
4,"{'竞价', '现金', '36', '中国有色集团'}",1053030,0,set(),4,"{'竞价', '现金', '36', '中国有色集团'}",4,"{'竞价', '现金', '36', '中国有色集团'}"
12,"{'财通基金-玉泉399号资管计划', '16095925', '财通基金-玉泉400号资管计划', '物流基金', '鑫诚投资', '定价', '5365308', '银晟资本', '10730616', '26826541', '中再生', '36'}",16040589,0,set(),6,"{'物流基金', '鑫诚投资', '定价', '银晟资本', '中再生', '36'}",12,"{'财通基金-玉泉399号资管计划', '16095925', '财通基金-玉泉400号资管计划', '物流基金', '鑫诚投资', '5365308', '定价', '银晟资本', '10730616', '26826541', '中再生', '36'}"
11,"{'定价', '204684515.8', '天齐集团', '87979689.05', '19587035', '矿业总公司', '175959388.6', '16838219', '8419109', '西藏投资公司', '36'}",2204569,3,"{'175959388.6', '87979689.05', '204684515.8'}",5,"{'定价', '天齐集团', '矿业总公司', '西藏投资公司', '36'}",8,"{'定价', '天齐集团', '19587035', '矿业总公司', '8419109', '16838219', '西藏投资公司', '36'}"
10,"{'平安大华基金管理有限公司', '现金', '江信基金管理有限公司', '16320000', '邱继光', '定价', '上海粤源实业有限公司', '36', '广州金信塑业有限公司', '林文昌'}",226556,1,{'16320000'},9,"{'平安大华基金管理有限公司', '现金', '江信基金管理有限公司', '邱继光', '定价', '上海粤源实业有限公司', '36', '广州金信塑业有限公司', '林文昌'}",9,"{'平安大华基金管理有限公司', '现金', '江信基金管理有限公司', '邱继光', '定价', '上海粤源实业有限公司', '36', '广州金信塑业有限公司', '林文昌'}"
28,"{'6795608', '学思投资', '20125457', '科劲投资', '紫光育才', '现金', '544999983.8', '129999981', '1568217', '谷多投资', '银润投资首期1号员工持股计划', '269999997.4', '28489283', '36', '74751698', '29999991.21', '乐耘投资', '384999992.4', '14113957', '乐金兄弟', '10454783', '106638787', '2039999995', '健坤长青', '长城嘉信', '1429999983', '199999998.8', '国研宝业'}",14670682,4,"{'29999991.21', '544999983.8', '1429999983', '199999998.8'}",11,"{'学思投资', '现金', '健坤长青', '乐耘投资', '长城嘉信', '科劲投资', '紫光育才', '谷多投资', '36', '乐金兄弟', '国研宝业'}",24,"{'6795608', '学思投资', '20125457', '科劲投资', '紫光育才', '现金', '129999981', '1568217', '谷多投资', '银润投资首期1号员工持股计划', '269999997.4', '28489283', '74751698', '乐耘投资', '384999992.4', '14113957', '乐金兄弟', '10454783', '106638787', '2039999995', '健坤长青', '长城嘉信', '36', '国研宝业'}"
21,"{'305550000', '388000000', '华泰资产管理有限公司', '申万菱信基金管理有限公司', '易方达资产管理有限公司', '新华基金管理有限公司', '63000000', '20320400', '竞价', '鹏华基金管理有限公司', '98553910.9', '东海基金管理有限责任公司', '264545456.8', '153061200', '742346936.4', '54545500', '184629600', '895453695.8', '嘉实基金管理有限公司', '80000000', '12'}",313983,6,"{'54545500', '184629600', '153061200', '264545456.8', '20320400', '80000000'}",3,"{'竞价', '12', '华泰资产管理有限公司'}",15,"{'新华基金管理有限公司', '63000000', '305550000', '388000000', '东海基金管理有限责任公司', '华泰资产管理有限公司', '嘉实基金管理有限公司', '742346936.4', '895453695.8', '竞价', '鹏华基金管理有限公司', '申万菱信基金管理有限公司', '98553910.9', '易方达资产管理有限公司', '12'}"
4,"{'竞价', '现金', '上海申达(集团)有限公司', '36'}",1798563,1,{'上海申达(集团)有限公司'},3,"{'竞价', '现金', '36'}",3,"{'竞价', '现金', '36'}"
12,"{'20000000', '上海国际资管', '现金', '国盛投资', '华安资管', '锦江酒店集团', '15000000', '长城资管', '10000000', '75958260', '弘毅投资基金', '36'}",1803457,0,set(),9,"{'上海国际资管', '现金', '国盛投资', '华安资管', '锦江酒店集团', '长城资管', '10000000', '弘毅投资基金', '36'}",12,"{'20000000', '上海国际资管', '现金', '国盛投资', '华安资管', '锦江酒店集团', '15000000', '长城资管', '10000000', '75958260', '弘毅投资基金', '36'}"
14,"{'现金', '5721550', '16326696', '203999994.8', '256818928.1', '287999988', '18308963', '申万菱信基金管理有限公司', '泰达宏利基金管理有限公司', '国投瑞银基金管理有限公司', '12968849', '89999981.5', '12', '上银基金管理有限公司'}",313653,3,"{'203999994.8', '287999988', '256818928.1'}",6,"{'现金', '申万菱信基金管理有限公司', '泰达宏利基金管理有限公司', '国投瑞银基金管理有限公司', '12', '上银基金管理有限公司'}",11,"{'现金', '5721550', '16326696', '18308963', '申万菱信基金管理有限公司', '泰达宏利基金管理有限公司', '国投瑞银基金管理有限公司', '12968849', '89999981.5', '12', '上银基金管理有限公司'}"
8,"{'现金、股权', '现金', '华君电力', '保华兴资产', '竞价', '瑞尔德', '股权', '36'}",9884123,2,"{'现金、股权', '竞价'}",6,"{'现金', '华君电力', '保华兴资产', '瑞尔德', '股权', '36'}",6,"{'现金', '华君电力', '保华兴资产', '瑞尔德', '股权', '36'}"
33,"{'凯联艾瑞', '泰康人寿保险有限责任公司-分红-团体分红-019L-FH001深', '225525674.6', '144980361.1', '泰康人寿保险有限责任公司-万能-个险万能', '198734467.3', '200092485.5', '泰康人寿保险有限责任公司-分红-个人分红-019L-FH002深', '10421704', '君享五粮液1号', '现金', '9183663', '23696280', '902503', '420119977.1', '65192880.4', '竞价', '泰康人寿保险有限责任公司-传统-普通保险产品-019L-CT001深', '1307272.4', '6699647', '60410', '国泰君安资管计划', '65006624.9', '泰康人寿保险有限责任公司-万能-个险万能(乙)', '19414047', '19530164.92', '中国石油天然气集团公司企业年金计划-中国工商银行', '3012610', '512787499.2', '华安基金', '9246418', '3004003', '36'}",20326871,4,"{'420119977.1', '竞价', '225525674.6', '144980361.1'}",7,"{'凯联艾瑞', '现金', '中国石油天然气集团公司企业年金计划-中国工商银行', '华安基金', '国泰君安资管计划', '泰康人寿保险有限责任公司-万能-个险万能', '36'}",29,"{'凯联艾瑞', '泰康人寿保险有限责任公司-分红-团体分红-019L-FH001深', '泰康人寿保险有限责任公司-万能-个险万能', '198734467.3', '200092485.5', '泰康人寿保险有限责任公司-分红-个人分红-019L-FH002深', '10421704', '君享五粮液1号', '现金', '9183663', '23696280', '902503', '65192880.4', '泰康人寿保险有限责任公司-传统-普通保险产品-019L-CT001深', '1307272.4', '6699647', '60410', '国泰君安资管计划', '65006624.9', '泰康人寿保险有限责任公司-万能-个险万能(乙)', '19414047', '19530164.92', '中国石油天然气集团公司企业年金计划-中国工商银行', '3012610', '512787499.2', '华安基金', '9246418', '3004003', '36'}"
24,"{'7000000', '30084000', '58860000', '现金', '94176000', '4600000', '定价', '陈学东', '苏州通博电子器材有限公司', '2300000', '36', '张宇', '60168000', '91560000', '64092000', '信达证券股份有限公司', '江苏虎甲投资有限公司', '4500000', '李绍君', '4900000', '7200000', '中海基金管理有限公司', '上海证券有限责任公司', '12'}",213862,8,"{'4500000', '94176000', '60168000', '91560000', '30084000', '58860000', '64092000', '2300000'}",5,"{'现金', '12', '定价', '苏州通博电子器材有限公司', '36'}",16,"{'36', '现金', '张宇', '4600000', '陈学东', '定价', '7000000', '李绍君', '4900000', '信达证券股份有限公司', '苏州通博电子器材有限公司', '7200000', '中海基金管理有限公司', '上海证券有限责任公司', '12', '江苏虎甲投资有限公司'}"
12,"{'39525691', '南京瑞森投资管理合伙企业(有限合伙)', '59999997.42', '现金', '安庆皖江高科技投资发展有限公司', '定价', '11857707', '199999996.5', '王钊勍', '田家玉', '36', '北京顺鑫置业有限公司'}",352349,1,{'199999996.5'},7,"{'现金', '安庆皖江高科技投资发展有限公司', '定价', '王钊勍', '田家玉', '36', '北京顺鑫置业有限公司'}",11,"{'39525691', '南京瑞森投资管理合伙企业(有限合伙)', '59999997.42', '现金', '安庆皖江高科技投资发展有限公司', '定价', '11857707', '王钊勍', '田家玉', '36', '北京顺鑫置业有限公司'}"
13,"{'南京瑞森投资管理合伙企业(有限合伙)', '5000000', '宿迁华基丰润投资合伙企业(有限合伙)', '亳州市古井玻璃制品有限责任公司', '上海证大投资管理有限公司', '上海国泰君安证券资产管理有限公司', '竞价', '3000000', '浙商证券股份有限公司', '1938461', '新疆中乾景隆中和股权投资合伙企业(有限合伙)', '2700000', '12'}",1130105,2,"{'2700000', '竞价'}",4,"{'亳州市古井玻璃制品有限责任公司', '上海国泰君安证券资产管理有限公司', '12', '上海证大投资管理有限公司'}",11,"{'南京瑞森投资管理合伙企业(有限合伙)', '5000000', '宿迁华基丰润投资合伙企业(有限合伙)', '上海证大投资管理有限公司', '上海国泰君安证券资产管理有限公司', '3000000', '浙商证券股份有限公司', '1938461', '新疆中乾景隆中和股权投资合伙企业(有限合伙)', '亳州市古井玻璃制品有限责任公司', '12'}"
4,"{'竞价', '现金', '36', '连云港港口集团有限公司'}",1459480,0,set(),4,"{'竞价', '现金', '36', '连云港港口集团有限公司'}",4,"{'竞价', '现金', '36', '连云港港口集团有限公司'}"
26,"{'53497668', '1599999986', '广发基金管理有限公司', '817999985', '国家开发投资公司', '现金', '定价', '799999993', '54497001', '财通基金管理有限公司', '国新央企运营(广州)投资基金(有限合伙)', '诺德基金管理有限公司', '36', '979999988.1', '青岛国信资本投资有限公司', '中信证券股份有限公司', '53297801', '802999996.7', '86608927', '1299999994', '54963361', '厦门恒兴集团有限公司', '825000048.6', '106595602', '12', '65289806'}",16836463,2,"{'802999996.7', '979999988.1'}",5,"{'现金', '12', '定价', '36', '国家开发投资公司'}",24,"{'53497668', '1599999986', '广发基金管理有限公司', '817999985', '国家开发投资公司', '现金', '定价', '799999993', '54497001', '财通基金管理有限公司', '国新央企运营(广州)投资基金(有限合伙)', '诺德基金管理有限公司', '36', '青岛国信资本投资有限公司', '中信证券股份有限公司', '53297801', '86608927', '1299999994', '54963361', '厦门恒兴集团有限公司', '825000048.6', '106595602', '12', '65289806'}"
17,"{'常州京治资本管理有限公司', '潍坊美晨投资有限公司', '8259997', '363828127.5', '19157087', '69698875', '定价', '赛石集团有限公司', '43117184.34', '20114942', '99999994.14', '杭州晨德投资管理有限公司', '38314175', '104999997.2', '199999993.5', '36', '山东晨德投资有限公司'}",1831033,3,"{'山东晨德投资有限公司', '43117184.34', '99999994.14'}",6,"{'36', '常州京治资本管理有限公司', '潍坊美晨投资有限公司', '定价', '赛石集团有限公司', '杭州晨德投资管理有限公司'}",14,"{'常州京治资本管理有限公司', '潍坊美晨投资有限公司', '8259997', '363828127.5', '19157087', '69698875', '定价', '赛石集团有限公司', '20114942', '杭州晨德投资管理有限公司', '38314175', '104999997.2', '199999993.5', '36'}"
12,"{'469999997.7', '现金', '581952117', '大船投资', '49723756', '定价', '武船投资', '中船重工集团', '269999995.1', '3159999995', '86556169', '36'}",16222846,2,"{'269999995.1', '469999997.7'}",6,"{'大船投资', '现金', '定价', '武船投资', '中船重工集团', '36'}",10,"{'大船投资', '581952117', '现金', '49723756', '定价', '武船投资', '中船重工集团', '3159999995', '86556169', '36'}"
29,"{'11723329', '10433763', '703403', '14999996.47', '61999997.92', '59999994.41', '23446658', '广东恒健资本管理有限公司', '现金', '中融基金管理有限公司', '7268464', '199999992.7', '99999996.37', '财通基金管理有限公司', '37999998.45', '竞价', '鹏华基金管理有限公司', '1758499', '佘常光', '4454865', '36', '北信瑞丰基金管理有限公司', '何剑锋', '6000027.59', '中投天琪期货有限公司', '88999998.39', '7033997', '12', '汇安基金管理有限责任公司'}",18861329,1,{'竞价'},12,"{'现金', '北信瑞丰基金管理有限公司', '中融基金管理有限公司', '12', '何剑锋', '汇安基金管理有限责任公司', '财通基金管理有限公司', '中投天琪期货有限公司', '广东恒健资本管理有限公司', '鹏华基金管理有限公司', '36', '佘常光'}",28,"{'11723329', '10433763', '703403', '14999996.47', '61999997.92', '59999994.41', '23446658', '广东恒健资本管理有限公司', '现金', '中融基金管理有限公司', '7268464', '199999992.7', '99999996.37', '财通基金管理有限公司', '37999998.45', '鹏华基金管理有限公司', '1758499', '佘常光', '4454865', '36', '北信瑞丰基金管理有限公司', '何剑锋', '6000027.59', '中投天琪期货有限公司', '88999998.39', '7033997', '12', '汇安基金管理有限责任公司'}"
21,"{'16000000', '7000000', '广发基金管理有限公司', '138880000', '8000000', '156240000', '现金', '60760000', '万家基金管理有限公司', '18000000', '17000000', '57635200', '147560000', '中银基金管理有限公司', '银河基金管理有限公司', '6640000', '汇添富基金管理有限公司', '东海证券有限责任公司', '69440000', '华宝信托有限责任公司', '12'}",1227528,8,"{'60760000', '57635200', '69440000', '138880000', '147560000', '17000000', '6640000', '156240000'}",9,"{'现金', '万家基金管理有限公司', '广发基金管理有限公司', '华宝信托有限责任公司', '中银基金管理有限公司', '银河基金管理有限公司', '12', '汇添富基金管理有限公司', '东海证券有限责任公司'}",13,"{'现金', '16000000', '万家基金管理有限公司', '18000000', '7000000', '华宝信托有限责任公司', '广发基金管理有限公司', '中银基金管理有限公司', '银河基金管理有限公司', '8000000', '12', '汇添富基金管理有限公司', '东海证券有限责任公司'}"
9,"{'现金', '海富资本', '王功军', '定价', '84138992', '143881983', '张琳', '114800000', '36'}",1767790,0,set(),6,"{'现金', '海富资本', '王功军', '定价', '张琳', '36'}",9,"{'现金', '海富资本', '王功军', '定价', '84138992', '143881983', '张琳', '114800000', '36'}"
15,"{'平安大华基金管理有限公司', '现金', '152718387', '新华基金管理有限公司', '61087354', '54978619', '安徽省铁路建设投资基金有限公司', '18821017', '诺安基金管理有限公司', '定价', '财通基金管理有限公司', '嘉实资本管理有限公司', '中国长城资产管理公司', '91136224', '12'}",1757633,1,{'定价'},9,"{'平安大华基金管理有限公司', '新华基金管理有限公司', '现金', '安徽省铁路建设投资基金有限公司', '诺安基金管理有限公司', '财通基金管理有限公司', '嘉实资本管理有限公司', '中国长城资产管理公司', '12'}",14,"{'平安大华基金管理有限公司', '新华基金管理有限公司', '152718387', '61087354', '54978619', '现金', '安徽省铁路建设投资基金有限公司', '18821017', '诺安基金管理有限公司', '财通基金管理有限公司', '嘉实资本管理有限公司', '中国长城资产管理公司', '91136224', '12'}"
21,"{'薛建', '6721000', '9776000', '刘夷', '现金', '定价', '翁祖翔', '95891980', '6110000', '刘晓鸣', '孙军', '1100000', '1600000', '福建丰琪投资有限公司', '聂慧', '魏立平', '李鹏', '585899997.8', '宋克均', '1000000', '36'}",120443,0,set(),12,"{'孙军', '36', '刘夷', '现金', '李鹏', '福建丰琪投资有限公司', '翁祖翔', '薛建', '宋克均', '聂慧', '刘晓鸣', '魏立平'}",21,"{'薛建', '6721000', '9776000', '刘夷', '现金', '定价', '翁祖翔', '95891980', '6110000', '刘晓鸣', '孙军', '1100000', '1600000', '福建丰琪投资有限公司', '聂慧', '魏立平', '李鹏', '585899997.8', '宋克均', '1000000', '36'}"
5,"{'现金', '60000000', '竞价', '华数集团', '36'}",241105,1,{'60000000'},4,"{'36', '竞价', '华数集团', '现金'}",4,"{'现金', '竞价', '华数集团', '36'}"
5,"{'现金', '4200000000', '竞价', '海航资本', '36'}",1635394,1,{'4200000000'},4,"{'海航资本', '竞价', '现金', '36'}",4,"{'海航资本', '竞价', '现金', '36'}"
3,"{'现金', '程宗玉', '36'}",16385844,0,set(),3,"{'36', '程宗玉', '现金'}",3,"{'36', '程宗玉', '现金'}"
7,"{'12000000', '申能集团财务有限公司', '40544000', '4000000', '定价', '121632000', '中国工商银行—中银持续增长股票型证券投资基金'}",204260,1,{'定价'},0,set(),6,"{'12000000', '申能集团财务有限公司', '40544000', '4000000', '121632000', '中国工商银行—中银持续增长股票型证券投资基金'}"
6,"{'现金', '海岛建设', '竞价', '790000000', '127214171', '36'}",557193,2,"{'竞价', '790000000'}",3,"{'现金', '36', '海岛建设'}",4,"{'127214171', '现金', '36', '海岛建设'}"
8,"{'巨杉(上海)资产管理有限公司', '现金', '260000000', '深圳中植产投科技投资合伙企业(有限合伙)', '60000000', '竞价', '2144388', '8577556'}",2172007,1,{'竞价'},1,{'现金'},7,"{'巨杉(上海)资产管理有限公司', '260000000', '现金', '深圳中植产投科技投资合伙企业(有限合伙)', '60000000', '2144388', '8577556'}"
4,"{'36', '竞价', '现金', '武汉当代科技产业集团股份有限公司'}",1171872,1,{'竞价'},3,"{'36', '现金', '武汉当代科技产业集团股份有限公司'}",3,"{'36', '现金', '武汉当代科技产业集团股份有限公司'}"
9,"{'铁投恒维发行股份购买资产', '现金', '冶金集团', '12', '中烟物资', '阿鲁国际', '竞价', '驰宏锌锗', '36'}",349987,0,set(),9,"{'铁投恒维发行股份购买资产', '36', '现金', '冶金集团', '阿鲁国际', '中烟物资', '驰宏锌锗', '竞价', '12'}",9,"{'铁投恒维发行股份购买资产', '现金', '冶金集团', '12', '中烟物资', '阿鲁国际', '驰宏锌锗', '竞价', '36'}"
17,"{'170499992.1', '159500013', '4555808', '杨鹏威', '定价', '博时基金管理有限公司', '4302708', '申万菱信(上海)资产管理有限公司', '4036953', '179999974.1', '120000009.1', '3037206', '4315363', '常州产业投资集团有限公司', '天治基金管理有限公司', '12', '169999993.1'}",12056770,3,"{'120000009.1', '179999974.1', '169999993.1'}",6,"{'杨鹏威', '博时基金管理有限公司', '定价', '天治基金管理有限公司', '12', '常州产业投资集团有限公司'}",14,"{'170499992.1', '159500013', '4555808', '杨鹏威', '博时基金管理有限公司', '申万菱信(上海)资产管理有限公司', '4302708', '4036953', '定价', '3037206', '4315363', '常州产业投资集团有限公司', '天治基金管理有限公司', '12'}"
4,"{'兵团建工集团', '现金', '竞价', '36'}",4952280,1,{'竞价'},3,"{'兵团建工集团', '现金', '36'}",3,"{'兵团建工集团', '现金', '36'}"
20,"{'219999994.1', '13380909', '芜湖弘唯基石创业投资合伙企业(有限合伙)', '现金', '36', '长城国融投资管理有限公司', '180000023.7', '京新控股集团有限公司', '19625334', '定价', '329999991.2', '16057094', '29438001', '杭州三仁投资管理有限公司', '9812667', '浙江协创资本管理有限公司', '149999989.9', '建信基金管理有限责任公司', '109999997.1', '12'}",16547557,2,"{'149999989.9', '109999997.1'}",9,"{'现金', '长城国融投资管理有限公司', '12', '定价', '杭州三仁投资管理有限公司', '京新控股集团有限公司', '建信基金管理有限责任公司', '36', '浙江协创资本管理有限公司'}",18,"{'219999994.1', '13380909', '芜湖弘唯基石创业投资合伙企业(有限合伙)', '现金', '36', '长城国融投资管理有限公司', '180000023.7', '京新控股集团有限公司', '19625334', '定价', '329999991.2', '16057094', '杭州三仁投资管理有限公司', '9812667', '浙江协创资本管理有限公司', '建信基金管理有限责任公司', '29438001', '12'}"
21,"{'67200000', '168000000', '73920000', '现金', '3553571', '国机财务有限责任公司', '定价', '11000000', '10000000', '万家共赢资产管理有限公司', '30000000', '平安大华基金管理有限公司', '201600000', '36', '漳州市九龙江建设有限公司', '25000000', '23879997.12', '嘉实基金管理有限公司', '上海东方证券资产管理有限公司', '东北证券股份有限公司', '12'}",136651,1,{'23879997.12'},11,"{'平安大华基金管理有限公司', '现金', '12', '国机财务有限责任公司', '定价', '嘉实基金管理有限公司', '漳州市九龙江建设有限公司', '上海东方证券资产管理有限公司', '东北证券股份有限公司', '万家共赢资产管理有限公司', '36'}",20,"{'平安大华基金管理有限公司', '201600000', '67200000', '现金', '3553571', '12', '国机财务有限责任公司', '定价', '嘉实基金管理有限公司', '11000000', '漳州市九龙江建设有限公司', '25000000', '上海东方证券资产管理有限公司', '168000000', '东北证券股份有限公司', '73920000', '10000000', '万家共赢资产管理有限公司', '30000000', '36'}"
3,"{'太安堂集团', '现金', '36'}",1091102,0,set(),3,"{'太安堂集团', '现金', '36'}",3,"{'太安堂集团', '现金', '36'}"
13,"{'299999988.1', '319999993.5', '鹏华资产管理有限公司', '16210834', '东海基金管理有限责任公司', '嘉实基金管理有限公司', '19342359', '财通基金管理有限公司', '251430035.3', '竞价', '安信证券股份有限公司', '12', '20631850'}",15980101,2,"{'竞价', '299999988.1'}",6,"{'鹏华资产管理有限公司', '东海基金管理有限责任公司', '嘉实基金管理有限公司', '财通基金管理有限公司', '安信证券股份有限公司', '12'}",11,"{'319999993.5', '鹏华资产管理有限公司', '16210834', '东海基金管理有限责任公司', '嘉实基金管理有限公司', '19342359', '财通基金管理有限公司', '251430035.3', '安信证券股份有限公司', '12', '20631850'}"
17,"{'现金', '12432012', '北信瑞丰基金管理有限公司', '4247864', '54670009.68', '12', '钟百胜', '160000007.3', '苏州正和投资有限公司', '竞价', '12432013', '263459993.9', '泰达宏利基金管理有限公司', '159999994.4', '建信基金管理有限责任公司', '20470862', '36'}",16427219,1,{'竞价'},8,"{'36', '现金', '北信瑞丰基金管理有限公司', '钟百胜', '苏州正和投资有限公司', '泰达宏利基金管理有限公司', '建信基金管理有限责任公司', '12'}",16,"{'现金', '12432012', '北信瑞丰基金管理有限公司', '4247864', '54670009.68', '12', '钟百胜', '160000007.3', '苏州正和投资有限公司', '12432013', '263459993.9', '泰达宏利基金管理有限公司', '159999994.4', '建信基金管理有限责任公司', '20470862', '36'}"
20,"{'平安大华基金管理有限公司', '太平洋资产管理有限责任公司', '179999970.6', '现金', '北京基业华商投资管理中心(有限合伙)', '3118316', '安徽省铁路建设投资基金有限公司', '定价', '国华人寿保险股份有限公司', '199999994.7', '财通基金管理有限公司', '678799984.9', '22003241', '6482982', '上海原点资产管理有限公司', '5834683', '96200048.6', '164999991', '5348460', '12'}",1742173,2,"{'678799984.9', '179999970.6'}",10,"{'平安大华基金管理有限公司', '太平洋资产管理有限责任公司', '现金', '北京基业华商投资管理中心(有限合伙)', '安徽省铁路建设投资基金有限公司', '国华人寿保险股份有限公司', '定价', '财通基金管理有限公司', '上海原点资产管理有限公司', '12'}",18,"{'平安大华基金管理有限公司', '太平洋资产管理有限责任公司', '3118316', '北京基业华商投资管理中心(有限合伙)', '现金', '安徽省铁路建设投资基金有限公司', '国华人寿保险股份有限公司', '199999994.7', '定价', '财通基金管理有限公司', '22003241', '6482982', '上海原点资产管理有限公司', '5834683', '96200048.6', '164999991', '5348460', '12'}"
12,"{'6949270', '现金', '41695621', '69492703', '君盛紫石', '前海开源', '13898540', '华夏人寿', '20847810', '上汽投资', '医控公司', '36'}",1570335,1,{'69492703'},7,"{'现金', '君盛紫石', '前海开源', '华夏人寿', '上汽投资', '医控公司', '36'}",11,"{'6949270', '现金', '41695621', '君盛紫石', '前海开源', '13898540', '华夏人寿', '20847810', '上汽投资', '医控公司', '36'}"
16,"{'106716000', '现金', '35572000', '16095925', '玉泉400号资管计划', '5365308', '中国再生资源开发有限公司', '四川省物流产业股权投资基金管理有限公司', '银晟资本(天津)股权投资基金管理有限公司', '71144000', '10730616', '供销集团北京鑫诚投资基金管理有限公司', '177860000', '26826541', '36', '玉泉399号资管计划'}",12040470,5,"{'106716000', '71144000', '177860000', '26826541', '35572000'}",5,"{'现金', '中国再生资源开发有限公司', '供销集团北京鑫诚投资基金管理有限公司', '36', '四川省物流产业股权投资基金管理有限公司'}",11,"{'现金', '玉泉400号资管计划', '16095925', '5365308', '中国再生资源开发有限公司', '四川省物流产业股权投资基金管理有限公司', '银晟资本(天津)股权投资基金管理有限公司', '10730616', '供销集团北京鑫诚投资基金管理有限公司', '36', '玉泉399号资管计划'}"
6,"{'现金', '14947600', '100000000', '竞价', '黑龙江省建设集团有限公司', '36'}",1763291,2,"{'100000000', '14947600'}",4,"{'竞价', '现金', '黑龙江省建设集团有限公司', '36'}",4,"{'竞价', '现金', '黑龙江省建设集团有限公司', '36'}"
10,"{'现金', '170239773.6', '上海中植鑫荞投资管理有限公司', '财通基金管理有限公司', '5126160', '4208899', '139777535.8', '周万沅', '509999959', '15356819'}",1922228,2,"{'139777535.8', '509999959'}",4,"{'上海中植鑫荞投资管理有限公司', '周万沅', '现金', '财通基金管理有限公司'}",8,"{'现金', '170239773.6', '上海中植鑫荞投资管理有限公司', '财通基金管理有限公司', '5126160', '4208899', '周万沅', '15356819'}"
14,"{'现金', '北信瑞丰基金管理有限公司', '诺安基金管理有限公司', '国联安基金管理有限公司', '8074183', '竞价', '11126961', '中欧盛世资产管理(上海)有限公司', '上海北信瑞丰资产管理有限公司', '建信基金管理有限责任公司', '1497860', '华安未来资产管理(上海)有限公司', '12', '10955777'}",7176301,1,{'竞价'},2,"{'现金', '12'}",13,"{'现金', '北信瑞丰基金管理有限公司', '诺安基金管理有限公司', '国联安基金管理有限公司', '8074183', '11126961', '中欧盛世资产管理(上海)有限公司', '上海北信瑞丰资产管理有限公司', '建信基金管理有限责任公司', '1497860', '华安未来资产管理(上海)有限公司', '12', '10955777'}"
19,"{'现金', '陈燕双', '63260000', '中民投资本', '100000000', '13807777', '海富通基金', '7903888', '250000000', '竞价', '3161555', '2000000', '周庆捷', '周清', '50000000', '朱国锭', '1580777', '436740000', '36'}",1590474,5,"{'13807777', '2000000', '7903888', '竞价', '1580777'}",8,"{'现金', '陈燕双', '中民投资本', '海富通基金', '周庆捷', '周清', '朱国锭', '36'}",14,"{'现金', '陈燕双', '63260000', '中民投资本', '100000000', '海富通基金', '3161555', '250000000', '50000000', '周庆捷', '周清', '朱国锭', '436740000', '36'}"
22,"{'广发证券资管管理(广东)有限公司', '260000000', '15473700', '160000000', '西藏自治区投资有限公司', '21052600', '国投瑞银基金管理有限公司', '8000000', '200000000', '江西大道国鼎实业发展有限公司', '147000000', '财通基金管理有限公司', '290000000', '30526300', '16315800', '155000000', '东海基金管理有限责任公司', '国联证券股份有限公司', '842100', '16842100', '27368400', '12'}",1574663,12,"{'147000000', '260000000', '30526300', '842100', '155000000', '15473700', '160000000', '16842100', '21052600', '290000000', '27368400', '16315800'}",7,"{'东海基金管理有限责任公司', '财通基金管理有限公司', '西藏自治区投资有限公司', '江西大道国鼎实业发展有限公司', '国投瑞银基金管理有限公司', '12', '国联证券股份有限公司'}",10,"{'广发证券资管管理(广东)有限公司', '12', '东海基金管理有限责任公司', '财通基金管理有限公司', '西藏自治区投资有限公司', '国投瑞银基金管理有限公司', '8000000', '200000000', '江西大道国鼎实业发展有限公司', '国联证券股份有限公司'}"
13,"{'上海恒岚', '现金', '12086831', '清华控股', '定价', '25180897', '富国-诚志集合资产管理计划', '83520002.21', '194880000.6', '173999998.3', '28202605', '36', '重庆昊海'}",350071,3,"{'194880000.6', '173999998.3', '83520002.21'}",6,"{'上海恒岚', '现金', '清华控股', '定价', '36', '重庆昊海'}",10,"{'上海恒岚', '现金', '12086831', '清华控股', '定价', '25180897', '富国-诚志集合资产管理计划', '28202605', '36', '重庆昊海'}"
15,"{'现金', '900000000', '2522068', '798000000', '长沙君清投资有限公司', '100000000', '定价', '2200000000', '20126103', '中信建投基金管理有限公司拟设立的资产管理计划', '君心盈泰知光1号证券投资基金', '55485498', '长沙华福康投资有限公司', '36', '22698612'}",1782284,8,"{'900000000', '2522068', '798000000', '100000000', '2200000000', '20126103', '55485498', '22698612'}",6,"{'现金', '长沙君清投资有限公司', '定价', '中信建投基金管理有限公司拟设立的资产管理计划', '长沙华福康投资有限公司', '36'}",7,"{'现金', '长沙君清投资有限公司', '定价', '中信建投基金管理有限公司拟设立的资产管理计划', '君心盈泰知光1号证券投资基金', '长沙华福康投资有限公司', '36'}"
23,"{'7000020.8', '国投瑞银基金管理有限公司', '119999989', '现金', '269999996', '49999996.8', '竞价', '2710843', '36', '3012048', '北信瑞丰基金管理有限公司', '44999993.8', '上海斐君投资管理中心(有限合伙)', '泓德基金管理有限公司', '津杉华融(天津)产业投资基金合伙企业(有限合伙)', '厦门金达威投资有限公司', '421688', '8132530', '134999998', '7228915', '16265060', '翁仁源', '12'}",14945458,0,set(),5,"{'36', '厦门金达威投资有限公司', '现金', '竞价', '12'}",23,"{'7000020.8', '国投瑞银基金管理有限公司', '119999989', '现金', '269999996', '49999996.8', '竞价', '2710843', '36', '3012048', '北信瑞丰基金管理有限公司', '44999993.8', '上海斐君投资管理中心(有限合伙)', '泓德基金管理有限公司', '津杉华融(天津)产业投资基金合伙企业(有限合伙)', '厦门金达威投资有限公司', '421688', '8132530', '134999998', '7228915', '16265060', '翁仁源', '12'}"
15,"{'杨晋华', '7855460', '现金', '信达-宝鼎成长1号定向资产管理计划', '8248233', '定价', '海通-宝鼎成长2号集合资产管理计划', '辛军', '陈京玉', '刘学根', '7462687', '15710919', '宝鼎万企', '36', '蒋益民'}",1672131,0,set(),9,"{'现金', '定价', '蒋益民', '辛军', '刘学根', '陈京玉', '宝鼎万企', '36', '杨晋华'}",15,"{'杨晋华', '7855460', '现金', '信达-宝鼎成长1号定向资产管理计划', '8248233', '定价', '海通-宝鼎成长2号集合资产管理计划', '辛军', '陈京玉', '刘学根', '7462687', '15710919', '宝鼎万企', '36', '蒋益民'}"
19,"{'31178566', '建银金博', '36028565', '挚信投资', '9897957', '12', '30000709', '定价', '17944997', '中稷弘立', '438301359', '博源集团', '汉高科技', '实地创业', '奥美投资', '南昌中科', '29693872', '股权', '36'}",353827,2,"{'定价', '438301359'}",11,"{'建银金博', '36', '挚信投资', '中稷弘立', '汉高科技', '博源集团', '实地创业', '奥美投资', '南昌中科', '股权', '12'}",17,"{'31178566', '建银金博', '36028565', '挚信投资', '9897957', '12', '30000709', '17944997', '中稷弘立', '博源集团', '汉高科技', '实地创业', '奥美投资', '南昌中科', '29693872', '股权', '36'}"
25,"{'89819984.32', '华安基金管理有限公司', '5161239', '60021595.04', '4648761', '3107417', '5070745', '现金', '定价', '邹瀚枢', '60159593.12', '财通基金管理有限公司', '36', '3100289', '90000012.96', '华福基金管理有限责任公司', '中国乐凯集团有限公司', '99921587.04', '4639462', '98169623.2', '山西证券股份有限公司', '101907593.9', '天弘基金管理有限公司', '5263822', '12'}",1648923,2,"{'定价', '山西证券股份有限公司'}",9,"{'36', '现金', '华安基金管理有限公司', '邹瀚枢', '华福基金管理有限责任公司', '财通基金管理有限公司', '中国乐凯集团有限公司', '天弘基金管理有限公司', '12'}",23,"{'89819984.32', '华安基金管理有限公司', '5161239', '60021595.04', '4648761', '3107417', '5070745', '现金', '邹瀚枢', '60159593.12', '财通基金管理有限公司', '36', '3100289', '90000012.96', '华福基金管理有限责任公司', '中国乐凯集团有限公司', '99921587.04', '4639462', '98169623.2', '101907593.9', '天弘基金管理有限公司', '5263822', '12'}"
22,"{'深圳中植产投环保投资合伙企业(有限合伙)', '中邮创业基金管理股份有限公司', '78947873', '750004793.5', '33684210', '现金', '竞价', '247199994', '华夏人寿保险股份有限公司', '319999995', '26021052', '21052631', '199999994.5', '平安资产管理有限责任公司', '上海德溢慧心股权投资有限公司', '31578946', '上海星鸿资产经营有限公司', '31578947', '299999987', '299999996.5', '36', '上海星通创业投资管理中心(有限合伙)'}",1814701,1,{'竞价'},7,"{'华夏人寿保险股份有限公司', '现金', '平安资产管理有限责任公司', '上海德溢慧心股权投资有限公司', '上海星鸿资产经营有限公司', '中邮创业基金管理股份有限公司', '36'}",21,"{'深圳中植产投环保投资合伙企业(有限合伙)', '中邮创业基金管理股份有限公司', '78947873', '750004793.5', '33684210', '现金', '247199994', '华夏人寿保险股份有限公司', '319999995', '26021052', '21052631', '199999994.5', '平安资产管理有限责任公司', '上海德溢慧心股权投资有限公司', '31578946', '上海星鸿资产经营有限公司', '31578947', '299999987', '299999996.5', '36', '上海星通创业投资管理中心(有限合伙)'}"
16,"{'华安基金管理有限公司', '111999996', '9629629', '8888888', '119999988', '7407407', '财通基金管理有限公司', '129999991.5', '广发基金管理有限公司', '竞价', '河南银企创业投资基金(有限合伙)', '创金合信基金管理有限公司', '国投瑞银基金管理有限公司', '99999994.5', '12', '8296296'}",1701287,1,{'竞价'},1,{'12'},15,"{'华安基金管理有限公司', '111999996', '9629629', '8888888', '119999988', '7407407', '财通基金管理有限公司', '129999991.5', '广发基金管理有限公司', '河南银企创业投资基金(有限合伙)', '创金合信基金管理有限公司', '国投瑞银基金管理有限公司', '99999994.5', '12', '8296296'}"
24,"{'中信建投基金管理有限公司', '12500000', '5000000', '1541668', '财通基金管理有限公司', '竞价', '300000000', '180000000', '苏伟强', '37000032', '7333333', '中信证券股份有限公司', '120000000', '121999992', '7500000', '招商财富资产管理有限公司', '第一创业证券股份有限公司', '144999984', '175999992', '6041666', '5083333', '重庆机电控股集团信博投资管理有限公司', '12', '珠海星程资本管理有限公司'}",1864116,1,{'竞价'},9,"{'招商财富资产管理有限公司', '第一创业证券股份有限公司', '财通基金管理有限公司', '中信建投基金管理有限公司', '重庆机电控股集团信博投资管理有限公司', '中信证券股份有限公司', '苏伟强', '12', '珠海星程资本管理有限公司'}",23,"{'中信建投基金管理有限公司', '12500000', '5000000', '1541668', '财通基金管理有限公司', '300000000', '180000000', '苏伟强', '37000032', '7333333', '中信证券股份有限公司', '120000000', '121999992', '7500000', '招商财富资产管理有限公司', '第一创业证券股份有限公司', '144999984', '175999992', '6041666', '5083333', '重庆机电控股集团信博投资管理有限公司', '12', '珠海星程资本管理有限公司'}"
4,"{'中节能资本', '竞价', '现金', '36'}",2030004,0,set(),4,"{'中节能资本', '竞价', '现金', '36'}",4,"{'中节能资本', '竞价', '现金', '36'}"
1,{'吴艳'},1787710,1,{'吴艳'},0,set(),0,set()
23,"{'421994143', '673394875.3', '448929920.8', '上海上投资产经营有限公司', '525248004.4', '现金', '45163199', '定价', '85984522', '57901537', '北京中融鼎新投资管理有限公司', '中国长城资产管理公司', '36284965', '中信证券股份有限公司', '38601025', '上海达甄资产管理中心(有限合伙)', '20120378', '上银基金管理有限公司', '999999990.9', '北京蓝巨农业产业投资基金管理中心(有限合伙)', '233999996.1', '曹文龙', '36'}",1804214,4,"{'421994143', '448929920.8', '999999990.9', '525248004.4'}",9,"{'现金', '定价', '北京中融鼎新投资管理有限公司', '中国长城资产管理公司', '中信证券股份有限公司', '上海上投资产经营有限公司', '曹文龙', '36', '上银基金管理有限公司'}",19,"{'现金', '20120378', '45163199', '57901537', '定价', '北京蓝巨农业产业投资基金管理中心(有限合伙)', '673394875.3', '85984522', '中国长城资产管理公司', '中信证券股份有限公司', '上海上投资产经营有限公司', '北京中融鼎新投资管理有限公司', '36284965', '233999996.1', '上海达甄资产管理中心(有限合伙)', '曹文龙', '36', '上银基金管理有限公司', '38601025'}"
21,"{'20000000', '上海表正', '194044176', '98537780', '50000000', '32363524', '上海共佳', '深圳睿弘', '现金', '许广跃', '张志祥', '竞价', '31892971', '51000000', '70977022', '上海居行', '95020143', '上海歌付', '顾国平', '上海晋帝', '36'}",402655,1,{'竞价'},12,"{'现金', '许广跃', '上海表正', '上海居行', '张志祥', '上海共佳', '上海歌付', '顾国平', '上海晋帝', '50000000', '36', '深圳睿弘'}",20,"{'31892971', '20000000', '现金', '许广跃', '上海表正', '70977022', '上海居行', '51000000', '194044176', '张志祥', '98537780', '95020143', '上海共佳', '上海歌付', '顾国平', '50000000', '上海晋帝', '32363524', '36', '深圳睿弘'}"
15,"{'国信弘盛', '现金', '480000000', '400000000', '5865102', '100000000', '28152492', '定价', '23460410', '吉林敖东', '瑞禾惠', '金域投资', '鹏源资本', '光大永明', '36'}",361540,5,"{'480000000', '400000000', '5865102', '28152492', '23460410'}",9,"{'国信弘盛', '现金', '定价', '吉林敖东', '瑞禾惠', '金域投资', '鹏源资本', '光大永明', '36'}",10,"{'国信弘盛', '现金', '100000000', '定价', '吉林敖东', '瑞禾惠', '金域投资', '鹏源资本', '光大永明', '36'}"
19,"{'新余市君创铭石投资中心(有限合伙)', '现金', '广东恒润互兴资产管理有限公司', '5188945', '23406655', '无锡天乐润点投资管理合伙企业(有限合伙)', '定价', '18725324', '276666700', '61333300', '9362662', '221333300', '朱洁', '6768189', '80000000', '新余咸城信阳投资中心(有限合伙)', '36', '新余高新区逸帆投资管理中心(有限合伙)', '110666700'}",1820474,5,"{'276666700', '221333300', '110666700', '新余咸城信阳投资中心(有限合伙)', '61333300'}",5,"{'现金', '广东恒润互兴资产管理有限公司', '定价', '朱洁', '36'}",14,"{'新余市君创铭石投资中心(有限合伙)', '现金', '广东恒润互兴资产管理有限公司', '23406655', '无锡天乐润点投资管理合伙企业(有限合伙)', '定价', '18725324', '9362662', '朱洁', '6768189', '80000000', '5188945', '36', '新余高新区逸帆投资管理中心(有限合伙)'}"
25,"{'539999988', '安徽省铁路建设投资基金有限公司', '24545454', '5790912', '279999984', '现金', '26363636', '财通基金管理有限公司', '安徽省投资集团控股有限公司', '15095454', '竞价', '宝盈基金管理有限公司', '270999982', '12318181', '诺安基金管理有限公司', '国华人寿保险股份有限公司', '15000000', '579999992', '中国长城资产管理公司', '西南证券股份有限公司', '127400064', '330000000', '332099988', '12727272', '12'}",687509,1,{'竞价'},7,"{'现金', '12', '诺安基金管理有限公司', '财通基金管理有限公司', '安徽省投资集团控股有限公司', '宝盈基金管理有限公司', '西南证券股份有限公司'}",24,"{'539999988', '安徽省铁路建设投资基金有限公司', '24545454', '5790912', '279999984', '现金', '26363636', '财通基金管理有限公司', '安徽省投资集团控股有限公司', '15095454', '宝盈基金管理有限公司', '270999982', '12318181', '诺安基金管理有限公司', '国华人寿保险股份有限公司', '15000000', '579999992', '中国长城资产管理公司', '西南证券股份有限公司', '127400064', '330000000', '332099988', '12727272', '12'}"
15,"{'招商财富资产管理有限公司', '现金', '第一创业证券股份有限公司', '6430923', '诺安基金管理有限公司', '99999994.4', '18256578', '财通基金管理有限公司', '97750029.6', '竞价', '448999989.6', '29539473', '277499985.6', '6578947', '12'}",5003391,1,{'竞价'},4,"{'诺安基金管理有限公司', '现金', '12', '财通基金管理有限公司'}",14,"{'招商财富资产管理有限公司', '现金', '第一创业证券股份有限公司', '6430923', '诺安基金管理有限公司', '99999994.4', '18256578', '财通基金管理有限公司', '97750029.6', '448999989.6', '29539473', '277499985.6', '6578947', '12'}"
12,"{'3800000', '5700000', '闫峻', '兴业全球基金管理有限公司', '4000000', '定价', '杨孟君', '3540000', '西藏瑞华投资发展有限公司', '12', '汇添富基金管理有限公司', '8400000'}",410691,4,"{'3540000', '3800000', '4000000', '5700000'}",7,"{'闫峻', '兴业全球基金管理有限公司', '定价', '杨孟君', '西藏瑞华投资发展有限公司', '12', '汇添富基金管理有限公司'}",8,"{'闫峻', '兴业全球基金管理有限公司', '定价', '杨孟君', '西藏瑞华投资发展有限公司', '12', '汇添富基金管理有限公司', '8400000'}"
5,"{'现金', '辽宁方大', '124674220', '竞价', '36'}",1537997,1,{'竞价'},3,"{'36', '现金', '辽宁方大'}",4,"{'36', '124674220', '现金', '辽宁方大'}"
4,"{'140845070', '杭州恒逸投资有限公司', '现金', '36'}",1805556,0,set(),3,"{'杭州恒逸投资有限公司', '现金', '36'}",4,"{'140845070', '杭州恒逸投资有限公司', '现金', '36'}"
5,"{'现金', '西宁特殊钢集团有限责任公司', '竞价', '500000000', '36'}",406315,1,{'500000000'},4,"{'西宁特殊钢集团有限责任公司', '竞价', '现金', '36'}",4,"{'现金', '竞价', '西宁特殊钢集团有限责任公司', '36'}"
8,"{'800000000', '现金', '深圳市能源集团有限公司', '定价', '华能国际电力股份有限公司', '200000000', '股权', '36'}",817685,0,set(),6,"{'现金', '深圳市能源集团有限公司', '定价', '华能国际电力股份有限公司', '股权', '36'}",8,"{'800000000', '现金', '深圳市能源集团有限公司', '定价', '华能国际电力股份有限公司', '200000000', '股权', '36'}"
18,"{'49999635', '永辉超市股份有限公司', '太平洋资产管理有限责任公司', '12', '26581600', '149999670', '中国食品发酵工业研究院', '19607800', '上海市糖业烟酒(集团)有限公司', '6535900', '上海扣山投资管理中心(有限合伙)', '竞价', '中国对外经济贸易信托有限公司', '鹏华基金管理有限公司', '27652455', '203349240', '36', '3614700'}",909453,1,{'上海扣山投资管理中心(有限合伙)'},8,"{'36', '永辉超市股份有限公司', '太平洋资产管理有限责任公司', '12', '中国食品发酵工业研究院', '竞价', '鹏华基金管理有限公司', '中国对外经济贸易信托有限公司'}",17,"{'49999635', '永辉超市股份有限公司', '太平洋资产管理有限责任公司', '12', '26581600', '149999670', '中国食品发酵工业研究院', '19607800', '上海市糖业烟酒(集团)有限公司', '6535900', '竞价', '中国对外经济贸易信托有限公司', '鹏华基金管理有限公司', '27652455', '203349240', '36', '3614700'}"
6,"{'现金', '中意资产管理有限责任公司', '10880316', '109999994.8', '竞价', '12'}",20314486,2,"{'109999994.8', '竞价'}",3,"{'现金', '12', '中意资产管理有限责任公司'}",4,"{'10880316', '现金', '12', '中意资产管理有限责任公司'}"
16,"{'江阴顺元投资发展有限公司', '5000000', '3200000', '中国人保资产管理股份有限公司', '4000000', '赵巧芳', '深圳金石资产管理中心(有限合伙)', '5500000', '易方达基金管理有限公司', '华宝信托有限责任公司', '竞价', '3000000', '郑文平', '5300000', '2542780', '12'}",421573,3,"{'2542780', '3000000', '5300000'}",2,"{'竞价', '12'}",13,"{'江阴顺元投资发展有限公司', '5000000', '3200000', '中国人保资产管理股份有限公司', '4000000', '赵巧芳', '深圳金石资产管理中心(有限合伙)', '5500000', '易方达基金管理有限公司', '华宝信托有限责任公司', '竞价', '郑文平', '12'}"
13,"{'中车金证投资有限公司', '信诚基金管理有限公司', '定价', '财通基金管理有限公司', '10528170', '10598591', '300999984.4', '10563380', '299999992', '299000028', '汇添富基金管理股份有限公司', '12', '华泰柏瑞基金管理有限公司'}",14211746,0,set(),7,"{'中车金证投资有限公司', '信诚基金管理有限公司', '定价', '财通基金管理有限公司', '汇添富基金管理股份有限公司', '12', '华泰柏瑞基金管理有限公司'}",13,"{'中车金证投资有限公司', '信诚基金管理有限公司', '定价', '财通基金管理有限公司', '10528170', '10598591', '300999984.4', '10563380', '299999992', '299000028', '汇添富基金管理股份有限公司', '12', '华泰柏瑞基金管理有限公司'}"
5,"{'现金', '杭州盘江汇智投资合伙企业(有限合伙)', '建信基金管理有限责任公司', '上海北信瑞丰资产管理有限公司', '36'}",1972498,1,{'杭州盘江汇智投资合伙企业(有限合伙)'},4,"{'建信基金管理有限责任公司', '现金', '上海北信瑞丰资产管理有限公司', '36'}",4,"{'建信基金管理有限责任公司', '现金', '上海北信瑞丰资产管理有限公司', '36'}"
3,"{'昝圣达', '现金', '36'}",230115,0,set(),3,"{'昝圣达', '现金', '36'}",3,"{'昝圣达', '现金', '36'}"
5,"{'现金', '100000000', '竞价', '深圳国恒', '36'}",1397216,2,"{'100000000', '竞价'}",3,"{'现金', '深圳国恒', '36'}",3,"{'现金', '深圳国恒', '36'}"
5,"{'定价', '187274458', '广弘公司', '股权', '36'}",1067914,1,{'187274458'},4,"{'广弘公司', '定价', '股权', '36'}",4,"{'广弘公司', '定价', '股权', '36'}"
19,"{'150000000', '20000000', '900000000', '现金', '新疆宏昇源', '芜湖江和', '600000000', '100000000', '深圳中民', '长沙云鼎', '广西正和', '孚威天玑', '300000000', '深圳盛财', '120000000', '50000000', '180000000', '30000000', '36'}",922492,5,"{'900000000', '600000000', '300000000', '120000000', '180000000'}",9,"{'现金', '新疆宏昇源', '芜湖江和', '深圳中民', '长沙云鼎', '广西正和', '孚威天玑', '深圳盛财', '36'}",14,"{'150000000', '20000000', '现金', '新疆宏昇源', '芜湖江和', '100000000', '深圳中民', '长沙云鼎', '广西正和', '孚威天玑', '深圳盛财', '50000000', '30000000', '36'}"
33,"{'191999998.3', '10845510', '186239985.8', '11049079', '中国华电集团资本控股有限公司', '276949989.5', '现金', '32184282.31', '定价', '哈尔滨龙晟资产管理有限责任公司', '1794996', '10387060', '215999984.6', '10373675', '上海力利投资管理合伙企业(有限合伙)', '186047991.4', '15446179', '194459994.3', '雅戈尔集团股份有限公司', '浙江天堂硅谷乐通股权投资合伙企业(有限合伙)', '方正证券股份有限公司', '10708310', '198109986.5', '10485220', '绍兴越商七期投资合伙企业(有限合伙)', '10376352', '天津凯石益金股权投资基金合伙企业(有限合伙)', '济南北安投资有限公司', '185999992.8', '西安长国投资管理有限合伙企业', '12046848', '12', '187999994.6'}",1498222,4,"{'198109986.5', '186047991.4', '276949989.5', '185999992.8'}",9,"{'中国华电集团资本控股有限公司', '现金', '定价', '哈尔滨龙晟资产管理有限责任公司', '雅戈尔集团股份有限公司', '方正证券股份有限公司', '济南北安投资有限公司', '西安长国投资管理有限合伙企业', '12'}",29,"{'191999998.3', '10845510', '11049079', '186239985.8', '中国华电集团资本控股有限公司', '现金', '32184282.31', '定价', '哈尔滨龙晟资产管理有限责任公司', '1794996', '10387060', '215999984.6', '10373675', '上海力利投资管理合伙企业(有限合伙)', '15446179', '194459994.3', '雅戈尔集团股份有限公司', '浙江天堂硅谷乐通股权投资合伙企业(有限合伙)', '方正证券股份有限公司', '10708310', '10485220', '绍兴越商七期投资合伙企业(有限合伙)', '10376352', '天津凯石益金股权投资基金合伙企业(有限合伙)', '济南北安投资有限公司', '西安长国投资管理有限合伙企业', '12046848', '12', '187999994.6'}"
4,"{'竞价', '现金', '黄河实业', '36'}",1260959,1,{'竞价'},3,"{'现金', '黄河实业', '36'}",3,"{'现金', '黄河实业', '36'}"
16,"{'15249714', '现金', '400000000', '景和道', '7624857', '100000000', '定价', '青尚股权', '11437285', '3812428', '深圳鼎江', '宁波中汇', '300000000', '200000000', '36', '深圳平湖'}",9895499,3,"{'100000000', '200000000', '400000000'}",8,"{'36', '现金', '景和道', '定价', '青尚股权', '宁波中汇', '深圳鼎江', '深圳平湖'}",13,"{'15249714', '现金', '景和道', '7624857', '11437285', '青尚股权', '3812428', '定价', '深圳鼎江', '宁波中汇', '300000000', '36', '深圳平湖'}"
8,"{'现金', '欧阳华珍', '新疆智明', '20216900', '62672300', '38412000', '郑素贞', '36'}",718889,3,"{'62672300', '38412000', '20216900'}",5,"{'现金', '欧阳华珍', '新疆智明', '郑素贞', '36'}",5,"{'现金', '欧阳华珍', '新疆智明', '郑素贞', '36'}"
16,"{'杭州万好万家股权投资有限公司', '5000000', '兵器财务有限责任公司', '6000000', '华夏基金管理有限公司', '7000000', '易方达基金管理有限公司', '雅戈尔集团股份有限公司', '6300000', '中信证券股份有限公司', '3787000', '5300000', '华泰证券股份有限公司', '信达澳银基金管理有限公司', '12', '天津证大金兔股权投资基金合伙企业(有限合伙)'}",1264449,1,{'3787000'},4,"{'易方达基金管理有限公司', '信达澳银基金管理有限公司', '12', '华夏基金管理有限公司'}",15,"{'杭州万好万家股权投资有限公司', '5000000', '兵器财务有限责任公司', '6000000', '华夏基金管理有限公司', '7000000', '易方达基金管理有限公司', '雅戈尔集团股份有限公司', '6300000', '中信证券股份有限公司', '5300000', '华泰证券股份有限公司', '信达澳银基金管理有限公司', '12', '天津证大金兔股权投资基金合伙企业(有限合伙)'}"
7,"{'现金', '35000000', '定价', '15000000', '杭州永银投资合伙企业(有限合伙)', '浙江赞宇科技股份有限公司第一期员工持股计划', '36'}",1769327,3,"{'杭州永银投资合伙企业(有限合伙)', '15000000', '35000000'}",4,"{'36', '定价', '现金', '浙江赞宇科技股份有限公司第一期员工持股计划'}",4,"{'现金', '定价', '36', '浙江赞宇科技股份有限公司第一期员工持股计划'}"
13,"{'939999992', '64032697', '华安未来资产管理(上海)有限公司', '泰达宏利基金管理有限公司', '47683923', '699999989.6', '999999999.9', '竞价', '方正富邦基金管理有限公司', '建信基金管理有限责任公司', '华融证券股份有限公司', '68119891', '12'}",2260700,2,"{'939999992', '999999999.9'}",6,"{'泰达宏利基金管理有限公司', '竞价', '方正富邦基金管理有限公司', '建信基金管理有限责任公司', '华融证券股份有限公司', '12'}",11,"{'64032697', '华安未来资产管理(上海)有限公司', '泰达宏利基金管理有限公司', '47683923', '699999989.6', '竞价', '方正富邦基金管理有限公司', '建信基金管理有限责任公司', '华融证券股份有限公司', '68119891', '12'}"
11,"{'3125000', '现金', '国寿安保基金管理有限公司', '竞价', '青岛城阳开发投资集团有限公司', '青岛城投金融控股集团有限公司', '9375000', '12500000', '泰达宏利基金管理有限公司', '华融证券股份有限公司', '12'}",19695420,1,{'竞价'},7,"{'现金', '国寿安保基金管理有限公司', '青岛城阳开发投资集团有限公司', '青岛城投金融控股集团有限公司', '泰达宏利基金管理有限公司', '华融证券股份有限公司', '12'}",10,"{'3125000', '现金', '国寿安保基金管理有限公司', '青岛城阳开发投资集团有限公司', '青岛城投金融控股集团有限公司', '9375000', '12500000', '泰达宏利基金管理有限公司', '华融证券股份有限公司', '12'}"
16,"{'现金', '1190000000', '中国人寿', '华泰汽车', '熔盛投资', '660000000', '定价', '1424000000', '160000000', '船东互保协会', '南方希望', '500000000', '泛海控股', '36', '上海健特', '266000000'}",499362,5,"{'1190000000', '160000000', '1424000000', '660000000', '266000000'}",10,"{'36', '现金', '中国人寿', '华泰汽车', '熔盛投资', '定价', '南方希望', '泛海控股', '上海健特', '船东互保协会'}",11,"{'36', '现金', '中国人寿', '华泰汽车', '熔盛投资', '定价', '南方希望', '500000000', '泛海控股', '上海健特', '船东互保协会'}"
4,"{'36', '105000000', '现金', '中国机械工业集团有限公司'}",301195,1,{'105000000'},3,"{'36', '现金', '中国机械工业集团有限公司'}",3,"{'36', '现金', '中国机械工业集团有限公司'}"
28,"{'北京瑞丰投资管理有限公司', '16100000', '华泰资产管理有限公司', '广发乾和投资有限公司', '111150000', '13538360', '现金', '新华基金管理有限公司', '89775000', '财通基金管理有限公司', '137655000', '东吴证券股份有限公司', '10000000', '36', '38584328.85', '航天科工资产管理有限公司', '4512787', '21414184.65', '10100000', '85500000', '中国航天科工集团公司', '115752978', '金鹰基金管理有限公司', '86355000', '13000000', '2504583', '10500000', '12'}",267471,11,"{'86355000', '38584328.85', '16100000', '13000000', '89775000', '21414184.65', '137655000', '2504583', '85500000', '111150000', '115752978'}",5,"{'现金', '航天科工资产管理有限公司', '12', '中国航天科工集团公司', '36'}",17,"{'北京瑞丰投资管理有限公司', '金鹰基金管理有限公司', '13538360', '新华基金管理有限公司', '36', '现金', '航天科工资产管理有限公司', '4512787', '华泰资产管理有限公司', '财通基金管理有限公司', '广发乾和投资有限公司', '10100000', '东吴证券股份有限公司', '10500000', '10000000', '中国航天科工集团公司', '12'}"
18,"{'太平洋资产管理有限责任公司', '现金', '5702429', '兴业全球基金管理有限公司', '109949184.7', '10218963', '6475217', '上海珑骐投资中心(有限合伙)', '2836607', '竞价', '48165586.86', '鹏华基金管理有限公司', '96827244.42', '51539988.3', '173517991.7', '12', '国联证券股份有限公司', '3035335'}",1089461,1,{'109949184.7'},7,"{'太平洋资产管理有限责任公司', '现金', '兴业全球基金管理有限公司', '竞价', '鹏华基金管理有限公司', '12', '国联证券股份有限公司'}",17,"{'太平洋资产管理有限责任公司', '现金', '5702429', '兴业全球基金管理有限公司', '10218963', '6475217', '上海珑骐投资中心(有限合伙)', '2836607', '48165586.86', '竞价', '鹏华基金管理有限公司', '96827244.42', '51539988.3', '173517991.7', '12', '国联证券股份有限公司', '3035335'}"
6,"{'现金', '160000000', '竞价', '8000000', '兴龙实业', '36'}",184725,3,"{'竞价', '8000000', '160000000'}",3,"{'现金', '兴龙实业', '36'}",3,"{'现金', '兴龙实业', '36'}"
4,"{'竞价', '现金', '36', '亦庄投资'}",1204198,0,set(),4,"{'竞价', '现金', '36', '亦庄投资'}",4,"{'竞价', '现金', '36', '亦庄投资'}"
7,"{'现金', '83507306', '兴业集团', '104384132', '竞价', '西北矿业', '36'}",679128,3,"{'104384132', '竞价', '83507306'}",4,"{'现金', '36', '西北矿业', '兴业集团'}",4,"{'现金', '36', '西北矿业', '兴业集团'}"
14,"{'现金', '249984000', '10080000', '长石投资有限公司', '5040000', '鑫元基金管理有限公司', '东海基金管理有限责任公司', '深圳市方德智联投资管理有限公司', '4360000', '129753600', '149990400', '299980800', '36', '8400000'}",1802694,1,{'149990400'},6,"{'现金', '长石投资有限公司', '鑫元基金管理有限公司', '东海基金管理有限责任公司', '深圳市方德智联投资管理有限公司', '36'}",13,"{'现金', '249984000', '10080000', '长石投资有限公司', '5040000', '鑫元基金管理有限公司', '东海基金管理有限责任公司', '深圳市方德智联投资管理有限公司', '4360000', '129753600', '299980800', '36', '8400000'}"
21,"{'申万菱信(上海)资产管理有限公司', '华泰资产管理有限公司', '广发基金管理有限公司', '209999998', '34153846', '中电投蒙东能源集团有限责任公司', '上海大正投资有限公司', '199999995', '271000009', '32307692', '孙挂霞', '太平洋资产管理有限责任公司', '300000006', '36', '299999999', '45692307', '221999999', '广发证券资产管理(广东)有限公司', '296999996', '46153847', '12'}",301746,7,"{'300000006', '209999998', '271000009', '296999996', '199999995', '221999999', '46153847'}",3,"{'36', '上海大正投资有限公司', '12'}",14,"{'广发证券资产管理(广东)有限公司', '孙挂霞', '36', '太平洋资产管理有限责任公司', '299999999', '申万菱信(上海)资产管理有限公司', '34153846', '华泰资产管理有限公司', '45692307', '中电投蒙东能源集团有限责任公司', '广发基金管理有限公司', '上海大正投资有限公司', '32307692', '12'}"
4,"{'吴迪', '竞价', '现金', '36'}",1817880,1,{'竞价'},3,"{'吴迪', '现金', '36'}",3,"{'吴迪', '现金', '36'}"
27,"{'79999994.5', '华数数字电视传媒集团有限公司', '海通证券股份有限公司', '5068965', '华夏资本管理有限公司', '59999999.5', '6855172', '7662071', '竞价', '5103448', '上海胜福婴童用品投资中心(有限合伙)', '74999988.5', '146999999.5', '南京瑞森投资管理合伙企业(有限合伙)', '36', '5517241', '摩根士丹利国际股份有限公司', '长盛基金管理有限公司', '10137931', '73499992.5', '浙江天堂硅谷久鸿股权投资合伙企业(有限合伙)', '4137931', '73999996', '5172413', '99399994', '12', '111100029.5'}",1078862,1,{'竞价'},7,"{'36', '华夏资本管理有限公司', '摩根士丹利国际股份有限公司', '长盛基金管理有限公司', '华数数字电视传媒集团有限公司', '海通证券股份有限公司', '12'}",26,"{'79999994.5', '华数数字电视传媒集团有限公司', '海通证券股份有限公司', '5068965', '华夏资本管理有限公司', '59999999.5', '6855172', '7662071', '5103448', '上海胜福婴童用品投资中心(有限合伙)', '74999988.5', '146999999.5', '南京瑞森投资管理合伙企业(有限合伙)', '36', '5517241', '摩根士丹利国际股份有限公司', '长盛基金管理有限公司', '10137931', '73499992.5', '浙江天堂硅谷久鸿股权投资合伙企业(有限合伙)', '4137931', '73999996', '5172413', '99399994', '12', '111100029.5'}"
7,"{'现金', '550000000', '250000000', '竞价', '洪都公司', '中航科工', '36'}",404390,2,"{'250000000', '550000000'}",5,"{'现金', '洪都公司', '竞价', '中航科工', '36'}",5,"{'现金', '洪都公司', '竞价', '中航科工', '36'}"
15,"{'广东省广晟资产经营有限公司', '定向资管计划(暨员工持股计划)', '1381313', '43760000', '100000000', '国华人寿保险股份有限公司', '14267676', '260240000', '8214646', '3156565', '500000000', '珺容战略资源1号基金', '15782828', '452000000', '刘益谦'}",1878877,10,"{'1381313', '43760000', '100000000', '14267676', '260240000', '8214646', '3156565', '500000000', '15782828', '452000000'}",1,{'广东省广晟资产经营有限公司'},5,"{'广东省广晟资产经营有限公司', '定向资管计划(暨员工持股计划)', '国华人寿保险股份有限公司', '珺容战略资源1号基金', '刘益谦'}"
25,"{'长安基金管理有限公司', '易方达基金管理有限公司', '299999979.3', '143849977.4', '7185878', '现金', '定价', '财通基金管理有限公司', '5632582', '165850064.2', '上海华谊(集团)公司', '12998266', '480299993', '36', '119999982.5', '20810225', '6232668', '招商财富资产管理有限公司', '浙江浙商证券资产管理有限公司', '129999992.6', '6932409', '5199306', '159999999.7', '创金合信基金管理有限公司', '12'}",1697063,3,"{'299999979.3', '119999982.5', '129999992.6'}",4,"{'定价', '12', '现金', '36'}",22,"{'长安基金管理有限公司', '易方达基金管理有限公司', '143849977.4', '7185878', '现金', '定价', '财通基金管理有限公司', '5632582', '165850064.2', '上海华谊(集团)公司', '12998266', '480299993', '36', '20810225', '6232668', '招商财富资产管理有限公司', '浙江浙商证券资产管理有限公司', '6932409', '5199306', '159999999.7', '创金合信基金管理有限公司', '12'}"
6,"{'105737705', '现金', '中色科金', '百善仁和', '26463700', '36'}",347063,2,"{'105737705', '26463700'}",4,"{'百善仁和', '现金', '中色科金', '36'}",4,"{'百善仁和', '现金', '中色科金', '36'}"
6,"{'现金', '40000000', '万载县银河湾投资有限公司', '定价', '395600000', '36'}",223410,1,{'395600000'},4,"{'36', '万载县银河湾投资有限公司', '定价', '现金'}",5,"{'现金', '40000000', '万载县银河湾投资有限公司', '定价', '36'}"
18,"{'北京亦庄国际投资发展有限公司', '北京经济技术投资开发总公司', '现金', '330000000', '北京工业发展投资管理有限公司', '北京嘉汇德信投资中心(有限合伙', '100000000', '12', '660000000', '西南证券股份有限公司', '竞价', '700000000', '500000000', '合肥融科项目投资有限公司', '200000000', '495049504', '36', '中外运空运发展股份有限公司'}",1236421,1,{'竞价'},9,"{'北京亦庄国际投资发展有限公司', '北京经济技术投资开发总公司', '现金', '36', '北京工业发展投资管理有限公司', '12', '合肥融科项目投资有限公司', '中外运空运发展股份有限公司', '西南证券股份有限公司'}",17,"{'北京亦庄国际投资发展有限公司', '北京经济技术投资开发总公司', '现金', '330000000', '北京工业发展投资管理有限公司', '北京嘉汇德信投资中心(有限合伙', '100000000', '12', '660000000', '西南证券股份有限公司', '700000000', '500000000', '合肥融科项目投资有限公司', '200000000', '495049504', '36', '中外运空运发展股份有限公司'}"
6,"{'现金', '国美咨询', '东方明珠', '30193814', '179153095', '36'}",15429642,0,set(),4,"{'东方明珠', '现金', '36', '国美咨询'}",6,"{'现金', '国美咨询', '东方明珠', '30193814', '179153095', '36'}"
15,"{'平安大华基金管理有限公司', '15500000', '13500000', '现金', '4500000', '贾丽娟', '3810000', '44460000', '华宝信托有限责任公司', '国泰基金管理有限公司', '133380000', '37642800', '153140000', '12', '海富通基金管理有限公司'}",1228595,7,"{'15500000', '13500000', '44460000', '133380000', '37642800', '153140000', '3810000'}",6,"{'平安大华基金管理有限公司', '现金', '华宝信托有限责任公司', '国泰基金管理有限公司', '12', '海富通基金管理有限公司'}",8,"{'平安大华基金管理有限公司', '现金', '4500000', '贾丽娟', '华宝信托有限责任公司', '国泰基金管理有限公司', '12', '海富通基金管理有限公司'}"
5,"{'124740125', '现金', '600000000', '宁夏宝塔石化集团有限公司', '36'}",937464,2,"{'124740125', '600000000'}",3,"{'现金', '宁夏宝塔石化集团有限公司', '36'}",3,"{'现金', '宁夏宝塔石化集团有限公司', '36'}"
3,"{'现金', '36', 'LAL公司'}",1015133,0,set(),2,"{'现金', '36'}",3,"{'现金', '36', 'LAL公司'}"
9,"{'京湖资本', '5208333', '1157407', '现金', '王代雪', '7716049', '刘宁', '李晓祥', '36'}",350694,3,"{'5208333', '1157407', '7716049'}",6,"{'京湖资本', '现金', '王代雪', '刘宁', '李晓祥', '36'}",6,"{'京湖资本', '现金', '王代雪', '刘宁', '李晓祥', '36'}"
29,"{'深圳名正', '34222809', '上海喜待', '112353254', '603690400', '上海爽达', '玉环捷瑞', '554532800', '宁波裕盛', '现金', '500200600', '北京天晟', '68445635', '竞价', '215603700', '上海哲萱', '宁波雨博', '86241492', '707825500', '宁波骏和', '431207500', '88021079', '95823873', '543321400', '41067381', '79396921', '258724500', '宁波万福', '36'}",14253450,9,"{'554532800', '707825500', '258724500', '500200600', '431207500', '603690400', '竞价', '215603700', '543321400'}",12,"{'玉环捷瑞', '宁波裕盛', '现金', '深圳名正', '北京天晟', '宁波骏和', '上海喜待', '宁波万福', '上海爽达', '上海哲萱', '宁波雨博', '36'}",20,"{'79396921', '宁波裕盛', '现金', '深圳名正', '34222809', '北京天晟', '宁波骏和', '上海喜待', '112353254', '88021079', '68445635', '95823873', '宁波雨博', '宁波万福', '上海爽达', '上海哲萱', '41067381', '玉环捷瑞', '86241492', '36'}"
15,"{'平安大华基金管理有限公司', '银华财富资本管理(北京)有限公司', '现金', '华融晋商资产管理股份有限公司', '10173541', '新华基金管理股份有限公司', '财通基金管理有限公司', '591013', '竞价', '10592445', '14868450', '5155444', '10173547', '12', '海富通基金管理有限公司'}",15715797,3,"{'591013', '竞价', '14868450'}",7,"{'平安大华基金管理有限公司', '现金', '华融晋商资产管理股份有限公司', '新华基金管理股份有限公司', '财通基金管理有限公司', '12', '海富通基金管理有限公司'}",12,"{'平安大华基金管理有限公司', '银华财富资本管理(北京)有限公司', '现金', '华融晋商资产管理股份有限公司', '10173541', '新华基金管理股份有限公司', '财通基金管理有限公司', '10592445', '5155444', '10173547', '12', '海富通基金管理有限公司'}"
25,"{'15714285', '129999996', '深圳天风天成资产管理有限公司', '申万菱信(上海)资产管理有限公司', '华泰资产管理有限公司', '北京千石创富资本管理有限公司', '18571428', '现金', '40000000', '定价', '财通基金管理有限公司', '信达澳银基金管理有限公司', '何慧清', '国华人寿保险股份有限公司', '109999995', '164999996', '1378660', '280000000', '138999994', '17142857', '23571428', '19857142', '12', '9650620', '119999999'}",1763024,0,set(),10,"{'现金', '深圳天风天成资产管理有限公司', '何慧清', '国华人寿保险股份有限公司', '定价', '华泰资产管理有限公司', '财通基金管理有限公司', '信达澳银基金管理有限公司', '北京千石创富资本管理有限公司', '12'}",25,"{'15714285', '129999996', '深圳天风天成资产管理有限公司', '申万菱信(上海)资产管理有限公司', '华泰资产管理有限公司', '北京千石创富资本管理有限公司', '18571428', '现金', '40000000', '定价', '财通基金管理有限公司', '信达澳银基金管理有限公司', '何慧清', '国华人寿保险股份有限公司', '109999995', '164999996', '1378660', '280000000', '138999994', '17142857', '23571428', '19857142', '12', '9650620', '119999999'}"
4,"{'竞价', '现金', '50000000', '物产集团'}",1276053,1,{'50000000'},3,"{'竞价', '现金', '物产集团'}",3,"{'竞价', '现金', '物产集团'}"
23,"{'9983361', '红土创新基金管理有限公司', '89999990.4', '6759437', '99999993.34', '国投瑞银基金管理有限公司', '7487520', '119999999.2', '24958402', '8319467', '100999997.2', '财通基金管理有限公司', '竞价', '宝盈基金管理有限公司', '8402662', '7570715', '90999994.3', '张克强', '81248432.74', '广西铁路发展投资基金(有限合伙)', '299999992', '中广核资本控股有限公司', '12'}",1829730,1,{'竞价'},7,"{'红土创新基金管理有限公司', '中广核资本控股有限公司', '财通基金管理有限公司', '张克强', '宝盈基金管理有限公司', '国投瑞银基金管理有限公司', '12'}",22,"{'9983361', '红土创新基金管理有限公司', '89999990.4', '6759437', '99999993.34', '国投瑞银基金管理有限公司', '7487520', '119999999.2', '24958402', '8319467', '100999997.2', '财通基金管理有限公司', '宝盈基金管理有限公司', '8402662', '7570715', '90999994.3', '张克强', '81248432.74', '广西铁路发展投资基金(有限合伙)', '299999992', '中广核资本控股有限公司', '12'}"
17,"{'安徽中安资本管理有限公司', '现金', '银华基金管理有限公司', '北信瑞丰基金管理有限公司', '27956990', '兴业财富资产管理有限公司', '43280430', '东海基金管理有限公司', '财通基金管理有限公司', '竞价', '25806451', '80805596', '鹏华基金管理有限公司', '27956987', '41935483', '12', '32258063'}",16144718,1,{'竞价'},9,"{'安徽中安资本管理有限公司', '现金', '银华基金管理有限公司', '北信瑞丰基金管理有限公司', '兴业财富资产管理有限公司', '东海基金管理有限公司', '财通基金管理有限公司', '鹏华基金管理有限公司', '12'}",16,"{'安徽中安资本管理有限公司', '现金', '银华基金管理有限公司', '北信瑞丰基金管理有限公司', '27956990', '兴业财富资产管理有限公司', '43280430', '东海基金管理有限公司', '财通基金管理有限公司', '25806451', '80805596', '鹏华基金管理有限公司', '27956987', '41935483', '12', '32258063'}"
29,"{'228999998.5', '192999995.5', '15627530', '30769230', '199999987.9', '泰达宏利基金管理有限公司', '19708502', '15384615', '现金', '379999990.5', '18542510', '定价', '财通基金管理有限公司', '鹏华基金管理有限公司', '华夏人寿保险股份有限公司', '36', '财富证券股份有限公司', '湖北德润投资发展有限公司', '国泰基金管理有限公司', '243399999.7', '64392713', '湘电集团有限公司', '69350029.45', '189999995.3', '16194331', '兴证证券资产管理有限公司', '795250005.6', '5615387', '12'}",14762528,4,"{'189999995.3', '199999987.9', '795250005.6', '69350029.45'}",4,"{'36', '现金', '定价', '12'}",25,"{'228999998.5', '192999995.5', '15627530', '30769230', '泰达宏利基金管理有限公司', '19708502', '15384615', '现金', '379999990.5', '18542510', '定价', '财通基金管理有限公司', '鹏华基金管理有限公司', '华夏人寿保险股份有限公司', '36', '财富证券股份有限公司', '湖北德润投资发展有限公司', '国泰基金管理有限公司', '243399999.7', '64392713', '湘电集团有限公司', '16194331', '兴证证券资产管理有限公司', '5615387', '12'}"
4,"{'竞价', '现金', '36', '成都博瑞投资控股集团有限公司'}",1133949,0,set(),4,"{'竞价', '现金', '36', '成都博瑞投资控股集团有限公司'}",4,"{'竞价', '现金', '36', '成都博瑞投资控股集团有限公司'}"
18,"{'15500000', '兵器财务有限责任公司', '现金', '8000000', '常州市新发展实业公司', '定价', '上海瑞熹联实业有限公司', '7000000', '林淑芳', '盛丰投资管理有限公司', '17000000', '富国基金管理有限公司', '东吴证券有限责任公司', '南方基金管理有限公司', '10000000', '12', '冯桂忠', '2500000'}",1244821,3,"{'17000000', '7000000', '2500000'}",9,"{'兵器财务有限责任公司', '现金', '常州市新发展实业公司', '定价', '上海瑞熹联实业有限公司', '盛丰投资管理有限公司', '富国基金管理有限公司', '东吴证券有限责任公司', '12'}",15,"{'15500000', '兵器财务有限责任公司', '8000000', '现金', '常州市新发展实业公司', '上海瑞熹联实业有限公司', '定价', '林淑芳', '盛丰投资管理有限公司', '富国基金管理有限公司', '东吴证券有限责任公司', '南方基金管理有限公司', '10000000', '12', '冯桂忠'}"
23,"{'12000000', '253858584', '海通证券股份有限公司', '融源成长(天津)股权投资合伙企业(有限合伙)', '北京国有资本经营管理中心', '中国高新投资集团公司', '14000000', '定价', '10000000', '14056400', '36', '长盛基金管理有限公司', '雅戈尔投资有限公司', '999998454', '252840000', '北京嘉诚资本投资管理有限公司', '180600000', '234780000', '13000000', '融通基金管理有限公司', '55370900', '12', '216720000'}",1500451,10,"{'12000000', '14056400', '253858584', '180600000', '234780000', '13000000', '252840000', '999998454', '55370900', '216720000'}",10,"{'36', '北京国有资本经营管理中心', '中国高新投资集团公司', '长盛基金管理有限公司', '融通基金管理有限公司', '定价', '雅戈尔投资有限公司', '海通证券股份有限公司', '12', '北京嘉诚资本投资管理有限公司'}",13,"{'36', '北京国有资本经营管理中心', '中国高新投资集团公司', '14000000', '长盛基金管理有限公司', '融通基金管理有限公司', '定价', '雅戈尔投资有限公司', '海通证券股份有限公司', '融源成长(天津)股权投资合伙企业(有限合伙)', '10000000', '12', '北京嘉诚资本投资管理有限公司'}"
14,"{'现金', '齐星集团', '金元惠理', '34000000', '首誉资管', '26000000', '千石创富', '英大基金', '永康投资', '聚辉投资', '46500000', '37600000', '22900000', '36'}",681107,5,"{'34000000', '26000000', '46500000', '37600000', '22900000'}",9,"{'现金', '齐星集团', '首誉资管', '千石创富', '英大基金', '永康投资', '聚辉投资', '金元惠理', '36'}",9,"{'现金', '齐星集团', '首誉资管', '千石创富', '英大基金', '永康投资', '聚辉投资', '金元惠理', '36'}"
4,"{'竞价', '现金', '中粮集团', '36'}",183701,0,set(),4,"{'竞价', '现金', '中粮集团', '36'}",4,"{'竞价', '现金', '中粮集团', '36'}"
25,"{'20332225', '15348837', '张慕中', '230999996.9', '305999986.3', '149999993.9', '现金', '鹏华资产管理有限公司', '137999996.8', '兴业财富资产管理有限公司', '财通基金管理有限公司', '9036544', '竞价', '135999987.2', '70830055.8', '9966777', '184999987.9', '4706316', '浙江浙商证券资产管理有限公司', '12292358', '银华基金管理股份有限公司', '嘉实基金管理有限公司', '天弘基金管理有限公司', '9169435', '12'}",15652742,5,"{'137999996.8', '230999996.9', '竞价', '305999986.3', '149999993.9'}",10,"{'现金', '鹏华资产管理有限公司', '浙江浙商证券资产管理有限公司', '银华基金管理股份有限公司', '兴业财富资产管理有限公司', '张慕中', '财通基金管理有限公司', '嘉实基金管理有限公司', '天弘基金管理有限公司', '12'}",20,"{'现金', '135999987.2', '鹏华资产管理有限公司', '浙江浙商证券资产管理有限公司', '70830055.8', '12292358', '20332225', '15348837', '张慕中', '184999987.9', '财通基金管理有限公司', '银华基金管理股份有限公司', '9966777', '天弘基金管理有限公司', '9036544', '兴业财富资产管理有限公司', '嘉实基金管理有限公司', '9169435', '4706316', '12'}"
22,"{'申万宏源证券有限公司', '前海开源基金管理有限公司', '现金', '44721669', '鹏华资产管理有限公司', '22365805', '财通基金管理有限公司', '竞价', '52186878', '899999993.2', '449999996.6', '1049999985', '平安资产管理有限责任公司', '664999982.7', '兴银基金管理有限责任公司', '33051689', '金鹰基金管理有限公司', '85199991.04', '4234592', '899799980.3', '44731610', '12'}",16219274,2,"{'664999982.7', '899799980.3'}",10,"{'金鹰基金管理有限公司', '现金', '鹏华资产管理有限公司', '平安资产管理有限责任公司', '财通基金管理有限公司', '申万宏源证券有限公司', '竞价', '兴银基金管理有限责任公司', '前海开源基金管理有限公司', '12'}",20,"{'金鹰基金管理有限公司', '现金', '44721669', '鹏华资产管理有限公司', '899999993.2', '449999996.6', '22365805', '4234592', '85199991.04', '1049999985', '平安资产管理有限责任公司', '财通基金管理有限公司', '申万宏源证券有限公司', '竞价', '兴银基金管理有限责任公司', '33051689', '52186878', '44731610', '前海开源基金管理有限公司', '12'}"
6,"{'现金', '600642000', '定价', '44100000', '东方基金', '36'}",606794,2,"{'44100000', '600642000'}",4,"{'定价', '东方基金', '现金', '36'}",4,"{'定价', '东方基金', '现金', '36'}"
18,"{'12000000', '现金', '兴业全球基金管理有限公司', '岳丽英', '9100000', '定价', '江西出版集团蓝海国际投资有限公司', '雅戈尔投资有限公司', '易方达基金管理有限公司', '常州投资集团有限公司', '10000000', '江西育科投资有限责任公司', '景隆融尊(天津)股权投资基金合伙企业(有限合伙)', '中财明远投资管理有限公司', '29300000', '30000000', '12', '14800000'}",1503787,0,set(),3,"{'定价', '现金', '12'}",18,"{'12000000', '现金', '兴业全球基金管理有限公司', '岳丽英', '9100000', '定价', '江西出版集团蓝海国际投资有限公司', '雅戈尔投资有限公司', '易方达基金管理有限公司', '常州投资集团有限公司', '10000000', '江西育科投资有限责任公司', '景隆融尊(天津)股权投资基金合伙企业(有限合伙)', '中财明远投资管理有限公司', '29300000', '30000000', '12', '14800000'}"
13,"{'现金', '535430', '1900000', '润晖投资咨询(北京)有限公司——斯坦福大学', '定价', '中国银河投资管理有限公司', '东方证券股份有限公司', '隋淑雯', '2000000', '国泰基金管理有限公司', '3000000', '8000000', '12'}",1203446,3,"{'1900000', '8000000', '535430'}",6,"{'现金', '定价', '东方证券股份有限公司', '2000000', '国泰基金管理有限公司', '12'}",10,"{'现金', '润晖投资咨询(北京)有限公司——斯坦福大学', '定价', '中国银河投资管理有限公司', '东方证券股份有限公司', '隋淑雯', '2000000', '国泰基金管理有限公司', '3000000', '12'}"
29,"{'6795608', '学思投资', '20125457', '科劲投资', '紫光育才', '现金', '544999983.8', '129999981', '定价', '1568217', '谷多投资', '银润投资首期1号员工持股计划', '269999997.4', '28489283', '36', '74751698', '29999991.21', '乐耘投资', '384999992.4', '14113957', '乐金兄弟', '10454783', '106638787', '2039999995', '健坤长青', '长城嘉信', '1429999983', '199999998.8', '国研宝业'}",1824769,4,"{'29999991.21', '544999983.8', '1429999983', '199999998.8'}",12,"{'学思投资', '现金', '定价', '健坤长青', '乐耘投资', '长城嘉信', '科劲投资', '紫光育才', '谷多投资', '36', '乐金兄弟', '国研宝业'}",25,"{'6795608', '学思投资', '20125457', '科劲投资', '紫光育才', '现金', '129999981', '定价', '1568217', '谷多投资', '银润投资首期1号员工持股计划', '269999997.4', '28489283', '74751698', '乐耘投资', '384999992.4', '14113957', '乐金兄弟', '10454783', '106638787', '2039999995', '健坤长青', '长城嘉信', '36', '国研宝业'}"
17,"{'399468', '现金', '山西证券股份有限公司', '华安基金管理有限公司', '1947419', '东海基金管理有限责任公司', '1509250', '3529698', '竞价', '鹏华基金管理有限公司', '上海诚鼎扬子投资合伙企业(有限合伙)', '创金合信基金管理有限公司', '信达澳银基金管理有限公司', '1460564', '鹏华资产管理(深圳)有限公司', '12', '1655306'}",1680786,8,"{'399468', '山西证券股份有限公司', '1947419', '1509250', '竞价', '1460564', '3529698', '1655306'}",7,"{'现金', '华安基金管理有限公司', '东海基金管理有限责任公司', '鹏华基金管理有限公司', '创金合信基金管理有限公司', '信达澳银基金管理有限公司', '12'}",9,"{'现金', '华安基金管理有限公司', '东海基金管理有限责任公司', '鹏华基金管理有限公司', '上海诚鼎扬子投资合伙企业(有限合伙)', '创金合信基金管理有限公司', '信达澳银基金管理有限公司', '鹏华资产管理(深圳)有限公司', '12'}"
18,"{'南京瑞森投资管理合伙企业(有限合伙)', '20000000', '现金', '工银瑞信基金管理有限公司', '四川长虹电器股份有限公司', '64102564', '12', '西南证券股份有限公司', '东海证券有限责任公司', '易方达基金管理有限公司', '竞价', '东海证券有限责任公司(资管)', '23800000', '7140171', '绵阳科技城发展投资(集团)有限公司', '30000000', '36', '胡智恒'}",1236476,1,{'竞价'},5,"{'36', '现金', '四川长虹电器股份有限公司', '西南证券股份有限公司', '12'}",17,"{'南京瑞森投资管理合伙企业(有限合伙)', '20000000', '现金', '工银瑞信基金管理有限公司', '四川长虹电器股份有限公司', '64102564', '12', '西南证券股份有限公司', '东海证券有限责任公司', '易方达基金管理有限公司', '东海证券有限责任公司(资管)', '23800000', '7140171', '绵阳科技城发展投资(集团)有限公司', '30000000', '36', '胡智恒'}"
23,"{'650317989.2', '999354000', '50000000', '48000000', '国电资本控股有限公司', '现金', '56158721', '新华人寿保险股份有限公司', '定价', '129533679', '中国航空集团公司', '36', '中国航空油料集团公司', '国华人寿保险股份有限公司', '1500000003', '759648000', '86300000', '雅戈尔集团股份有限公司', '579000000', '555840000', '中国人保资产管理股份有限公司', '65600000', '12'}",1501997,2,"{'650317989.2', '1500000003'}",6,"{'中国航空集团公司', '36', '现金', '中国航空油料集团公司', '定价', '12'}",21,"{'999354000', '50000000', '48000000', '国电资本控股有限公司', '现金', '56158721', '新华人寿保险股份有限公司', '定价', '129533679', '中国航空集团公司', '36', '中国航空油料集团公司', '国华人寿保险股份有限公司', '759648000', '86300000', '雅戈尔集团股份有限公司', '579000000', '555840000', '中国人保资产管理股份有限公司', '65600000', '12'}"
28,"{'深圳名正', '34222809', '上海喜待', '112353254', '603690400', '上海爽达', '玉环捷瑞', '554532800', '宁波裕盛', '现金', '500200600', '北京天晟', '68445635', '竞价', '215603700', '上海哲萱', '宁波雨博', '86241492', '707825500', '宁波骏和', '431207500', '95823873', '543321400', '41067381', '79396921', '258724500', '宁波万福', '36'}",14389836,9,"{'554532800', '707825500', '258724500', '500200600', '431207500', '603690400', '竞价', '215603700', '543321400'}",12,"{'玉环捷瑞', '宁波裕盛', '现金', '深圳名正', '北京天晟', '宁波骏和', '上海喜待', '宁波万福', '上海爽达', '上海哲萱', '宁波雨博', '36'}",19,"{'79396921', '宁波裕盛', '现金', '深圳名正', '34222809', '北京天晟', '宁波骏和', '上海喜待', '112353254', '68445635', '95823873', '宁波雨博', '宁波万福', '上海爽达', '上海哲萱', '41067381', '玉环捷瑞', '86241492', '36'}"
9,"{'现金', '宝钢集团有限公司', '中国船舶工业集团公司', '600000000', '债权、现金', '中国海运(集团)总公司', '竞价', '300000000', '36'}",424706,4,"{'中国海运(集团)总公司', '300000000', '债权、现金', '600000000'}",5,"{'现金', '宝钢集团有限公司', '中国船舶工业集团公司', '竞价', '36'}",5,"{'现金', '宝钢集团有限公司', '中国船舶工业集团公司', '竞价', '36'}"
11,"{'巨人投资有限公司', '现金', '中欧物流', '65000000', '定价', '辽宁成大集团有限公司', '143559636', '富邦人寿保险股份有限公司', '169889039', '80000000', '36'}",1901250,1,{'143559636'},7,"{'巨人投资有限公司', '现金', '中欧物流', '定价', '辽宁成大集团有限公司', '富邦人寿保险股份有限公司', '36'}",10,"{'巨人投资有限公司', '现金', '中欧物流', '65000000', '定价', '辽宁成大集团有限公司', '富邦人寿保险股份有限公司', '169889039', '80000000', '36'}"
4,"{'北新海天投资有限公司', '现金', '上银基金财富28、29、30号资产管理计划', '36'}",1577307,1,{'上银基金财富28、29、30号资产管理计划'},3,"{'北新海天投资有限公司', '现金', '36'}",3,"{'北新海天投资有限公司', '现金', '36'}"
26,"{'2089136', '太和东方', '4178274', '70000000', '8774373', '50000000', '现金', '63000000', '定价', '当代互联', '10000000', '30000000', '15000000', '远沐投资', '杨小蓉', '菁英时代—菁英时代久盈2号基金', '当代投资', '中智天诚', '黄立山', '先锋亚太', '203000000', '9749304', '6963788', '1392758', '28272981', '36'}",1768795,14,"{'2089136', '63000000', '4178274', '9749304', '70000000', '8774373', '15000000', '6963788', '1392758', '50000000', '10000000', '黄立山', '203000000', '28272981'}",10,"{'现金', '太和东方', '定价', '当代互联', '远沐投资', '杨小蓉', '中智天诚', '当代投资', '先锋亚太', '36'}",12,"{'现金', '太和东方', '定价', '当代互联', '远沐投资', '杨小蓉', '菁英时代—菁英时代久盈2号基金', '当代投资', '中智天诚', '先锋亚太', '30000000', '36'}"
20,"{'20000000', '现金', '武汉欣荣睿企业咨询管理有限公司', '上海圣瀚创业投资合伙企业(有限合伙)', '王德琦', '侯维才', '15000000', '冯美娟', '9000000', '苏州嘉禾亿创业投资中心(有限合伙)', '上海中能企业发展(集团)有限公司', '25000000', '7500000', '6000000', '10000000', '陈晓晖', '温晓宁', '36', '24000000', '孙利'}",325669,8,"{'20000000', '15000000', '9000000', '25000000', '6000000', '10000000', '24000000', '7500000'}",10,"{'现金', '武汉欣荣睿企业咨询管理有限公司', '王德琦', '侯维才', '冯美娟', '上海中能企业发展(集团)有限公司', '陈晓晖', '温晓宁', '36', '孙利'}",12,"{'现金', '武汉欣荣睿企业咨询管理有限公司', '上海圣瀚创业投资合伙企业(有限合伙)', '王德琦', '侯维才', '冯美娟', '苏州嘉禾亿创业投资中心(有限合伙)', '上海中能企业发展(集团)有限公司', '陈晓晖', '温晓宁', '36', '孙利'}"
4,"{'竞价', '现金', '550000000', '欣诺投资'}",2030120,1,{'550000000'},3,"{'竞价', '现金', '欣诺投资'}",3,"{'竞价', '现金', '欣诺投资'}"
4,"{'竞价', '上海市北高新(集团)有限公司', '36', '股权'}",1847302,0,set(),3,"{'竞价', '股权', '36'}",4,"{'竞价', '上海市北高新(集团)有限公司', '36', '股权'}"
15,"{'平安大华基金管理有限公司', '150000000', '现金', '5800464', '100000000', '深圳市怀真资产管理有限公司', '上海富诚海富通资产管理有限公司', '定价', '8700696', '杭州华弘荷泰投资管理合伙企业(有限合伙)', '杭州华弘湖泰投资管理合伙企业(有限合伙)', '300000000', '上海隆华汇投资管理有限公司', '17401392', '36'}",1728471,2,"{'150000000', '300000000'}",7,"{'平安大华基金管理有限公司', '现金', '深圳市怀真资产管理有限公司', '上海富诚海富通资产管理有限公司', '定价', '上海隆华汇投资管理有限公司', '36'}",13,"{'平安大华基金管理有限公司', '现金', '5800464', '100000000', '深圳市怀真资产管理有限公司', '上海富诚海富通资产管理有限公司', '定价', '8700696', '杭州华弘荷泰投资管理合伙企业(有限合伙)', '杭州华弘湖泰投资管理合伙企业(有限合伙)', '上海隆华汇投资管理有限公司', '17401392', '36'}"
4,"{'36', '竞价', '现金', '刘梦龙'}",15704978,0,set(),4,"{'36', '竞价', '现金', '刘梦龙'}",4,"{'36', '竞价', '现金', '刘梦龙'}"
20,"{'现金', '北信瑞丰基金管理有限公司', '84999980.8', '159999996.8', '12', '58600035.2', '尤友岳', '3794642', '79999987.2', '财通基金管理有限公司', '239999984', '竞价', '3571428', '申万菱信基金管理有限公司', '宝盈基金管理有限公司', '7142857', '2616073', '前海开源基金管理有限公司', '10714285', '36'}",14392846,1,{'竞价'},4,"{'尤友岳', '12', '现金', '36'}",19,"{'现金', '北信瑞丰基金管理有限公司', '84999980.8', '159999996.8', '12', '58600035.2', '尤友岳', '3794642', '79999987.2', '财通基金管理有限公司', '239999984', '3571428', '申万菱信基金管理有限公司', '宝盈基金管理有限公司', '7142857', '2616073', '前海开源基金管理有限公司', '10714285', '36'}"
14,"{'河北建投', '华能国际电力开发公司', '167000000', '现金', '5000000', '泰康人寿保险股份有限公司', '333000000', '12', '定价', '35000000', '60000000', '中国人寿资产管理有限公司', '博时基金管理有限公司—全国社保基金五零一组合', '36'}",823987,0,set(),9,"{'河北建投', '华能国际电力开发公司', '36', '现金', '泰康人寿保险股份有限公司', '定价', '中国人寿资产管理有限公司', '博时基金管理有限公司—全国社保基金五零一组合', '12'}",14,"{'河北建投', '华能国际电力开发公司', '167000000', '现金', '5000000', '333000000', '12', '定价', '35000000', '60000000', '中国人寿资产管理有限公司', '泰康人寿保险股份有限公司', '博时基金管理有限公司—全国社保基金五零一组合', '36'}"
16,"{'上海汽车集团股权投资有限公司(上汽投资-颀瑞1号)', '现金', '长城资本管理有限公司', '8422579', '10107095', '正海集团有限公司', '定价', '11791610', '125833330', '中国长城资产管理公司', '176166660', '151000010', '10107096', '151000000', '山东省国有资产投资控股有限公司', '36'}",14101158,1,{'山东省国有资产投资控股有限公司'},6,"{'36', '长城资本管理有限公司', '现金', '定价', '中国长城资产管理公司', '正海集团有限公司'}",15,"{'上海汽车集团股权投资有限公司(上汽投资-颀瑞1号)', '现金', '长城资本管理有限公司', '8422579', '10107095', '正海集团有限公司', '定价', '11791610', '125833330', '中国长城资产管理公司', '176166660', '151000010', '10107096', '151000000', '36'}"
7,"{'现金', '550000000', '250000000', '竞价', '洪都公司', '中航科工', '36'}",1154120,2,"{'250000000', '550000000'}",5,"{'现金', '洪都公司', '竞价', '中航科工', '36'}",5,"{'现金', '洪都公司', '竞价', '中航科工', '36'}"
15,"{'3988800', '现金', '10371200', '湖南海利高新技术产业集团有限公司', '招证资管-同赢之湖南海利1号员工持股计划定向资产管理计划', '38199690', '定价', '78095136', '5073000', '湖南国有资产经营管理有限公司', '深圳市瑞丰林投资管理中心(有限合伙)', '30035664', '63821268', '36', '8475600'}",19238446,0,set(),5,"{'现金', '湖南海利高新技术产业集团有限公司', '定价', '湖南国有资产经营管理有限公司', '36'}",15,"{'3988800', '10371200', '招证资管-同赢之湖南海利1号员工持股计划定向资产管理计划', '湖南海利高新技术产业集团有限公司', '38199690', '现金', '定价', '78095136', '5073000', '湖南国有资产经营管理有限公司', '深圳市瑞丰林投资管理中心(有限合伙)', '30035664', '63821268', '36', '8475600'}"
28,"{'13214505', '143999994.2', '8850645', '2028272', '现金', '10141364', '3073140', '财通基金管理有限公司', '竞价', '294999993.1', '鹏华基金管理有限公司', '79999996.75', '4917025', '北信瑞丰基金管理有限公司', '18131530', '博时基金管理有限公司', '49999987.8', '214999996.4', '富国基金管理有限公司', '华商基金管理有限公司', '华融证券股份有限公司', '17701290', '164999992.3', '32999985.44', '287999988.3', '嘉实基金管理有限公司', '安徽高新毅达皖江产业发展创业投资基金(有限合伙)', '12'}",18887420,15,"{'164999992.3', '10141364', '79999996.75', '18131530', '3073140', '13214505', '32999985.44', '287999988.3', '49999987.8', '214999996.4', '竞价', '294999993.1', '143999994.2', '8850645', '2028272'}",10,"{'现金', '北信瑞丰基金管理有限公司', '博时基金管理有限公司', '嘉实基金管理有限公司', '财通基金管理有限公司', '鹏华基金管理有限公司', '富国基金管理有限公司', '华商基金管理有限公司', '华融证券股份有限公司', '12'}",13,"{'现金', '北信瑞丰基金管理有限公司', '博时基金管理有限公司', '4917025', '嘉实基金管理有限公司', '财通基金管理有限公司', '安徽高新毅达皖江产业发展创业投资基金(有限合伙)', '富国基金管理有限公司', '鹏华基金管理有限公司', '华商基金管理有限公司', '华融证券股份有限公司', '12', '17701290'}"
10,"{'清华控股有限公司', '现金', '208913649', '工银瑞信基金管理有限公司', '紫光集团有限公司', '定价', '博时基金管理有限公司', '69637883', '278551532', '36'}",82457,0,set(),7,"{'清华控股有限公司', '现金', '工银瑞信基金管理有限公司', '紫光集团有限公司', '博时基金管理有限公司', '定价', '36'}",10,"{'清华控股有限公司', '现金', '208913649', '工银瑞信基金管理有限公司', '紫光集团有限公司', '博时基金管理有限公司', '定价', '69637883', '278551532', '36'}"
18,"{'259999992', '329999997.6', '现金', '19841269', '第一创业证券股份有限公司', '249999989.4', '红土创新基金管理有限公司', '信诚基金管理有限公司', '20634920', '博时基金管理有限公司', '26190476', '广东粤科资本投资有限公司', '52380957', '易方达基金管理有限公司', '660000058.2', '前海开源基金管理有限公司', '12', '秦川'}",15373401,0,set(),2,"{'现金', '12'}",18,"{'259999992', '329999997.6', '现金', '19841269', '第一创业证券股份有限公司', '249999989.4', '红土创新基金管理有限公司', '信诚基金管理有限公司', '20634920', '博时基金管理有限公司', '26190476', '广东粤科资本投资有限公司', '52380957', '易方达基金管理有限公司', '660000058.2', '前海开源基金管理有限公司', '12', '秦川'}"
20,"{'现金', '陈钦徽', '7407407', '陈钦发', '定价', '90000000', '70000000', '4115226', '4938271', '60000000', '万里翱翔计划', '5761316', '陈钦鹏', '16460905', '50000000', '慧富7号计划', '共赢2号计划', '200000000', '陈钦武', '36'}",1598025,2,"{'5761316', '16460905'}",8,"{'36', '现金', '陈钦发', '定价', '万里翱翔计划', '陈钦鹏', '陈钦武', '陈钦徽'}",18,"{'现金', '陈钦徽', '7407407', '陈钦发', '70000000', '90000000', '4115226', '万里翱翔计划', '4938271', '60000000', '定价', '陈钦鹏', '50000000', '慧富7号计划', '共赢2号计划', '200000000', '陈钦武', '36'}"
14,"{'现金', '529999996.8', '1026000000', '信诚基金管理有限公司', '华润元大基金管理有限公司', '建信基金管理有限责任公司', '106875000', '189079166', '172916666', '1815159994', '1659999994', '东方汇智资产管理有限公司', '12', '55208333'}",1854607,2,"{'1659999994', '1815159994'}",6,"{'现金', '信诚基金管理有限公司', '华润元大基金管理有限公司', '建信基金管理有限责任公司', '12', '东方汇智资产管理有限公司'}",12,"{'现金', '529999996.8', '1026000000', '信诚基金管理有限公司', '华润元大基金管理有限公司', '建信基金管理有限责任公司', '106875000', '189079166', '172916666', '东方汇智资产管理有限公司', '12', '55208333'}"
12,"{'4864489', '现金', '7701974', '华安基金管理有限公司', '12', '定价', '3474635', '财通基金管理有限公司', '上海界龙集团有限公司', '鹏华资产管理(深圳)有限公司', '36', '1772063'}",1665046,0,set(),7,"{'36', '现金', '华安基金管理有限公司', '定价', '财通基金管理有限公司', '上海界龙集团有限公司', '12'}",12,"{'4864489', '7701974', '现金', '华安基金管理有限公司', '12', '3474635', '定价', '财通基金管理有限公司', '上海界龙集团有限公司', '鹏华资产管理(深圳)有限公司', '36', '1772063'}"
28,"{'30261969', '尊雅锦绣', '160000000', '850000000', '7429990', '7226731', '164500000', '9033423', '200000000', '睿宇投资', '旭日九嘉', '现金', '26648599', '宏康众望', '16508571', '博锐奇投资', '400000000', '670000000', '嘉润宏实', '恒益达昌', '智宸宇投资', '旭日隆昌', '睿宏嘉业', '38392050', '590000000', '18066847', '365500000', '36'}",1794331,8,"{'400000000', '365500000', '670000000', '160000000', '850000000', '164500000', '200000000', '590000000'}",12,"{'旭日九嘉', '现金', '旭日隆昌', '睿宏嘉业', '尊雅锦绣', '宏康众望', '博锐奇投资', '嘉润宏实', '恒益达昌', '智宸宇投资', '睿宇投资', '36'}",20,"{'30261969', '旭日九嘉', '现金', '旭日隆昌', '睿宏嘉业', '26648599', '尊雅锦绣', '宏康众望', '16508571', '博锐奇投资', '18066847', '7429990', '嘉润宏实', '7226731', '38392050', '恒益达昌', '智宸宇投资', '9033423', '36', '睿宇投资'}"
10,"{'孔鑫明', '现金', '19305000', '定价', '99999900', '799999200', '工银瑞信投资管理有限公司', '154440000', '丁航飞', '36'}",1768453,1,{'定价'},5,"{'孔鑫明', '现金', '工银瑞信投资管理有限公司', '丁航飞', '36'}",9,"{'孔鑫明', '现金', '19305000', '99999900', '799999200', '工银瑞信投资管理有限公司', '154440000', '丁航飞', '36'}"
9,"{'赛德万方', '定价', '建新集团', '360339241', '301508345', '智尚劢合', '73538620', '股权', '36'}",919218,1,{'360339241'},6,"{'赛德万方', '定价', '建新集团', '智尚劢合', '股权', '36'}",8,"{'赛德万方', '股权', '定价', '建新集团', '智尚劢合', '73538620', '301508345', '36'}"
29,"{'19737553', '申万宏源证券有限公司', '299999997.1', '航天投资控股有限公司', '229999993', '现金', '18506787', '218099960.7', '279999994.3', '财通基金管理有限公司', '199999994.4', '竞价', '鹏华基金管理有限公司', '27149321', '36', '25339366', '203399991', '204499996.4', '国泰基金管理有限公司', '198999991.5', '20814479', '上海航天工业(集团)有限公司', '兴证证券资产管理有限公司', '18099547', '18009049', '18407239', '安信基金管理有限责任公司', '创金合信基金管理有限公司', '12'}",9897892,8,"{'204499996.4', '203399991', '218099960.7', '199999994.4', '198999991.5', '竞价', '299999997.1', '229999993'}",11,"{'36', '现金', '兴证证券资产管理有限公司', '财通基金管理有限公司', '申万宏源证券有限公司', '国泰基金管理有限公司', '安信基金管理有限责任公司', '鹏华基金管理有限公司', '创金合信基金管理有限公司', '航天投资控股有限公司', '12'}",21,"{'19737553', '申万宏源证券有限公司', '航天投资控股有限公司', '现金', '18506787', '279999994.3', '财通基金管理有限公司', '鹏华基金管理有限公司', '27149321', '36', '25339366', '国泰基金管理有限公司', '20814479', '上海航天工业(集团)有限公司', '兴证证券资产管理有限公司', '18099547', '18009049', '18407239', '安信基金管理有限责任公司', '创金合信基金管理有限公司', '12'}"
28,"{'东吴基金管理有限公司', '华泰资产管理有限公司', '云南冶金集团股份有限公司', '67307692', '897000000', '172500000', '312999996.4', '现金', '359999998.8', '379999999.6', '财通基金管理有限公司', '60576923', '竞价', '349999998.4', '36', '73076923', '69230769', '信诚基金管理有限公司', '147085900', '中信证券股份有限公司', '富国基金管理有限公司', '314999999.6', '177056788', '60192307', '华宝信托有限责任公司', '28285750', '12', '920695297.6'}",15462094,1,{'竞价'},11,"{'36', '现金', '东吴基金管理有限公司', '信诚基金管理有限公司', '12', '财通基金管理有限公司', '华泰资产管理有限公司', '华宝信托有限责任公司', '中信证券股份有限公司', '富国基金管理有限公司', '云南冶金集团股份有限公司'}",27,"{'东吴基金管理有限公司', '华泰资产管理有限公司', '云南冶金集团股份有限公司', '67307692', '897000000', '172500000', '312999996.4', '现金', '359999998.8', '379999999.6', '财通基金管理有限公司', '60576923', '349999998.4', '36', '73076923', '69230769', '信诚基金管理有限公司', '147085900', '中信证券股份有限公司', '富国基金管理有限公司', '314999999.6', '177056788', '60192307', '华宝信托有限责任公司', '28285750', '12', '920695297.6'}"
19,"{'江苏瑞华投资发展有限公司', '兴业全球基金管理有限公司', '华夏基金管理有限公司', '67176018', '2857143', '6076190', '127599990', '9837333', '60000000', '易方达基金管理有限公司', '75249993', '3198858', '天津证大金牛股权投资基金合伙企业(有限合伙)', '3018571', '206583993', '3583333', '五矿投资发展有限责任公司', '12', '63389991'}",1254460,0,set(),6,"{'兴业全球基金管理有限公司', '华夏基金管理有限公司', '江苏瑞华投资发展有限公司', '易方达基金管理有限公司', '五矿投资发展有限责任公司', '12'}",19,"{'江苏瑞华投资发展有限公司', '兴业全球基金管理有限公司', '华夏基金管理有限公司', '67176018', '2857143', '6076190', '127599990', '9837333', '60000000', '易方达基金管理有限公司', '75249993', '3198858', '天津证大金牛股权投资基金合伙企业(有限合伙)', '3018571', '206583993', '3583333', '五矿投资发展有限责任公司', '12', '63389991'}"
18,"{'上投摩根基金管理有限公司', '9500000', '17300000', '7000000', '广发基金管理有限公司', '国泰基金管理有限公司', '竞价', '上海国泰君安证券资产管理有限公司', '易方达基金管理有限公司', '7600000', '南方基金管理有限公司', '12700000', '12500000', '鹏华基金管理有限公司', '4900000', '12', '6700000', '海富通基金管理有限公司'}",1235173,7,"{'17300000', '竞价', '4900000', '7600000', '12500000', '12700000', '6700000'}",9,"{'上投摩根基金管理有限公司', '广发基金管理有限公司', '国泰基金管理有限公司', '上海国泰君安证券资产管理有限公司', '易方达基金管理有限公司', '南方基金管理有限公司', '鹏华基金管理有限公司', '12', '海富通基金管理有限公司'}",11,"{'上投摩根基金管理有限公司', '9500000', '7000000', '广发基金管理有限公司', '国泰基金管理有限公司', '上海国泰君安证券资产管理有限公司', '易方达基金管理有限公司', '南方基金管理有限公司', '鹏华基金管理有限公司', '12', '海富通基金管理有限公司'}"
24,"{'89999992.55', '贾伟平', '179999998.1', '现金', '中广核财务有限责任公司', '财通基金管理有限公司', '6917755', '7686395', '竞价', '吴立', '104999989.1', '99999998.95', '中信证券股份有限公司', '96999997.03', '7455803', '九泰基金管理有限公司', '大成基金管理有限公司', '银华基金管理股份有限公司', '2618666', '8070714', '34068844.66', '13835511', '银河金汇证券资产管理有限公司', '12'}",16428924,1,{'竞价'},11,"{'现金', '九泰基金管理有限公司', '大成基金管理有限公司', '银华基金管理股份有限公司', '中广核财务有限责任公司', '财通基金管理有限公司', '中信证券股份有限公司', '贾伟平', '吴立', '银河金汇证券资产管理有限公司', '12'}",23,"{'89999992.55', '贾伟平', '179999998.1', '现金', '中广核财务有限责任公司', '财通基金管理有限公司', '6917755', '7686395', '吴立', '104999989.1', '99999998.95', '中信证券股份有限公司', '96999997.03', '7455803', '九泰基金管理有限公司', '大成基金管理有限公司', '银华基金管理股份有限公司', '2618666', '8070714', '34068844.66', '13835511', '银河金汇证券资产管理有限公司', '12'}"
16,"{'现金', '81999994.8', '华安基金管理有限公司', '7192982', '58000019.4', '12', '79999990.2', '43859649', '诺德基金管理有限公司', '竞价', '安信基金管理有限责任公司', '5087721', '499999998.6', '株洲市国有资产投资控股集团有限公司', '7017543', '华泰柏瑞基金管理有限公司'}",14945655,1,{'竞价'},7,"{'现金', '华安基金管理有限公司', '安信基金管理有限责任公司', '诺德基金管理有限公司', '株洲市国有资产投资控股集团有限公司', '12', '华泰柏瑞基金管理有限公司'}",15,"{'现金', '81999994.8', '华安基金管理有限公司', '7192982', '58000019.4', '79999990.2', '43859649', '诺德基金管理有限公司', '7017543', '安信基金管理有限责任公司', '5087721', '499999998.6', '株洲市国有资产投资控股集团有限公司', '12', '华泰柏瑞基金管理有限公司'}"
4,"{'竞价', '现金', '36', '特变电工'}",423485,0,set(),4,"{'竞价', '现金', '36', '特变电工'}",4,"{'竞价', '现金', '36', '特变电工'}"
10,"{'广州金骏资产管理有限公司', '江苏瑞华投资发展有限公司', '江苏新业科技投资发展有限公司', '2000000', '竞价', '3000000', '海通证券股份有限公司', '东吴证券有限责任公司', '12', '江苏开元国际集团轻工业品进出口股份有限公司'}",544770,1,{'竞价'},1,{'12'},9,"{'广州金骏资产管理有限公司', '江苏瑞华投资发展有限公司', '江苏新业科技投资发展有限公司', '2000000', '3000000', '海通证券股份有限公司', '东吴证券有限责任公司', '12', '江苏开元国际集团轻工业品进出口股份有限公司'}"
21,"{'中国人民财产保险股份有限公司', '申能资产管理有限公司', '3000000', '无锡国联创业投资有限公司', '现金', '36000000', '长江证券有限责任公司', '中国建银投资证券有限责任公司', '180000000', '30000000', '24000000', '2500000', '中航鑫港担保有限公司', '诺安基金管理有限公司', '15000000', '泰康资产管理有限公司', '2000000', '27000000', '中国人寿资产管理有限公司', '2250000', '12'}",534022,7,"{'36000000', '15000000', '27000000', '180000000', '2250000', '24000000', '2500000'}",5,"{'现金', '诺安基金管理有限公司', '中国人民财产保险股份有限公司', '中国人寿资产管理有限公司', '12'}",14,"{'现金', '中航鑫港担保有限公司', '诺安基金管理有限公司', '长江证券有限责任公司', '中国人民财产保险股份有限公司', '2000000', '申能资产管理有限公司', '3000000', '无锡国联创业投资有限公司', '中国人寿资产管理有限公司', '中国建银投资证券有限责任公司', '泰康资产管理有限公司', '30000000', '12'}"
25,"{'497169998.3', '103977391', '413830016.2', '申万菱信基金管理有限公司', '泰达宏利基金管理有限公司', '498999998.3', '嘉兴民安投资合伙企业(有限合伙', '现金', '509999997.9', '兴业财富资产管理有限公司', '定价', '125376884', '天治基金管理有限公司', '128140703', '北信瑞丰基金管理有限公司', '123115577', '150753768', '351758793', '1399999996', '489999996.5', '西藏兆能新能源开发有限公司', '599999996.6', '124917085', '华安未来资产管理(上海)有限公司', '12'}",4929701,2,"{'413830016.2', '489999996.5'}",9,"{'现金', '北信瑞丰基金管理有限公司', '兴业财富资产管理有限公司', '定价', '西藏兆能新能源开发有限公司', '申万菱信基金管理有限公司', '泰达宏利基金管理有限公司', '天治基金管理有限公司', '12'}",23,"{'497169998.3', '103977391', '申万菱信基金管理有限公司', '泰达宏利基金管理有限公司', '498999998.3', '嘉兴民安投资合伙企业(有限合伙', '现金', '509999997.9', '兴业财富资产管理有限公司', '定价', '125376884', '天治基金管理有限公司', '128140703', '北信瑞丰基金管理有限公司', '123115577', '150753768', '351758793', '1399999996', '西藏兆能新能源开发有限公司', '599999996.6', '124917085', '华安未来资产管理(上海)有限公司', '12'}"
12,"{'常州京湖资本管理有限公司', '王代雪', '67499998.2', '7751937', '1162790', '刘宁', '竞价', '14999991', '99999987.3', '李晓祥', '36', '5232558'}",1814326,1,{'竞价'},5,"{'常州京湖资本管理有限公司', '王代雪', '刘宁', '李晓祥', '36'}",11,"{'常州京湖资本管理有限公司', '王代雪', '67499998.2', '7751937', '1162790', '刘宁', '14999991', '99999987.3', '李晓祥', '36', '5232558'}"
22,"{'华安基金管理有限公司', '10195578', '东方证券股份有限公司', '5103239', '易方达基金管理有限公司', '5102168', '294119999', '239799994.6', '工银瑞信基金管理有限公司', '120359977.9', '120104997.6', '鹏华基金管理有限公司', '汇添富基金管理股份有限公司', '5106505', '120028181.3', '中银基金管理有限公司', '120002991.4', '5117346', '139827717.1', '12505102', '5945056', '12'}",708295,3,"{'120028181.3', '120002991.4', '239799994.6'}",8,"{'华安基金管理有限公司', '工银瑞信基金管理有限公司', '东方证券股份有限公司', '易方达基金管理有限公司', '中银基金管理有限公司', '鹏华基金管理有限公司', '汇添富基金管理股份有限公司', '12'}",19,"{'汇添富基金管理股份有限公司', '华安基金管理有限公司', '工银瑞信基金管理有限公司', '10195578', '120359977.9', '东方证券股份有限公司', '5103239', '易方达基金管理有限公司', '5106505', '5117346', '中银基金管理有限公司', '120104997.6', '鹏华基金管理有限公司', '5102168', '294119999', '139827717.1', '12505102', '12', '5945056'}"
4,"{'36', '竞价', '现金', '精工投资'}",16608476,1,{'竞价'},3,"{'36', '现金', '精工投资'}",3,"{'36', '现金', '精工投资'}"
14,"{'天地实业', '20000000', '浙江食品公司', '12', '定价', '浙江烟糖公司', '源源投资', '资产', '16960000', '浙商集团', '杭钢集团', '张民一', '36', '国大集团'}",1069603,3,"{'20000000', '16960000', '定价'}",11,"{'天地实业', '36', '浙江食品公司', '浙江烟糖公司', '源源投资', '资产', '浙商集团', '杭钢集团', '张民一', '12', '国大集团'}",11,"{'天地实业', '浙江食品公司', '12', '浙江烟糖公司', '源源投资', '资产', '浙商集团', '杭钢集团', '张民一', '36', '国大集团'}"
15,"{'5000000', '现金', '上投摩根基金管理有限公司', '12', '定价', '15832738', '嘉实基金管理有限公司', '7000000', '红塔证券股份有限公司', '中国蓝星(集团)总公司', '中信证券股份有限公司', '4250000', '股权', '36', '中国国际金融有限公司'}",1538183,0,set(),11,"{'36', '现金', '上投摩根基金管理有限公司', '定价', '嘉实基金管理有限公司', '红塔证券股份有限公司', '中国蓝星(集团)总公司', '中信证券股份有限公司', '股权', '12', '中国国际金融有限公司'}",15,"{'5000000', '现金', '上投摩根基金管理有限公司', '12', '定价', '15832738', '嘉实基金管理有限公司', '7000000', '红塔证券股份有限公司', '中国蓝星(集团)总公司', '中信证券股份有限公司', '4250000', '股权', '36', '中国国际金融有限公司'}"
5,"{'现金', '竞价', '500000000', '上海环指投资中心(有限合伙)', '36'}",282942,2,"{'上海环指投资中心(有限合伙)', '500000000'}",3,"{'竞价', '现金', '36'}",3,"{'竞价', '现金', '36'}"
21,"{'20000000', '16000000', '中海基金管理有限公司', '浙江天堂硅谷长盈股权投资合伙企业(有限合伙)', '5000000', '现金', '7875500', '12', '17100000', '竞价', '朱在龙', '25000000', '江苏瑞华投资发展有限公司', '正大制药投资(北京)有限公司', '上海哲熙投资管理合伙企业(有限合伙)', '华宝信托有限责任公司', '江苏苏豪创业投资有限公司', '博弘数君(天津)股权投资基金合伙企业(有限合伙)', '泰康资产管理有限责任公司', '30650000', '36'}",1261368,1,{'30650000'},6,"{'现金', '12', '朱在龙', '竞价', '中海基金管理有限公司', '36'}",20,"{'20000000', '5000000', '现金', '7875500', '16000000', '江苏瑞华投资发展有限公司', '正大制药投资(北京)有限公司', '36', '上海哲熙投资管理合伙企业(有限合伙)', '17100000', '华宝信托有限责任公司', '朱在龙', '竞价', '25000000', '江苏苏豪创业投资有限公司', '浙江天堂硅谷长盈股权投资合伙企业(有限合伙)', '博弘数君(天津)股权投资基金合伙企业(有限合伙)', '泰康资产管理有限责任公司', '中海基金管理有限公司', '12'}"
21,"{'157040000', '晶鑫科技', '凯威创投', '现金', '125630000', '37690000', '鹏欣集团', '和汇实业', '18840000', '158290000', '厚康实业', '合臣化学', '12560000', '7540000', '宜众通达', '42710000', '兰月生物', '25130000', '晶浩信息', '刘红波', '36'}",678133,0,set(),12,"{'宜众通达', '现金', '晶鑫科技', '兰月生物', '晶浩信息', '厚康实业', '合臣化学', '和汇实业', '鹏欣集团', '刘红波', '凯威创投', '36'}",21,"{'157040000', '晶鑫科技', '凯威创投', '现金', '125630000', '37690000', '鹏欣集团', '和汇实业', '18840000', '158290000', '厚康实业', '合臣化学', '12560000', '7540000', '宜众通达', '42710000', '兰月生物', '25130000', '晶浩信息', '刘红波', '36'}"
9,"{'550000', '华夏基金管理有限公司', '2000000', '易方达基金管理有限公司', '1250000', '吴见娣', '国投财务有限公司', '1857159', '12'}",231698,2,"{'1250000', '1857159'}",5,"{'华夏基金管理有限公司', '易方达基金管理有限公司', '吴见娣', '国投财务有限公司', '12'}",7,"{'550000', '华夏基金管理有限公司', '2000000', '易方达基金管理有限公司', '吴见娣', '国投财务有限公司', '12'}"
12,"{'5000000', '现金', '福建天利电力科技有限公司', '深圳市利捷达贸易有限公司', '定价', '6900000', '江西省江信国际集团有限公司', '7000000', '上海大众汽车嘉定销售服务有限公司', '上海永润置业发展有限公司', '8000000', '12'}",1361909,0,set(),8,"{'现金', '福建天利电力科技有限公司', '深圳市利捷达贸易有限公司', '定价', '江西省江信国际集团有限公司', '上海大众汽车嘉定销售服务有限公司', '上海永润置业发展有限公司', '12'}",12,"{'5000000', '现金', '福建天利电力科技有限公司', '深圳市利捷达贸易有限公司', '定价', '6900000', '江西省江信国际集团有限公司', '7000000', '上海大众汽车嘉定销售服务有限公司', '上海永润置业发展有限公司', '8000000', '12'}"
19,"{'150000000', '大连中以太和投资管理中心(有限合伙)', '现金', '上海登君资产管理有限公司与上海阿卯网络科技有限公司拟设立的有限合伙企业', '21588946', '8635579', '100000000', '平安大华沃盈2号资产管理计划', '定价', '25906736', '12953368', '43177893', '250000000', '300000000', '杭州艮恒投资管理合伙企业(有限合伙)', '500000000', '长海县獐子岛投资发展中心', '36', '平安大华增利17号资产管理计划'}",1823669,9,"{'150000000', '21588946', '8635579', '100000000', '43177893', '25906736', '12953368', '250000000', '300000000'}",6,"{'上海登君资产管理有限公司与上海阿卯网络科技有限公司拟设立的有限合伙企业', '现金', '定价', '长海县獐子岛投资发展中心', '36', '平安大华增利17号资产管理计划'}",10,"{'大连中以太和投资管理中心(有限合伙)', '现金', '上海登君资产管理有限公司与上海阿卯网络科技有限公司拟设立的有限合伙企业', '平安大华沃盈2号资产管理计划', '定价', '杭州艮恒投资管理合伙企业(有限合伙)', '500000000', '长海县獐子岛投资发展中心', '36', '平安大华增利17号资产管理计划'}"
11,"{'7101800', '北信瑞丰基金管理有限公司', '7104000', '定价', '245798400', '491596800', '3552000', '中信建投基金管理有限公司', '安信基金管理有限责任公司', '12', '491444560'}",2301901,3,"{'491596800', '245798400', '491444560'}",5,"{'北信瑞丰基金管理有限公司', '定价', '中信建投基金管理有限公司', '安信基金管理有限责任公司', '12'}",8,"{'7101800', '北信瑞丰基金管理有限公司', '7104000', '定价', '3552000', '中信建投基金管理有限公司', '安信基金管理有限责任公司', '12'}"
16,"{'10548500', '现金', '华泰柏瑞-视觉中国特定多客户资产管理计划', '14000000', '定价', '东方证券股份有限公司', '9229900', '5274200', '3164500', '江苏武进国经投资发展有限公司', '兴铁产业投资基金(有限合伙)', '华泰柏瑞基金管理有限公司管理的华泰柏瑞-东方证券-视觉中国特定多客户资产管理计划', '10500000', '常州产业投资集团有限公司', '江苏慧德科技发展有限公司', '36'}",368311,8,"{'10548500', '14000000', '9229900', '5274200', '3164500', '华泰柏瑞基金管理有限公司管理的华泰柏瑞-东方证券-视觉中国特定多客户资产管理计划', '兴铁产业投资基金(有限合伙)', '10500000'}",8,"{'现金', '华泰柏瑞-视觉中国特定多客户资产管理计划', '定价', '东方证券股份有限公司', '江苏武进国经投资发展有限公司', '常州产业投资集团有限公司', '江苏慧德科技发展有限公司', '36'}",8,"{'现金', '华泰柏瑞-视觉中国特定多客户资产管理计划', '定价', '东方证券股份有限公司', '江苏武进国经投资发展有限公司', '常州产业投资集团有限公司', '江苏慧德科技发展有限公司', '36'}"
26,"{'13400000', '52260000', '华安基金管理有限公司', '山东滨州印染集团有限责任公司', '53820000', '66924000', '19000000', '现金', '兴业全球基金管理有限公司', '上海纺织投资管理有限公司', '6683660', '招商基金管理有限公司', '财通基金管理有限公司', '竞价', '37245000', '22970441', '36', '89584720', '26066274', '广东温氏投资有限公司', '17160000', '9550000', '土地', '13800000', '12', '74100000'}",894825,2,"{'山东滨州印染集团有限责任公司', '竞价'}",10,"{'现金', '土地', '华安基金管理有限公司', '兴业全球基金管理有限公司', '上海纺织投资管理有限公司', '12', '招商基金管理有限公司', '财通基金管理有限公司', '广东温氏投资有限公司', '36'}",24,"{'13400000', '52260000', '华安基金管理有限公司', '53820000', '66924000', '19000000', '现金', '兴业全球基金管理有限公司', '上海纺织投资管理有限公司', '6683660', '招商基金管理有限公司', '财通基金管理有限公司', '37245000', '22970441', '36', '89584720', '26066274', '广东温氏投资有限公司', '17160000', '9550000', '土地', '13800000', '12', '74100000'}"
29,"{'69900000', '胜辉投资', '9224800', '中投协基金', '安吉泰克', '中能投资', '王占国', '1319713', '340000000', '长信基金-曙光1号', '现金', '1649642', '定价', '48640915', '10000000', '徐双全', '44934000', '国润创投', '和创软件', '股权', '17342600', '12138100', '1736495', '100000000', '6428325', '14306151', '11531000', '2481061', '36'}",1655777,16,"{'17342600', '1649642', '69900000', '12138100', '1736495', '100000000', '44934000', '6428325', '9224800', '48640915', '14306151', '11531000', '2481061', '1319713', '10000000', '340000000'}",12,"{'现金', '胜辉投资', '股权', '国润创投', '定价', '和创软件', '安吉泰克', '中投协基金', '中能投资', '王占国', '徐双全', '36'}",13,"{'长信基金-曙光1号', '现金', '胜辉投资', '定价', '国润创投', '徐双全', '和创软件', '中投协基金', '安吉泰克', '中能投资', '王占国', '股权', '36'}"
14,"{'金鹰基金管理有限公司', '36', '程宗玉', '现金', '100000000.2', '298999994.7', '9206511', '竞价', '15208545', '181000006.3', '5086470', '信达澳银基金管理有限公司', '建信基金管理有限责任公司', '12'}",20503293,1,{'181000006.3'},8,"{'金鹰基金管理有限公司', '现金', '程宗玉', '12', '竞价', '信达澳银基金管理有限公司', '建信基金管理有限责任公司', '36'}",13,"{'金鹰基金管理有限公司', '36', '程宗玉', '现金', '100000000.2', '298999994.7', '9206511', '竞价', '15208545', '5086470', '信达澳银基金管理有限公司', '建信基金管理有限责任公司', '12'}"
6,"{'现金', '上海中能', '69370629', '定价', '1488000000', '36'}",1846047,2,"{'69370629', '1488000000'}",4,"{'定价', '现金', '上海中能', '36'}",4,"{'现金', '定价', '上海中能', '36'}"
5,"{'159999999.8', '创和投资', '竞价', '16016016', '36'}",320996,3,"{'159999999.8', '竞价', '16016016'}",2,"{'36', '创和投资'}",2,"{'36', '创和投资'}"
5,"{'现金', '华晨集团', '518000000', '200000000', '36'}",398145,2,"{'200000000', '518000000'}",3,"{'华晨集团', '现金', '36'}",3,"{'华晨集团', '现金', '36'}"
5,"{'中国纸业投资总公司', '20000000', '现金', '竞价', '36'}",1153077,1,{'20000000'},4,"{'中国纸业投资总公司', '竞价', '现金', '36'}",4,"{'中国纸业投资总公司', '竞价', '现金', '36'}"
5,"{'现金', '郭现生', '竞价', '宋全启', '36'}",314175,0,set(),5,"{'现金', '郭现生', '竞价', '宋全启', '36'}",5,"{'现金', '郭现生', '竞价', '宋全启', '36'}"
29,"{'浙江省物产集团有限公司', '36500000', '34931506', '国联安基金管理有限公司', '25684931', '263500004.3', '5000000', '财通基金管理有限公司', '12200008.2', '浙江物产金属集团有限公司', '187499996.3', '20684932', '36', '太平洋资产管理有限责任公司', '149999998.5', '1671234', '北京世纪力宏计算机软件科技有限公司', '诺安基金管理有限公司', '153300000', '290999994.9', '李怡名', '254999993.8', '20547945', '36095891', '151000003.6', '21000000', '39863013', '华安未来资产管理(上海)有限公司', '12'}",390060,0,set(),4,"{'浙江省物产集团有限公司', '12', '浙江物产金属集团有限公司', '36'}",29,"{'浙江省物产集团有限公司', '36500000', '34931506', '国联安基金管理有限公司', '25684931', '263500004.3', '5000000', '财通基金管理有限公司', '12200008.2', '浙江物产金属集团有限公司', '187499996.3', '20684932', '36', '太平洋资产管理有限责任公司', '149999998.5', '1671234', '北京世纪力宏计算机软件科技有限公司', '诺安基金管理有限公司', '153300000', '290999994.9', '李怡名', '254999993.8', '20547945', '36095891', '151000003.6', '21000000', '39863013', '华安未来资产管理(上海)有限公司', '12'}"
9,"{'现金', '23931583', '景德镇市焦化工业集团有限责任公司', '景德镇井冈山北汽创新发展投资中心(有限合伙)', '竞价', '96068417', '137367286.4', '36', '551432713.6'}",16407119,2,"{'竞价', '551432713.6'}",3,"{'现金', '36', '景德镇市焦化工业集团有限责任公司'}",7,"{'现金', '23931583', '景德镇市焦化工业集团有限责任公司', '景德镇井冈山北汽创新发展投资中心(有限合伙)', '96068417', '137367286.4', '36'}"
12,"{'现金', '民权中证国投创业投资基金(有限合伙)', '北京芯动能投资基金(有限合伙)', '49999992', '3982080', '财通基金管理有限公司', '79999987.2', '2488800', '3529120', '竞价', '70900020.8', '12'}",19242471,1,{'竞价'},3,"{'现金', '12', '财通基金管理有限公司'}",11,"{'现金', '民权中证国投创业投资基金(有限合伙)', '北京芯动能投资基金(有限合伙)', '49999992', '3982080', '财通基金管理有限公司', '79999987.2', '2488800', '3529120', '70900020.8', '12'}"
5,"{'现金', '东吉林省能源交通总公司', '竞价', '36', '中国电能成套设备有限公司'}",1749123,1,{'竞价'},4,"{'东吉林省能源交通总公司', '现金', '36', '中国电能成套设备有限公司'}",4,"{'东吉林省能源交通总公司', '现金', '36', '中国电能成套设备有限公司'}"
12,"{'现金', '长安基金管理有限公司', '兴业全球基金管理有限公司', '定价', '东方基金管理有限责任公司', '297225890', '2249999995', '297225891', '2249999987', '198150593', '1499999989', '36'}",350952,1,{'2249999995'},6,"{'现金', '长安基金管理有限公司', '兴业全球基金管理有限公司', '定价', '东方基金管理有限责任公司', '36'}",11,"{'长安基金管理有限公司', '现金', '兴业全球基金管理有限公司', '定价', '东方基金管理有限责任公司', '297225890', '297225891', '2249999987', '198150593', '1499999989', '36'}"
16,"{'招商财富资产管理有限公司', '现金', '陈国平', '20480833', '兵工财务有限责任公司', '定价', '122769996', '东海基金管理有限责任公司', '财通基金管理有限公司', '245769996', '10230833', '10263335', '123160020', '367999992', '12', '30666666'}",283607,0,set(),4,"{'陈国平', '现金', '定价', '12'}",16,"{'招商财富资产管理有限公司', '现金', '陈国平', '20480833', '兵工财务有限责任公司', '122769996', '定价', '东海基金管理有限责任公司', '财通基金管理有限公司', '245769996', '10230833', '10263335', '123160020', '367999992', '12', '30666666'}"
11,"{'古少波', '定价', '古少明', '古少扬', '古朴', '3222341', '10741138', '4296455', '56713211', '36', '李素玉'}",16804267,0,set(),7,"{'古少波', '定价', '古少明', '古少扬', '古朴', '36', '李素玉'}",11,"{'36', '古少波', '定价', '古少明', '古少扬', '古朴', '3222341', '4296455', '56713211', '10741138', '李素玉'}"
5,"{'现金', '陈清州', '500000000', '第三期员工持股计划', '36'}",15472939,1,{'500000000'},4,"{'现金', '36', '陈清州', '第三期员工持股计划'}",4,"{'现金', '36', '陈清州', '第三期员工持股计划'}"
4,"{'36', '竞价', '现金', '武汉当代科技产业集团股份有限公司'}",1329766,0,set(),4,"{'36', '竞价', '现金', '武汉当代科技产业集团股份有限公司'}",4,"{'36', '竞价', '现金', '武汉当代科技产业集团股份有限公司'}"
19,"{'南京瑞森投资管理合伙企业(有限合伙)', '1017812', '广东省广晟资产经营有限公司', '现金', '29290565.1', '2049872', '36', '745307', '200149476.6', '定价', '40000011.6', '5092862', '上海证大投资管理有限公司', '80559969.6', '广东温氏投资有限公司', '鹏华基金管理有限公司', '149999964.9', '12', '3816793'}",340952,8,"{'1017812', '29290565.1', '745307', '200149476.6', '40000011.6', '5092862', '80559969.6', '149999964.9'}",8,"{'广东省广晟资产经营有限公司', '现金', '12', '定价', '上海证大投资管理有限公司', '广东温氏投资有限公司', '鹏华基金管理有限公司', '36'}",11,"{'南京瑞森投资管理合伙企业(有限合伙)', '36', '广东省广晟资产经营有限公司', '现金', '2049872', '定价', '上海证大投资管理有限公司', '广东温氏投资有限公司', '鹏华基金管理有限公司', '12', '3816793'}"
6,"{'现金、股权', '174000000', '713400000', '定价', '上海交运(集团)公司', '36'}",1351957,2,"{'713400000', '现金、股权'}",2,"{'定价', '36'}",4,"{'定价', '36', '上海交运(集团)公司', '174000000'}"
6,"{'现金', '600000000', '定价', '48000000', '国开金融有限责任公司', '36'}",1626936,2,"{'48000000', '600000000'}",4,"{'定价', '现金', '国开金融有限责任公司', '36'}",4,"{'36', '定价', '国开金融有限责任公司', '现金'}"
19,"{'14400000', '现金', '6100000', '444000007', '158400000', '华安基金管理有限公司', '杭谷', '12', '67100000', '定价', '4500000', '国联安基金管理有限公司', '20999990', '广发基金管理有限公司', '40363637', '1909090', '36', '张家港保税区金港资产经营有限公司', '49500000'}",349335,0,set(),2,"{'现金', '12'}",19,"{'14400000', '现金', '6100000', '444000007', '158400000', '华安基金管理有限公司', '杭谷', '12', '67100000', '定价', '4500000', '国联安基金管理有限公司', '20999990', '广发基金管理有限公司', '40363637', '1909090', '36', '张家港保税区金港资产经营有限公司', '49500000'}"
15,"{'1400000', '15500000', '现金', '乐清市电力实业有限总公司', '乐清市海通电子实业公司', '江苏瑞华投资发展有限公司', '王文韬', '陈宏伟', '定价', '7000000', '吴宝发', '3100000', '1000000', '12', '支绍环'}",1210786,2,"{'1400000', '1000000'}",10,"{'乐清市电力实业有限总公司', '现金', '乐清市海通电子实业公司', '江苏瑞华投资发展有限公司', '王文韬', '陈宏伟', '定价', '吴宝发', '12', '支绍环'}",13,"{'15500000', '乐清市电力实业有限总公司', '现金', '乐清市海通电子实业公司', '江苏瑞华投资发展有限公司', '王文韬', '陈宏伟', '定价', '7000000', '吴宝发', '3100000', '12', '支绍环'}"
13,"{'36', '现金', '1026216880', '高瓴资本管理有限公司', '信诚基金管理有限公司', '37181771', '12681159', '竞价', '349999988.4', '12465733', '陈邦', '344054230.8', '12'}",18869294,2,"{'竞价', '1026216880'}",6,"{'现金', '高瓴资本管理有限公司', '信诚基金管理有限公司', '12', '陈邦', '36'}",11,"{'36', '现金', '高瓴资本管理有限公司', '信诚基金管理有限公司', '37181771', '12681159', '349999988.4', '12465733', '陈邦', '344054230.8', '12'}"
4,"{'现金', '50000000', '36', '中国平安人寿保险股份有限公司'}",807575,0,set(),3,"{'现金', '36', '中国平安人寿保险股份有限公司'}",4,"{'现金', '50000000', '36', '中国平安人寿保险股份有限公司'}"
17,"{'12000000', '20000000', '现金', '深圳市创新资本投资有限公司', '华安基金管理有限公司', '12452000', '定价', '博时基金管理有限公司', '15000000', '嘉实基金管理有限公司', '财通基金管理有限公司', '11000000', '10000000', '银河基金管理有限公司', '申万菱信基金管理有限公司', '广东中科招商创业投资管理有限责任公司', '12'}",366925,3,"{'12000000', '11000000', '12452000'}",10,"{'现金', '深圳市创新资本投资有限公司', '华安基金管理有限公司', '定价', '博时基金管理有限公司', '嘉实基金管理有限公司', '财通基金管理有限公司', '银河基金管理有限公司', '申万菱信基金管理有限公司', '12'}",14,"{'20000000', '现金', '深圳市创新资本投资有限公司', '华安基金管理有限公司', '博时基金管理有限公司', '15000000', '定价', '嘉实基金管理有限公司', '财通基金管理有限公司', '10000000', '银河基金管理有限公司', '申万菱信基金管理有限公司', '广东中科招商创业投资管理有限责任公司', '12'}"
25,"{'339999996.6', '60148693', '51671732', '304999996.1', '华泰资产管理有限公司', '何清华', '46352583', '45592705', '299999998.9', '竞价', '395778399.9', '36', '北信瑞丰基金管理有限公司', '43465045', '285999996.1', '金鹰基金管理有限公司', '113616.86', '17267', '金元顺安基金管理有限公司', '苏州工业园区鲁鑫创世创业投资企业(有限合伙)', '26747720', '安信基金管理有限责任公司', '创金合信基金管理有限公司', '175999997.6', '12'}",16755850,1,{'339999996.6'},10,"{'36', '金鹰基金管理有限公司', '北信瑞丰基金管理有限公司', '华泰资产管理有限公司', '金元顺安基金管理有限公司', '竞价', '安信基金管理有限责任公司', '何清华', '创金合信基金管理有限公司', '12'}",24,"{'60148693', '51671732', '304999996.1', '华泰资产管理有限公司', '何清华', '46352583', '45592705', '299999998.9', '竞价', '395778399.9', '36', '北信瑞丰基金管理有限公司', '43465045', '285999996.1', '金鹰基金管理有限公司', '113616.86', '17267', '金元顺安基金管理有限公司', '苏州工业园区鲁鑫创世创业投资企业(有限合伙)', '26747720', '安信基金管理有限责任公司', '创金合信基金管理有限公司', '175999997.6', '12'}"
7,"{'现金', '华宸未来基金管理有限公司', '18018018', '竞价', '36036036', '北京千石创富资本管理有限公司', '36'}",383420,1,{'竞价'},4,"{'现金', '华宸未来基金管理有限公司', '北京千石创富资本管理有限公司', '36'}",6,"{'现金', '华宸未来基金管理有限公司', '18018018', '36036036', '北京千石创富资本管理有限公司', '36'}"
22,"{'申万菱信(上海)资产管理有限公司', '117294589.7', '易方达基金管理有限公司', '14369337', '陕西省国际信托股份有限公司', '泰达宏利基金管理有限公司', '119993394.2', '华夏资本管理有限公司', '120615409.3', '财通基金管理有限公司', '339999931.3', '23693375', '206199986', '太平资产管理有限公司', '8274355', '10459930', '8361909', '8173839', '8405255', '150099995.5', '118736994.3', '12'}",313576,6,"{'119993394.2', '120615409.3', '117294589.7', '339999931.3', '118736994.3', '206199986'}",1,{'12'},16,"{'8274355', '华夏资本管理有限公司', '150099995.5', '10459930', '8361909', '申万菱信(上海)资产管理有限公司', '财通基金管理有限公司', '8173839', '14369337', '陕西省国际信托股份有限公司', '23693375', '易方达基金管理有限公司', '泰达宏利基金管理有限公司', '12', '8405255', '太平资产管理有限公司'}"
5,"{'现金', '深圳市通产集团有限公司', '371000000', '竞价', '36'}",574811,1,{'371000000'},4,"{'竞价', '现金', '36', '深圳市通产集团有限公司'}",4,"{'竞价', '现金', '36', '深圳市通产集团有限公司'}"
6,"{'现金', '孙晖', '定价', '6220028', '36', '132299995.6'}",16194800,1,{'132299995.6'},4,"{'孙晖', '定价', '现金', '36'}",5,"{'现金', '孙晖', '定价', '6220028', '36'}"
4,"{'36', '45818300', '现金', '辽宁曙光集团有限责任公司'}",817762,0,set(),3,"{'36', '现金', '辽宁曙光集团有限责任公司'}",4,"{'36', '45818300', '现金', '辽宁曙光集团有限责任公司'}"
11,"{'1883499933', '现金', '王薇', '2881500000', '555604700', '新理益集团', '5085000000', '850000000', '1500000000', '36', '刘益谦'}",1556933,0,set(),5,"{'现金', '王薇', '新理益集团', '36', '刘益谦'}",11,"{'1883499933', '36', '现金', '2881500000', '555604700', '新理益集团', '5085000000', '850000000', '1500000000', '王薇', '刘益谦'}"
6,"{'现金', '2388879301', '60', '定价', '46476251', '淘宝(中国)软件有限公司'}",1842090,1,{'2388879301'},3,"{'定价', '60', '现金'}",5,"{'现金', '定价', '60', '46476251', '淘宝(中国)软件有限公司'}"
6,"{'朱红玉', '22026431', '锐德创投', '竞价', '33039647', '36'}",12046269,3,"{'竞价', '22026431', '33039647'}",3,"{'36', '锐德创投', '朱红玉'}",3,"{'36', '锐德创投', '朱红玉'}"
4,"{'中国物资储运总公司', '竞价', '现金', '36'}",1131763,0,set(),4,"{'中国物资储运总公司', '竞价', '现金', '36'}",4,"{'中国物资储运总公司', '竞价', '现金', '36'}"
15,"{'王建林', '贺胜龙', '蒋云', '王正', '定价', '张丹丹', '6073988', '3078033', '王宇飞', '820809', '5540462', '287283', '4432369', '12', '冯健刚'}",293040,2,"{'287283', '820809'}",9,"{'王建林', '贺胜龙', '蒋云', '王正', '定价', '张丹丹', '王宇飞', '12', '冯健刚'}",13,"{'王建林', '贺胜龙', '蒋云', '王正', '定价', '张丹丹', '6073988', '3078033', '王宇飞', '5540462', '4432369', '12', '冯健刚'}"
6,"{'现金', '1642000000', '定价', '199249088', '以化上海', '36'}",116341,1,{'1642000000'},4,"{'定价', '36', '以化上海', '现金'}",5,"{'现金', '定价', '199249088', '以化上海', '36'}"
4,"{'828000000', '60', '定价', '荣安集团股份有限公司'}",1064158,0,set(),3,"{'定价', '60', '荣安集团股份有限公司'}",4,"{'定价', '828000000', '60', '荣安集团股份有限公司'}"
19,"{'广发证券资产管理(广东)有限公司', '4867364', '中融基金管理有限公司', '12', '定价', '159999981.2', '华鑫证券有限责任公司', '中国长城资产管理公司', '149999990.1', '青岛城投金融控股集团有限公司', '安徽中安资本投资基金有限公司', '7301046', '299999980.1', '9491362', '3650523', '常州产业投资集团有限公司', '3893891', '199999986.8', '390000064.6'}",12051543,4,"{'199999986.8', '390000064.6', '149999990.1', '159999981.2'}",8,"{'中融基金管理有限公司', '12', '定价', '中国长城资产管理公司', '青岛城投金融控股集团有限公司', '安徽中安资本投资基金有限公司', '常州产业投资集团有限公司', '华鑫证券有限责任公司'}",15,"{'广发证券资产管理(广东)有限公司', '4867364', '中融基金管理有限公司', '定价', '华鑫证券有限责任公司', '中国长城资产管理公司', '青岛城投金融控股集团有限公司', '安徽中安资本投资基金有限公司', '7301046', '299999980.1', '9491362', '3650523', '常州产业投资集团有限公司', '3893891', '12'}"
13,"{'现金', '北信瑞丰基金管理有限公司', '4708098', '100000000', '郭仁祥', '兴证资管鑫众—吉艾科技1号定向资产管理计划', '41431262', '竞价', '9416195', '50000000', '440000000', '南通元鼎投资有限公司', '36'}",1903742,2,"{'竞价', '440000000'}",5,"{'现金', '北信瑞丰基金管理有限公司', '郭仁祥', '南通元鼎投资有限公司', '36'}",11,"{'现金', '北信瑞丰基金管理有限公司', '4708098', '100000000', '郭仁祥', '兴证资管鑫众—吉艾科技1号定向资产管理计划', '41431262', '9416195', '50000000', '南通元鼎投资有限公司', '36'}"
6,"{'现金', '52910000', '竞价', '侯建芳', '36', '820000000'}",678666,4,"{'竞价', '52910000', '36', '820000000'}",2,"{'现金', '侯建芳'}",2,"{'现金', '侯建芳'}"
28,"{'262619995.4', '9.40557E+14', '440439982.7', '华泰资产管理有限公司', '西藏自治区投资有限公司', '10376222', '10526711', '江西洪都航空工业集团有限责任公司', '275799980.8', '293479986.7', '现金', '兴业全球基金管理有限公司', '定价', '38069949.24', '1432278', '10151241', '太平资产管理有限公司', '36', '269819985.8', '279799978.4', '中国航空科技工业股份有限公司', '9880361', '16570353', '华宝信托有限责任公司', '中海基金管理有限公司', '上海证券有限责任公司', '12', '11041384'}",1497964,5,"{'262619995.4', '9.40557E+14', '269819985.8', '279799978.4', '275799980.8'}",13,"{'36', '现金', '兴业全球基金管理有限公司', '定价', '华泰资产管理有限公司', '华宝信托有限责任公司', '西藏自治区投资有限公司', '江西洪都航空工业集团有限责任公司', '中国航空科技工业股份有限公司', '中海基金管理有限公司', '上海证券有限责任公司', '12', '太平资产管理有限公司'}",23,"{'440439982.7', '华泰资产管理有限公司', '西藏自治区投资有限公司', '10376222', '10526711', '江西洪都航空工业集团有限责任公司', '293479986.7', '现金', '兴业全球基金管理有限公司', '38069949.24', '定价', '1432278', '10151241', '太平资产管理有限公司', '36', '中国航空科技工业股份有限公司', '9880361', '16570353', '华宝信托有限责任公司', '中海基金管理有限公司', '上海证券有限责任公司', '12', '11041384'}"
5,"{'现金', '湖北鼎铭投资有限公司', '竞价', '36', '宜昌兴发集团有限责任公司'}",2370497,1,{'竞价'},4,"{'湖北鼎铭投资有限公司', '现金', '36', '宜昌兴发集团有限责任公司'}",4,"{'湖北鼎铭投资有限公司', '现金', '36', '宜昌兴发集团有限责任公司'}"
5,"{'定价', '资产', '南一农集团', '36', '227008007'}",211652,0,set(),4,"{'定价', '资产', '南一农集团', '36'}",5,"{'定价', '资产', '南一农集团', '36', '227008007'}"
4,"{'巨杉(上海)资产管理有限公司', '深圳中植产投科技投资合伙企业(有限合伙)', '8577556', '2144388'}",2250713,1,{'2144388'},0,set(),3,"{'巨杉(上海)资产管理有限公司', '深圳中植产投科技投资合伙企业(有限合伙)', '8577556'}"
14,"{'12000000', '499200000', '5000000', '4038161', '166400000', '15000000', '上海昊益实业有限公司', '雅戈尔集团股份有限公司', '134389998.1', '深圳市平安创新资本投资有限公司', '中国人寿资产管理有限公司', '信达澳银基金管理有限公司', '399360000', '12'}",1505794,1,{'134389998.1'},6,"{'12', '上海昊益实业有限公司', '雅戈尔集团股份有限公司', '中国人寿资产管理有限公司', '信达澳银基金管理有限公司', '深圳市平安创新资本投资有限公司'}",13,"{'12000000', '499200000', '5000000', '4038161', '166400000', '15000000', '上海昊益实业有限公司', '雅戈尔集团股份有限公司', '深圳市平安创新资本投资有限公司', '中国人寿资产管理有限公司', '信达澳银基金管理有限公司', '399360000', '12'}"
27,"{'106045000', '浙江天堂硅谷久盈股权投资合伙企业', '4150000', '58457503.1', '5334', '35297491', '兴业全球基金管理有限公司', '中广核财务有限责任公司', '竞价', '8300000', '绍兴市旅游集团有限公司', '36', '52705000', '中邮创业基金管理有限公司', '兵工财务有限责任公司', '2779330', '8350000', '105410000', '中国建银投资有限责任公司', '4200000', '53340000', '65405000', '420', '4602953', '5150000', '上海浦东科技投资有限公司', '12'}",572547,10,"{'106045000', '52705000', '8350000', '105410000', '4602953', '5150000', '58457503.1', '53340000', '65405000', '35297491'}",5,"{'兵工财务有限责任公司', '12', '竞价', '绍兴市旅游集团有限公司', '36'}",17,"{'36', '兴业全球基金管理有限公司', '中邮创业基金管理有限公司', '兵工财务有限责任公司', '浙江天堂硅谷久盈股权投资合伙企业', '2779330', '4150000', '中广核财务有限责任公司', '中国建银投资有限责任公司', '竞价', '4200000', '5334', '8300000', '上海浦东科技投资有限公司', '绍兴市旅游集团有限公司', '12', '420'}"
5,"{'现金', '吴潮忠', '竞价', '80000000', '36'}",852542,1,{'80000000'},4,"{'吴潮忠', '竞价', '现金', '36'}",4,"{'吴潮忠', '竞价', '现金', '36'}"
22,"{'7000000', '6000000', '8000000', '15942619', '现金', '新华人寿保险股份有限公司', '34796318', '中国航空技术进出口深圳公司', '竞价', '深圳中航集团股份有限公司', '信达澳银基金管理有限公司', '斯坦福大学', '2500000', '36', '深圳中航地产公司', '5261063', '中国太平洋人寿保险股份有限公司', '大成基金管理有限公司', '2000000', '上海励诚投资发展有限公司', '1495000', '12'}",820387,4,"{'34796318', '5261063', '2500000', '1495000'}",8,"{'深圳中航地产公司', '现金', '中国太平洋人寿保险股份有限公司', '12', '中国航空技术进出口深圳公司', '竞价', '深圳中航集团股份有限公司', '36'}",18,"{'深圳中航地产公司', '现金', '6000000', '新华人寿保险股份有限公司', '中国太平洋人寿保险股份有限公司', '12', '15942619', '大成基金管理有限公司', '中国航空技术进出口深圳公司', '7000000', '2000000', '上海励诚投资发展有限公司', '竞价', '深圳中航集团股份有限公司', '信达澳银基金管理有限公司', '8000000', '斯坦福大学', '36'}"
5,"{'现金', '423728813', '银鸽集团', '1500000000', '36'}",85717,2,"{'423728813', '1500000000'}",3,"{'36', '银鸽集团', '现金'}",3,"{'现金', '银鸽集团', '36'}"
8,"{'20000000', '现金', '广发基金', '竞价', '中邮基金', '广发证券', '10000000', '12'}",1666650,3,"{'20000000', '竞价', '10000000'}",5,"{'现金', '广发基金', '中邮基金', '广发证券', '12'}",5,"{'现金', '广发基金', '中邮基金', '广发证券', '12'}"
16,"{'上海万融投资发展有限公司', '现金', '3200000', '4000000', '定价', '国华人寿保险股份有限公司', '900000', '华宝信托有限责任公司', '上海英博企业发展有限公司', '3000000', '安康(天津)股权投资基金合伙企业(有限合伙)', '季坚义', '上海天臻实业有限公司', '9900000', '12', '上海混沌投资有限公司'}",1500579,4,"{'9900000', '4000000', '3200000', '900000'}",3,"{'定价', '现金', '12'}",12,"{'上海万融投资发展有限公司', '现金', '国华人寿保险股份有限公司', '定价', '华宝信托有限责任公司', '上海英博企业发展有限公司', '3000000', '安康(天津)股权投资基金合伙企业(有限合伙)', '季坚义', '上海天臻实业有限公司', '12', '上海混沌投资有限公司'}"
20,"{'现金', '新华基金管理有限公司', '河北港口集团有限公司', '中国远洋运输(集团)总公司', '748440000', '12', '1209686795', '定价', '60', '77000000', '65000000', '65273684', '634460208.5', '国泰基金管理有限公司', '631800000', '124453374', '815308642', '7924800000', '深圳市招融投资控股有限公司', '36'}",11747,1,{'634460208.5'},9,"{'新华基金管理有限公司', '现金', '河北港口集团有限公司', '12', '60', '定价', '国泰基金管理有限公司', '深圳市招融投资控股有限公司', '36'}",19,"{'新华基金管理有限公司', '现金', '河北港口集团有限公司', '中国远洋运输(集团)总公司', '748440000', '12', '1209686795', '60', '77000000', '65000000', '631800000', '65273684', '定价', '国泰基金管理有限公司', '124453374', '815308642', '7924800000', '深圳市招融投资控股有限公司', '36'}"
4,"{'竞价', '现金', '36', '绵阳耀达投资有限公司'}",1115545,1,{'竞价'},3,"{'现金', '36', '绵阳耀达投资有限公司'}",3,"{'现金', '36', '绵阳耀达投资有限公司'}"
17,"{'5000000', '现金', '华安基金管理有限公司', '华夏基金管理有限公司', '12', '汇丰晋信基金管理有限公司', '博时基金管理有限公司', '500000', '宝钛集团有限公司', '广发基金管理有限公司', '3880000', '鹏华基金管理有限公司', '4820000', '1000000', '五矿投资发展有限责任公司', '5120000', '36'}",1522408,4,"{'4820000', '3880000', '5120000', '1000000'}",8,"{'现金', '华安基金管理有限公司', '华夏基金管理有限公司', '12', '宝钛集团有限公司', '广发基金管理有限公司', '鹏华基金管理有限公司', '36'}",13,"{'36', '5000000', '现金', '华安基金管理有限公司', '华夏基金管理有限公司', '汇丰晋信基金管理有限公司', '博时基金管理有限公司', '500000', '宝钛集团有限公司', '广发基金管理有限公司', '鹏华基金管理有限公司', '五矿投资发展有限责任公司', '12'}"
5,"{'债权、资产、现金', '212343400', '竞价', '湘电集团', '36'}",709105,2,"{'债权、资产、现金', '212343400'}",3,"{'湘电集团', '竞价', '36'}",3,"{'湘电集团', '竞价', '36'}"
6,"{'现金', '定价', '永华投资', '600384000', '47200000', '36'}",399797,2,"{'600384000', '47200000'}",4,"{'36', '定价', '现金', '永华投资'}",4,"{'36', '定价', '现金', '永华投资'}"
19,"{'1361285', '中华联合', '现金', '5172884', '同药集团', '99999996.1', '凯石价值10号证券投资基金', '范子雅', '定价', '408385', '190000029.3', '浙江商裕', '陈德康', '平安资产鑫享7号资产管理产品', '东丰药业', '49999998.05', '2722570', '36', '14999981.05'}",1812773,2,"{'49999998.05', '14999981.05'}",9,"{'中华联合', '现金', '同药集团', '定价', '浙江商裕', '陈德康', '东丰药业', '范子雅', '36'}",17,"{'1361285', '中华联合', '现金', '5172884', '同药集团', '99999996.1', '凯石价值10号证券投资基金', '定价', '408385', '190000029.3', '浙江商裕', '陈德康', '平安资产鑫享7号资产管理产品', '东丰药业', '范子雅', '2722570', '36'}"
14,"{'249999997.4', '5894848', '2850336', '东海基金管理有限责任公司', '财通基金管理有限公司', '易方达基金管理有限公司', '竞价', '13276686', '109999983', '5841741', '53671826.88', '12', '110999987.8', '重庆北斗投资中心(有限合伙)'}",1578135,3,"{'249999997.4', '竞价', '53671826.88'}",4,"{'东海基金管理有限责任公司', '易方达基金管理有限公司', '12', '财通基金管理有限公司'}",11,"{'5894848', '2850336', '东海基金管理有限责任公司', '财通基金管理有限公司', '易方达基金管理有限公司', '13276686', '109999983', '5841741', '12', '110999987.8', '重庆北斗投资中心(有限合伙)'}"
25,"{'27856736', '名正信融', '68561682', '灿翔实业', '28425241', '天晟泰合', '现金', '1206000000', '定价', '仰添投资', '19897669', '490000000', '150000000', '智度五云', '8527572', '450000000', '通映投资', '修敬资产', '骏丰投资', '25582717', '350000000', '德符投资', '500000000', '36', '成嘉投资'}",4943425,6,"{'490000000', '150000000', '1206000000', '450000000', '350000000', '500000000'}",13,"{'天晟泰合', '现金', '名正信融', '智度五云', '定价', '德符投资', '通映投资', '仰添投资', '修敬资产', '灿翔实业', '成嘉投资', '36', '骏丰投资'}",19,"{'27856736', '天晟泰合', '现金', '名正信融', '智度五云', '8527572', '定价', '德符投资', '68561682', '通映投资', '28425241', '修敬资产', '19897669', '灿翔实业', '仰添投资', '成嘉投资', '36', '骏丰投资', '25582717'}"
12,"{'长安平安富贵东方通资产管理计划', '朱曼', '830584', '黄永军', '6921373', '竞价', '兴全沈惠中特定客户资产管理计划', '2214840', '3599114', '36', '平安汇通星通资本定向投资4号资产管理计划', '9286433'}",9892468,6,"{'830584', '竞价', '2214840', '3599114', '6921373', '9286433'}",5,"{'长安平安富贵东方通资产管理计划', '朱曼', '黄永军', '兴全沈惠中特定客户资产管理计划', '36'}",6,"{'长安平安富贵东方通资产管理计划', '朱曼', '黄永军', '兴全沈惠中特定客户资产管理计划', '36', '平安汇通星通资本定向投资4号资产管理计划'}"
30,"{'北京顺鑫农业发展集团有限公司', '271349997.6', '建投投资有限责任公司', '14300000', '188760000', '国联安基金管理有限公司', '11266661', '184319995.2', '20556818', '现金', '新华基金管理有限公司', '299249992.8', '7575758', '13900000', '13963636', '36', '太平洋资产管理有限责任公司', '山东高速投资控股有限公司', '100000005.6', '183579990', '13909090', '148719925.2', '13907575', '183480000', '北京郁金香股权投资中心(有限合伙)', '鑫元基金管理有限公司', '22670454', '安信证券股份有限公司', '183599988', '12'}",581611,0,set(),11,"{'36', '太平洋资产管理有限责任公司', '北京顺鑫农业发展集团有限公司', '新华基金管理有限公司', '现金', '山东高速投资控股有限公司', '建投投资有限责任公司', '鑫元基金管理有限公司', '国联安基金管理有限公司', '安信证券股份有限公司', '12'}",30,"{'北京顺鑫农业发展集团有限公司', '271349997.6', '建投投资有限责任公司', '14300000', '188760000', '国联安基金管理有限公司', '11266661', '184319995.2', '20556818', '现金', '新华基金管理有限公司', '299249992.8', '7575758', '13900000', '13963636', '36', '太平洋资产管理有限责任公司', '山东高速投资控股有限公司', '100000005.6', '183579990', '13909090', '148719925.2', '13907575', '183480000', '北京郁金香股权投资中心(有限合伙)', '鑫元基金管理有限公司', '22670454', '安信证券股份有限公司', '183599988', '12'}"
20,"{'2310546', '现金', '李蔚', '30707159', '33543848', '6997742', '2321219', '93000000', '苏清香', '定价', '30848993', '1723100', '王小萍', '15048908', '狄爱玲', '2523992', '陈慧', '22900000', '200000000', '36'}",14670972,6,"{'30707159', '33543848', '93000000', '30848993', '22900000', '200000000'}",8,"{'李蔚', '现金', '苏清香', '定价', '王小萍', '陈慧', '狄爱玲', '36'}",14,"{'2310546', '现金', '李蔚', '2321219', '6997742', '苏清香', '定价', '1723100', '王小萍', '15048908', '狄爱玲', '2523992', '陈慧', '36'}"
15,"{'深圳平安大华汇通财富管理有限公司', '现金', '124260355', '514368400', '82840000', '兴业财富资产管理有限公司', '76090000', '华龙证券股份有限公司', '559998400', '839953896.6', '财通基金管理有限公司', '839999999.8', '竞价', '124253535', '12'}",2117449,0,set(),7,"{'深圳平安大华汇通财富管理有限公司', '现金', '兴业财富资产管理有限公司', '华龙证券股份有限公司', '财通基金管理有限公司', '竞价', '12'}",15,"{'深圳平安大华汇通财富管理有限公司', '现金', '124260355', '514368400', '82840000', '兴业财富资产管理有限公司', '76090000', '华龙证券股份有限公司', '559998400', '839953896.6', '财通基金管理有限公司', '839999999.8', '竞价', '124253535', '12'}"
5,"{'现金', '19751000', '158995550', '杭州制氧机集团有限公司', '36'}",784374,0,set(),3,"{'36', '现金', '杭州制氧机集团有限公司'}",5,"{'现金', '19751000', '158995550', '杭州制氧机集团有限公司', '36'}"
19,"{'87999995.04', '现金', '14184397', '山西吉昌投资有限公司', '7446808', '83999994.24', '华泰资产管理有限公司', '财通基金管理有限公司', '竞价', '79999993.44', '7092198', '富国基金管理有限公司', '21276595', '239999991.6', '159999998.2', '7801418', '厦门半导体投资集团有限公司', '12', '汇安基金管理有限责任公司'}",19163640,2,"{'159999998.2', '现金'}",8,"{'山西吉昌投资有限公司', '华泰资产管理有限公司', '财通基金管理有限公司', '竞价', '富国基金管理有限公司', '厦门半导体投资集团有限公司', '12', '汇安基金管理有限责任公司'}",17,"{'87999995.04', '山西吉昌投资有限公司', '14184397', '7446808', '83999994.24', '华泰资产管理有限公司', '财通基金管理有限公司', '21276595', '79999993.44', '7092198', '富国基金管理有限公司', '239999991.6', '竞价', '厦门半导体投资集团有限公司', '7801418', '12', '汇安基金管理有限责任公司'}"
18,"{'北京市海淀区国有资产投资经营有限公司', '20000000', '12000000', '现金', '北京海淀科技发展有限公司', '8000000', '485436', '北京中恒天达科技发展有限公司', '4000000', '定价', '1213592', '242718', '364077', '刘雷', '林科', '6000000', '728155', '36'}",358621,0,set(),8,"{'北京市海淀区国有资产投资经营有限公司', '北京海淀科技发展有限公司', '现金', '北京中恒天达科技发展有限公司', '定价', '刘雷', '林科', '36'}",18,"{'北京市海淀区国有资产投资经营有限公司', '20000000', '12000000', '现金', '北京海淀科技发展有限公司', '8000000', '485436', '北京中恒天达科技发展有限公司', '4000000', '定价', '1213592', '242718', '364077', '刘雷', '林科', '6000000', '728155', '36'}"
4,"{'竞价', '现金', '中恒汇志', '36'}",4918861,1,{'竞价'},3,"{'现金', '中恒汇志', '36'}",3,"{'现金', '中恒汇志', '36'}"
13,"{'孙海胜', '现金', '徐跃', '曹燕红', '宋皞', '定价', '朱春林', '昝圣达', '杨小军', '吉正坤', '周云中', '36', '南通产业控股集团有限公司'}",990381,0,set(),13,"{'孙海胜', '36', '现金', '徐跃', '曹燕红', '宋皞', '定价', '朱春林', '昝圣达', '杨小军', '吉正坤', '周云中', '南通产业控股集团有限公司'}",13,"{'孙海胜', '36', '现金', '徐跃', '宋皞', '定价', '朱春林', '昝圣达', '南通产业控股集团有限公司', '杨小军', '吉正坤', '周云中', '曹燕红'}"
14,"{'39997440', '南京瑞森投资管理合伙企业(有限合伙)', '天津硅谷天堂阳光股权投资基金合伙企业(有限合伙)', '现金', '泰豪集团有限公司', '9999360', '74995200', '定价', '中国海外控股集团有限公司', '99943200', '13325760', '299980800', '36', '新疆硅谷天堂嘉鸿股权投资合伙企业(有限合伙)'}",1689899,0,set(),7,"{'南京瑞森投资管理合伙企业(有限合伙)', '天津硅谷天堂阳光股权投资基金合伙企业(有限合伙)', '现金', '泰豪集团有限公司', '定价', '中国海外控股集团有限公司', '36'}",14,"{'39997440', '南京瑞森投资管理合伙企业(有限合伙)', '天津硅谷天堂阳光股权投资基金合伙企业(有限合伙)', '现金', '泰豪集团有限公司', '9999360', '74995200', '99943200', '中国海外控股集团有限公司', '定价', '13325760', '299980800', '36', '新疆硅谷天堂嘉鸿股权投资合伙企业(有限合伙)'}"
7,"{'现金', '16000000', '460000000', '西藏南江投资有限公司', '定价', '上海南江(集团)有限公司', '36'}",1813027,2,"{'460000000', '16000000'}",4,"{'定价', '西藏南江投资有限公司', '现金', '36'}",5,"{'现金', '西藏南江投资有限公司', '定价', '上海南江(集团)有限公司', '36'}"
17,"{'现金', '8869306', '4434654', '125412015.1', '长安基金管理有限公司', '上银瑞金资本管理有限公司', '2956437', '定价', '华福基金管理有限责任公司', '4434653', '250823973.7', '渤海证券股份有限公司', '125411986.8', '83608038.36', '华安未来资产管理(上海)有限公司', '12', '上银基金管理有限公司'}",1701264,1,{'250823973.7'},8,"{'现金', '长安基金管理有限公司', '上银瑞金资本管理有限公司', '定价', '华福基金管理有限责任公司', '渤海证券股份有限公司', '12', '上银基金管理有限公司'}",16,"{'8869306', '4434654', '125412015.1', '长安基金管理有限公司', '现金', '上银瑞金资本管理有限公司', '2956437', '定价', '华福基金管理有限责任公司', '4434653', '渤海证券股份有限公司', '125411986.8', '83608038.36', '华安未来资产管理(上海)有限公司', '12', '上银基金管理有限公司'}"
11,"{'19536100', '53724000', '融通基金管理有限公司', '天弘基金管理有限公司', '48840000', '竞价', '申万菱信基金管理有限公司', '399999600', '439999560', '12', '160000659'}",792473,0,set(),5,"{'融通基金管理有限公司', '天弘基金管理有限公司', '竞价', '申万菱信基金管理有限公司', '12'}",11,"{'19536100', '53724000', '融通基金管理有限公司', '天弘基金管理有限公司', '48840000', '竞价', '申万菱信基金管理有限公司', '399999600', '439999560', '12', '160000659'}"
9,"{'2300000', '8900000', '财通基金管理有限公司', '2000000', '4248000', '山东省国有资产投资控股有限公司', '新华信托股份有限公司', '12', '国联证券股份有限公司'}",1163681,3,"{'4248000', '山东省国有资产投资控股有限公司', '2300000'}",4,"{'国联证券股份有限公司', '新华信托股份有限公司', '12', '财通基金管理有限公司'}",6,"{'8900000', '财通基金管理有限公司', '2000000', '新华信托股份有限公司', '12', '国联证券股份有限公司'}"
13,"{'陈慕群', '天天向上龟龄集资管计划', '现金', '16000000', '涪商集团', '蒋仕波', '广誉远安宫清心资管计划', '7000000', '2000000', '竞价', '3000000', '平安富贵定坤丹资管计划', '36'}",583505,1,{'竞价'},8,"{'陈慕群', '天天向上龟龄集资管计划', '现金', '涪商集团', '蒋仕波', '广誉远安宫清心资管计划', '平安富贵定坤丹资管计划', '36'}",12,"{'陈慕群', '天天向上龟龄集资管计划', '现金', '16000000', '涪商集团', '蒋仕波', '广誉远安宫清心资管计划', '7000000', '2000000', '3000000', '平安富贵定坤丹资管计划', '36'}"
19,"{'1690000', '1560000', '尹卫泽', '单银木', '定价', '6630000', '王爱民', '刘安贵', '许荣根', '2548000', '张振勇', '7800000', '6500000', '寿林平', '2730000', '36400000', '郭立湘', '36', '陆拥军'}",1857103,0,set(),11,"{'尹卫泽', '单银木', '定价', '王爱民', '许荣根', '张振勇', '寿林平', '郭立湘', '刘安贵', '36', '陆拥军'}",19,"{'1690000', '1560000', '尹卫泽', '单银木', '6630000', '定价', '王爱民', '刘安贵', '许荣根', '2548000', '张振勇', '7800000', '6500000', '寿林平', '2730000', '36400000', '郭立湘', '36', '陆拥军'}"
5,"{'河南豫联能源集团有限责任公司', '现金', '1998080000', '448000000', '36'}",1252920,2,"{'1998080000', '448000000'}",3,"{'36', '河南豫联能源集团有限责任公司', '现金'}",3,"{'现金', '河南豫联能源集团有限责任公司', '36'}"
26,"{'20000000', '23210000', '湖北新海天投资有限公司', '泰达宏利基金管理有限公司', '长沙琛远财务咨询有限公司', '302263400', '现金', '193800000', '581400000', '定价', '财通基金管理有限公司', '中信证券股份有限公司设立的中信证券岳阳林纸员工持股计划1期定向资产管理计划', '30000000', '129200000', '36', '90000000', '60000000', '刘建国', '25000000', '国联证券股份有限公司', '387600000', '嘉实基金管理有限公司', '46790000', '山东省国有资产投资控股有限公司', '161500000', '149936600'}",1671087,15,"{'129200000', '20000000', '23210000', '302263400', '193800000', '581400000', '90000000', '387600000', '60000000', '25000000', '46790000', '30000000', '山东省国有资产投资控股有限公司', '161500000', '149936600'}",10,"{'现金', '定价', '财通基金管理有限公司', '嘉实基金管理有限公司', '刘建国', '湖北新海天投资有限公司', '长沙琛远财务咨询有限公司', '泰达宏利基金管理有限公司', '36', '国联证券股份有限公司'}",11,"{'36', '现金', '定价', '财通基金管理有限公司', '嘉实基金管理有限公司', '中信证券股份有限公司设立的中信证券岳阳林纸员工持股计划1期定向资产管理计划', '刘建国', '湖北新海天投资有限公司', '泰达宏利基金管理有限公司', '长沙琛远财务咨询有限公司', '国联证券股份有限公司'}"
4,"{'现金', '竞价', '盛晖投资', '36'}",167193,0,set(),4,"{'36', '竞价', '盛晖投资', '现金'}",4,"{'现金', '竞价', '盛晖投资', '36'}"
5,"{'6043463', '140902333', '张邻', '36', '西宁市国新投资控股有限公司'}",1504097,0,set(),3,"{'36', '西宁市国新投资控股有限公司', '张邻'}",5,"{'6043463', '140902333', '张邻', '36', '西宁市国新投资控股有限公司'}"
20,"{'金圆资本', '20000000', '5000000', '现金', '皓熙投资', '定价', '15000000', '南京高科', '2000000', '福建投资集团', '福建稀土集团', '50000000', '开源基金', '25000000', '10000000', '上海理顺投资', '3000000', '陈国鹰', '36', '柯希平'}",899554,4,"{'10000000', '3000000', '15000000', '25000000'}",12,"{'金圆资本', '皓熙投资', '现金', '定价', '南京高科', '福建投资集团', '福建稀土集团', '开源基金', '上海理顺投资', '陈国鹰', '36', '柯希平'}",16,"{'金圆资本', '20000000', '5000000', '现金', '皓熙投资', '定价', '南京高科', '2000000', '福建投资集团', '福建稀土集团', '50000000', '开源基金', '上海理顺投资', '陈国鹰', '36', '柯希平'}"
20,"{'王伟', '现金', '1092102', '910085', '王海晨', '340080002.4', '7489999.55', '定价', '90264297', '邢柏静', '深圳众志联高投资管理合伙企业(有限合伙)', '林蔚', '王正宇', '滕柏松', '北京华居天下网络技术有限公司', '袁鸿昌', '742875164.3', '8987999.46', '41321993', '36'}",447183,1,{'340080002.4'},11,"{'王伟', '现金', '王海晨', '定价', '邢柏静', '林蔚', '王正宇', '滕柏松', '北京华居天下网络技术有限公司', '袁鸿昌', '36'}",19,"{'王伟', '现金', '1092102', '910085', '王海晨', '7489999.55', '定价', '90264297', '邢柏静', '深圳众志联高投资管理合伙企业(有限合伙)', '林蔚', '王正宇', '滕柏松', '北京华居天下网络技术有限公司', '袁鸿昌', '742875164.3', '8987999.46', '41321993', '36'}"
21,"{'1199920000', '中意资产管理有限责任公司', '84800000', '799899500', '现金', '定价', '财通基金管理有限公司', '70670000', '信达澳银基金管理有限公司', '中信保诚基金管理有限公司', '北信瑞丰基金管理有限公司', '65990000', '933758500', '平安资产管理有限责任公司', '144170000', '1210391000', '2040005500', '85540000', '56530000', '999980500', '12'}",20286416,0,set(),9,"{'现金', '北信瑞丰基金管理有限公司', '中意资产管理有限责任公司', '定价', '平安资产管理有限责任公司', '财通基金管理有限公司', '信达澳银基金管理有限公司', '中信保诚基金管理有限公司', '12'}",21,"{'1199920000', '中意资产管理有限责任公司', '84800000', '799899500', '现金', '定价', '财通基金管理有限公司', '70670000', '信达澳银基金管理有限公司', '中信保诚基金管理有限公司', '北信瑞丰基金管理有限公司', '65990000', '933758500', '平安资产管理有限责任公司', '144170000', '1210391000', '2040005500', '85540000', '56530000', '999980500', '12'}"
18,"{'3177159590', '百度鹏寰', '585651537', '阿里创投', '中国人寿', '1024890190', '兴全基金', '京东三弘', '苏宁云商', '定价', '腾讯信达', '1610541728', '淮海方舟', '光启互联', '102489018', '732064421', '36', '633254734'}",16850046,0,set(),11,"{'百度鹏寰', '阿里创投', '中国人寿', '兴全基金', '京东三弘', '苏宁云商', '定价', '腾讯信达', '淮海方舟', '光启互联', '36'}",18,"{'3177159590', '百度鹏寰', '585651537', '阿里创投', '中国人寿', '1024890190', '兴全基金', '京东三弘', '苏宁云商', '定价', '腾讯信达', '1610541728', '淮海方舟', '光启互联', '102489018', '732064421', '36', '633254734'}"
6,"{'富邦人寿', '现金', '定价', '50000000', '前海基金', '36'}",100104,0,set(),5,"{'富邦人寿', '现金', '定价', '前海基金', '36'}",6,"{'富邦人寿', '现金', '定价', '50000000', '前海基金', '36'}"
22,"{'285132300', '1399999593', '现金', '钢钢网', '814663900', '定价', '广西新容', '韬蕴投资', '999999569', '599999545', '1000000060', '泰达宏利', '203666000', '203665900', '3999999749', '首钢基金', '407332000', '林芝福彤', '金鹰基金', '122199500', '36', '2000000120'}",1759549,12,"{'1399999593', '285132300', '1000000060', '814663900', '999999569', '203666000', '203665900', '3999999749', '407332000', '599999545', '122199500', '2000000120'}",10,"{'钢钢网', '现金', '韬蕴投资', '泰达宏利', '定价', '林芝福彤', '首钢基金', '金鹰基金', '广西新容', '36'}",10,"{'钢钢网', '现金', '韬蕴投资', '泰达宏利', '定价', '林芝福彤', '首钢基金', '金鹰基金', '广西新容', '36'}"
26,"{'20000000', '华泰资产管理有限公司', '139200000', '四川产业振兴发展投资基金有限公司', '现金', '兴业全球基金管理有限公司', '财通基金管理有限公司', '47200000', '东吴证券股份有限公司', '238360000', '59100003.55', '诺安基金管理有限公司', '国华人寿保险股份有限公司', '702960000', '52657425', '120695000', '617615000', '23900000', '265919996.3', '122300000', '234349997', '中国银河证券股份有限公司', '11702971', '46405940', '101000000', '12'}",1087977,2,"{'现金', '265919996.3'}",9,"{'四川产业振兴发展投资基金有限公司', '兴业全球基金管理有限公司', '诺安基金管理有限公司', '国华人寿保险股份有限公司', '财通基金管理有限公司', '华泰资产管理有限公司', '中国银河证券股份有限公司', '东吴证券股份有限公司', '12'}",24,"{'20000000', '华泰资产管理有限公司', '139200000', '四川产业振兴发展投资基金有限公司', '兴业全球基金管理有限公司', '财通基金管理有限公司', '47200000', '东吴证券股份有限公司', '238360000', '59100003.55', '诺安基金管理有限公司', '国华人寿保险股份有限公司', '702960000', '52657425', '120695000', '617615000', '23900000', '122300000', '234349997', '中国银河证券股份有限公司', '11702971', '46405940', '101000000', '12'}"
8,"{'现金', '25220264', '张曦', '庄丽', '7577092', '上海证券-国瓷1号定向资产管理计划', '36', '11013215'}",2131582,0,set(),4,"{'庄丽', '现金', '张曦', '36'}",8,"{'现金', '25220264', '张曦', '庄丽', '7577092', '上海证券-国瓷1号定向资产管理计划', '36', '11013215'}"
17,"{'中车金证投资有限公司', '15835340', '现金', '15835310', '北京市基础设施投资有限', '陈福泉', '北京巴士传媒股份有限公司', '江苏一带一路投资基金(有限合伙)', '11876480', '北京泰生鸿明投资中心(有限合伙)', '定价', '嘉实基金管理有限公司', '23752960', '7125890', '深圳安鹏资本创新有限公司', '安徽高新毅达皖江产业发展创业投资基金(有限合伙)', '36'}",4938192,8,"{'15835340', '江苏一带一路投资基金(有限合伙)', '11876480', '15835310', '北京泰生鸿明投资中心(有限合伙)', '23752960', '7125890', '安徽高新毅达皖江产业发展创业投资基金(有限合伙)'}",9,"{'中车金证投资有限公司', '北京巴士传媒股份有限公司', '现金', '北京市基础设施投资有限', '陈福泉', '定价', '嘉实基金管理有限公司', '深圳安鹏资本创新有限公司', '36'}",9,"{'中车金证投资有限公司', '北京巴士传媒股份有限公司', '现金', '北京市基础设施投资有限', '陈福泉', '定价', '嘉实基金管理有限公司', '深圳安鹏资本创新有限公司', '36'}"
5,"{'现金', '中智慧通', '竞价', '4514672', '36'}",296203,1,{'4514672'},4,"{'中智慧通', '竞价', '现金', '36'}",4,"{'中智慧通', '竞价', '现金', '36'}"
4,"{'竞价', '现金', '中国机电出口产品投资有限公司', '36'}",575943,1,{'竞价'},3,"{'现金', '中国机电出口产品投资有限公司', '36'}",3,"{'现金', '中国机电出口产品投资有限公司', '36'}"
5,"{'中国信达资产管理股份有限公司', '现金', '1900000000', '36', '353159851'}",1850453,1,{'1900000000'},3,"{'中国信达资产管理股份有限公司', '现金', '36'}",4,"{'中国信达资产管理股份有限公司', '现金', '36', '353159851'}"
4,"{'竞价', '现金', '鼎立控股集团', '36'}",496473,1,{'竞价'},3,"{'现金', '鼎立控股集团', '36'}",3,"{'现金', '鼎立控股集团', '36'}"
17,"{'357499999.6', '731120000', '372590000', '现金', '50853485', '56877667', '104000000', '湖南省轻工盐业集团有限责任公司', '53000000', '359999994.1', '国机财务有限责任公司', '51209103', '西部建元控股有限公司', '云南省城市建设投资有限公司', '无锡市新宝联投资有限公司', '12', '399849999'}",1318144,2,"{'357499999.6', '359999994.1'}",7,"{'现金', '湖南省轻工盐业集团有限责任公司', '国机财务有限责任公司', '西部建元控股有限公司', '云南省城市建设投资有限公司', '无锡市新宝联投资有限公司', '12'}",15,"{'731120000', '372590000', '50853485', '现金', '56877667', '104000000', '湖南省轻工盐业集团有限责任公司', '53000000', '国机财务有限责任公司', '51209103', '西部建元控股有限公司', '云南省城市建设投资有限公司', '无锡市新宝联投资有限公司', '12', '399849999'}"
13,"{'万胜实业', '贝尔高新', '现金', '150000000', '智胜高新', '250000000', '瑞安信息', '竞价', '27567397', '200000000', '20675548', '36', '34459246'}",16212947,4,"{'150000000', '竞价', '200000000', '250000000'}",6,"{'万胜实业', '现金', '智胜高新', '瑞安信息', '36', '贝尔高新'}",9,"{'万胜实业', '贝尔高新', '现金', '智胜高新', '瑞安信息', '27567397', '20675548', '36', '34459246'}"
20,"{'119999995.8', '金塔投资', '现金', '无锡金嘉源文旅投资有限公司', '26414662', '中意资产管理有限责任公司', '379999996.1', '12', '325999999.4', '124148911.4', '无锡圣邦地产投资有限公司', '69361702', '安信基金管理有限责任公司', '148936170', '天津鸿嘉置业发展有限公司', '80851063', '北京鸿盈瑞悦企业发展咨询中心(有限合伙)', '699999999', '36', '25531914'}",16313537,0,set(),9,"{'36', '金塔投资', '现金', '无锡金嘉源文旅投资有限公司', '中意资产管理有限责任公司', '无锡圣邦地产投资有限公司', '安信基金管理有限责任公司', '天津鸿嘉置业发展有限公司', '12'}",20,"{'119999995.8', '金塔投资', '26414662', '无锡金嘉源文旅投资有限公司', '现金', '中意资产管理有限责任公司', '379999996.1', '12', '325999999.4', '124148911.4', '无锡圣邦地产投资有限公司', '69361702', '安信基金管理有限责任公司', '148936170', '天津鸿嘉置业发展有限公司', '80851063', '北京鸿盈瑞悦企业发展咨询中心(有限合伙)', '699999999', '36', '25531914'}"
18,"{'戴小元', '现金', '上海证券有限责任公司', '蒋航飞', '江苏瑞华投资发展有限公司', '张丽霞', '93330000', '凌俊', '15000000', '凯桥(北京)投资管理有限公司', '82350000', '9000000', '17000000', '方正证券有限责任公司', '10000000', '54900000', '12', '49410000'}",71111,1,{'15000000'},4,"{'戴小元', '现金', '12', '江苏瑞华投资发展有限公司'}",17,"{'戴小元', '现金', '上海证券有限责任公司', '蒋航飞', '江苏瑞华投资发展有限公司', '张丽霞', '93330000', '凌俊', '凯桥(北京)投资管理有限公司', '82350000', '9000000', '17000000', '方正证券有限责任公司', '10000000', '54900000', '12', '49410000'}"
20,"{'深圳市投资控股有限公司', '149999997.6', '132479997.3', '10215053', '12', '中国人保资产管理股份有限公司', '10752700', '100000110', '37634408', '华宝信托有限责任公司', '2421495', '94999992.9', '常州投资集团有限公司', '22519903.5', '16129032', '浙江硅谷天堂鲲诚创业投资有限公司', '深圳市深超科技投资有限公司', '36', '349999994.4', '14245161'}",65914,0,set(),4,"{'深圳市投资控股有限公司', '深圳市深超科技投资有限公司', '12', '36'}",20,"{'深圳市投资控股有限公司', '149999997.6', '132479997.3', '10215053', '12', '中国人保资产管理股份有限公司', '10752700', '100000110', '37634408', '华宝信托有限责任公司', '2421495', '94999992.9', '常州投资集团有限公司', '22519903.5', '16129032', '浙江硅谷天堂鲲诚创业投资有限公司', '深圳市深超科技投资有限公司', '36', '349999994.4', '14245161'}"
24,"{'深圳平安大华汇通财富管理有限公司', '386000000', '申万菱信(上海)资产管理有限公司', '周雪钦', '200000000', '现金', '财通基金管理有限公司', '竞价', '300000000', '12440800', '220000000', '吴招娣', '22867300', '84000000', '东海基金管理有限责任公司', '赖宗阳', '4976300', '11848300', '17772500', '13033200', '浙江浙商证券资产管理有限公司', '210000000', '中国银河证券股份有限公司', '12'}",1841887,11,"{'386000000', '13033200', '210000000', '竞价', '12440800', '4976300', '11848300', '84000000', '220000000', '22867300', '17772500'}",4,"{'现金', '12', '财通基金管理有限公司', '浙江浙商证券资产管理有限公司'}",13,"{'深圳平安大华汇通财富管理有限公司', '现金', '浙江浙商证券资产管理有限公司', '申万菱信(上海)资产管理有限公司', '东海基金管理有限责任公司', '财通基金管理有限公司', '周雪钦', '中国银河证券股份有限公司', '300000000', '赖宗阳', '吴招娣', '200000000', '12'}"
14,"{'547919991.4', '25108695', '博时基金管理有限公司', '24565217', '542399991.4', '安徽安元投资基金有限公司', '华鑫证券有限责任公司', '竞价', '554399985.6', '财通基金管理有限公司', '1004880032', '12', '24815217', '45510871'}",9871285,4,"{'1004880032', '547919991.4', '竞价', '542399991.4'}",4,"{'安徽安元投资基金有限公司', '博时基金管理有限公司', '12', '财通基金管理有限公司'}",10,"{'25108695', '博时基金管理有限公司', '24565217', '财通基金管理有限公司', '安徽安元投资基金有限公司', '华鑫证券有限责任公司', '554399985.6', '12', '24815217', '45510871'}"
19,"{'太平洋资产管理有限责任公司', '现金', '142168674', '上海建工(集团)总公司', '浦银安盛基金管理有限公司', '12', '183132530', '144578315', '115662650', '国联安基金管理有限公司', '圆信永丰基金管理有限公司', '91566265', '财通基金管理有限公司', '12048192', '竞价', '汇添富基金管理有限公司', '36', '上海城投控股股份有限公司', '太平资产管理有限公司'}",318245,1,{'竞价'},11,"{'36', '太平洋资产管理有限责任公司', '现金', '圆信永丰基金管理有限公司', '浦银安盛基金管理有限公司', '上海城投控股股份有限公司', '国联安基金管理有限公司', '财通基金管理有限公司', '12', '汇添富基金管理有限公司', '太平资产管理有限公司'}",18,"{'太平洋资产管理有限责任公司', '现金', '142168674', '上海建工(集团)总公司', '浦银安盛基金管理有限公司', '12', '183132530', '144578315', '115662650', '国联安基金管理有限公司', '圆信永丰基金管理有限公司', '91566265', '财通基金管理有限公司', '12048192', '汇添富基金管理有限公司', '36', '上海城投控股股份有限公司', '太平资产管理有限公司'}"
4,"{'中化股份', '现金', '竞价', '36'}",1187195,0,set(),4,"{'中化股份', '现金', '竞价', '36'}",4,"{'中化股份', '现金', '竞价', '36'}"
21,"{'华安基金管理有限公司', '天津嘉泰投资合伙企业(有限合伙)', '浙信尊享(天津)投资管理中心(有限合伙)', '399998200', '上海六禾桃林投资中心(有限合伙)', '航天投资控股有限公司', '45484590', '45592705', '现金', '199966200', '299999998.9', '定价', '226780798.9', '上海闽宏创业投资合伙企业(有限合伙)', '60790000', '36', '30390000', '299288602.2', '34465167', '上海浦东科技投资有限公司', '12'}",160640,1,{'226780798.9'},7,"{'现金', '华安基金管理有限公司', '12', '定价', '上海浦东科技投资有限公司', '航天投资控股有限公司', '36'}",20,"{'现金', '华安基金管理有限公司', '天津嘉泰投资合伙企业(有限合伙)', '199966200', '299999998.9', '299288602.2', '399998200', '定价', '12', '34465167', '45592705', '上海六禾桃林投资中心(有限合伙)', '上海闽宏创业投资合伙企业(有限合伙)', '60790000', '浙信尊享(天津)投资管理中心(有限合伙)', '30390000', '上海浦东科技投资有限公司', '航天投资控股有限公司', '45484590', '36'}"
6,"{'现金', '定价', 'Art Garden', '物产国际', '36', '46552901'}",1076348,1,{'46552901'},5,"{'现金', '定价', 'Art Garden', '物产国际', '36'}",5,"{'现金', '定价', 'Art Garden', '物产国际', '36'}"
5,"{'牛奶有限公司', '现金', '竞价', '813100468', '36'}",1573016,1,{'竞价'},3,"{'现金', '牛奶有限公司', '36'}",4,"{'813100468', '牛奶有限公司', '现金', '36'}"
17,"{'5100000', '8500000', '兴证证券资产管理有限公司', '兵工财务有限责任公司', '2354054', '中广核财务有限责任公司', '财通基金管理有限公司', '国联安基金管理有限公司', '5400000', '信达澳银基金管理有限公司', '10100000', '9300000', '宝盈基金管理有限公司', '泰达宏利基金管理有限公司', '6000000', '7300000', '12'}",341504,4,"{'5400000', '2354054', '5100000', '7300000'}",1,{'12'},13,"{'8500000', '兴证证券资产管理有限公司', '兵工财务有限责任公司', '中广核财务有限责任公司', '财通基金管理有限公司', '国联安基金管理有限公司', '信达澳银基金管理有限公司', '10100000', '9300000', '宝盈基金管理有限公司', '泰达宏利基金管理有限公司', '6000000', '12'}"
10,"{'现金', '定价', '经怡实业', '49342100', '大新华投资公司', '汇银投资', '109649200', '76754300', '上海国际集团', '36'}",167351,0,set(),7,"{'现金', '定价', '经怡实业', '大新华投资公司', '汇银投资', '上海国际集团', '36'}",10,"{'现金', '定价', '经怡实业', '49342100', '大新华投资公司', '汇银投资', '109649200', '76754300', '上海国际集团', '36'}"
4,"{'同盛集团', '1764379518', '股权', '36'}",501643,0,set(),3,"{'同盛集团', '股权', '36'}",4,"{'同盛集团', '1764379518', '股权', '36'}"
4,"{'36', '现金', '128000000', '三环集团'}",1255461,0,set(),3,"{'现金', '36', '三环集团'}",4,"{'36', '现金', '128000000', '三环集团'}"
4,"{'40330000', '李旭亮', '现金', '36'}",444994,1,{'40330000'},3,"{'李旭亮', '现金', '36'}",3,"{'李旭亮', '现金', '36'}"
9,"{'现金', '定价', '工投产业基金', '61349693', '1000000000', '南天成长1号定向资产管理计划', '12269938', '200000000', '36'}",1934562,2,"{'61349693', '12269938'}",4,"{'定价', '现金', '工投产业基金', '36'}",7,"{'现金', '定价', '工投产业基金', '1000000000', '南天成长1号定向资产管理计划', '200000000', '36'}"
26,"{'北京北广传媒投资发展中心', '99999989.6', '上海东方明珠新媒体股份有限公司', '44008122', '13540961', '33852403', '现金', '金砖丝路投资(深圳)合伙企业(有限合伙)', '199999994', '定价', '6770480', '299999998.3', '中国电影股份有限公司', '新湖中宝股份有限公司', '149999999.2', '10155721', '40622884', '中信证券股份有限公司', '20311442', '江西省广播电视网络传输有限公司', '499999992.3', '北京广播公司', '599999996.7', '649999961.9', '中信建投证券股份有限公司', '36'}",1835912,3,"{'599999996.7', '149999999.2', '199999994'}",6,"{'现金', '北京北广传媒投资发展中心', '定价', '中信建投证券股份有限公司', '北京广播公司', '36'}",23,"{'北京北广传媒投资发展中心', '99999989.6', '上海东方明珠新媒体股份有限公司', '44008122', '13540961', '33852403', '现金', '金砖丝路投资(深圳)合伙企业(有限合伙)', '定价', '6770480', '299999998.3', '中国电影股份有限公司', '新湖中宝股份有限公司', '10155721', '40622884', '中信证券股份有限公司', '20311442', '江西省广播电视网络传输有限公司', '499999992.3', '北京广播公司', '649999961.9', '中信建投证券股份有限公司', '36'}"
10,"{'203549988.6', '周志聪', '567010644', '43053200', '4300000', '56631000', '15455580', '鄂武商2015年度员工持股计划', '前海开源定增9号资产管理计划', '36'}",2204764,0,set(),2,"{'周志聪', '36'}",10,"{'203549988.6', '周志聪', '567010644', '43053200', '4300000', '56631000', '15455580', '鄂武商2015年度员工持股计划', '前海开源定增9号资产管理计划', '36'}"
22,"{'海通证券股份有限公司', '50000000', '330300000', '187170000', '201850000', '上海泽熙增煦投资中心(有限合伙)', '183500000', '周海虹', '定价', '55000000', '平安大华基金管理有限公司', '南京瑞森投资管理合伙企业(有限合伙)', '209975380', '51000000', '90000000', '60000000', '陈海忠', '220200000', '邱继光', '57214000', '胡跃', '12'}",359972,0,set(),8,"{'平安大华基金管理有限公司', '周海虹', '定价', '邱继光', '海通证券股份有限公司', '陈海忠', '胡跃', '12'}",22,"{'海通证券股份有限公司', '50000000', '330300000', '187170000', '201850000', '上海泽熙增煦投资中心(有限合伙)', '183500000', '周海虹', '55000000', '定价', '平安大华基金管理有限公司', '南京瑞森投资管理合伙企业(有限合伙)', '209975380', '51000000', '90000000', '60000000', '陈海忠', '220200000', '邱继光', '57214000', '胡跃', '12'}"
17,"{'现金', '43565218', '双星集团', '350700000', '42959623', '10093167', '平安汇通金橙400', '平安汇通金橙410', '63748452', '345825000', '59050000', '513175000', '7335403', '81250000', '平安汇通金橙402', '36', '平安汇通金橙401'}",1872125,5,"{'350700000', '345825000', '59050000', '513175000', '81250000'}",3,"{'现金', '36', '双星集团'}",12,"{'现金', '43565218', '双星集团', '10093167', '42959623', '平安汇通金橙400', '平安汇通金橙410', '63748452', '7335403', '平安汇通金橙402', '36', '平安汇通金橙401'}"
17,"{'陈慕群', '天天向上龟龄集资管计划', '现金', '16000000', '56400000', '涪商集团', '蒋仕波', '广誉远安宫清心资管计划', '定价', '131600000', '7000000', '2000000', '3000000', '平安富贵定坤丹资管计划', '37600000', '36', '300800000'}",1715266,5,"{'56400000', '131600000', '2000000', '37600000', '300800000'}",9,"{'陈慕群', '天天向上龟龄集资管计划', '现金', '涪商集团', '蒋仕波', '广誉远安宫清心资管计划', '定价', '平安富贵定坤丹资管计划', '36'}",12,"{'陈慕群', '天天向上龟龄集资管计划', '现金', '16000000', '涪商集团', '蒋仕波', '广誉远安宫清心资管计划', '定价', '7000000', '3000000', '平安富贵定坤丹资管计划', '36'}"
12,"{'20000000', '现金', '185449500', '定价', '36150000', '102600000', '西宁经济技术开发区投资控股集团有限公司', '西宁城市投资管理有限公司', '51300000', '10000000', '青海四维信用担保有限公司', '36'}",574256,5,"{'185449500', '36150000', '102600000', '10000000', '51300000'}",6,"{'现金', '定价', '西宁经济技术开发区投资控股集团有限公司', '西宁城市投资管理有限公司', '青海四维信用担保有限公司', '36'}",7,"{'20000000', '现金', '定价', '西宁经济技术开发区投资控股集团有限公司', '西宁城市投资管理有限公司', '青海四维信用担保有限公司', '36'}"
4,"{'沈阳机床(集团)有限责任公司', '竞价', '现金', '36'}",573069,1,{'沈阳机床(集团)有限责任公司'},3,"{'竞价', '现金', '36'}",3,"{'竞价', '现金', '36'}"
11,"{'现金', '9778845', '华贸圣佑', '403017', '探索者创业', '10684000', '竞价', '聚盛万合', '259237200', '精一投资', '36'}",12064498,2,"{'竞价', '259237200'}",6,"{'36', '现金', '华贸圣佑', '聚盛万合', '精一投资', '探索者创业'}",9,"{'现金', '9778845', '华贸圣佑', '403017', '探索者创业', '10684000', '聚盛万合', '精一投资', '36'}"
17,"{'41916167', '现金', '羚锐集团', '叶强', '11616766', '24999991.85', '2994011', '定价', '96999996.1', '999996', '李进', '119760', '熊伟', '吴希振', '民族—羚锐小羚羊资产管理计划', '36', '349999994.5'}",2367344,2,"{'24999991.85', '349999994.5'}",9,"{'现金', '羚锐集团', '叶强', '定价', '熊伟', '李进', '吴希振', '民族—羚锐小羚羊资产管理计划', '36'}",15,"{'41916167', '现金', '羚锐集团', '叶强', '11616766', '2994011', '96999996.1', '定价', '999996', '李进', '119760', '熊伟', '吴希振', '民族—羚锐小羚羊资产管理计划', '36'}"
5,"{'中国华电集团公司', '现金', '定价', '597609561', '36'}",1295846,0,set(),4,"{'定价', '现金', '中国华电集团公司', '36'}",5,"{'中国华电集团公司', '现金', '定价', '597609561', '36'}"
22,"{'19800000', '青岛煜明投资中心(有限合伙)', '213840000', '73440000', '6000000', '张淑玲', '8400000', '108000000', '定价', '李广超', '财通基金管理有限公司', '宝盈基金管理有限公司', '10000000', '平安大华基金管理有限公司', '太平洋资产管理有限责任公司', '5500000', '59400000', '90720000', '117720000', '64800000', '10900000', '6800000'}",1034183,13,"{'108000000', '6800000', '117720000', '213840000', '5500000', '73440000', '64800000', '59400000', '6000000', '10000000', '10900000', '90720000', '8400000'}",5,"{'太平洋资产管理有限责任公司', '定价', '李广超', '宝盈基金管理有限公司', '张淑玲'}",9,"{'平安大华基金管理有限公司', '太平洋资产管理有限责任公司', '19800000', '李广超', '青岛煜明投资中心(有限合伙)', '定价', '财通基金管理有限公司', '宝盈基金管理有限公司', '张淑玲'}"
16,"{'现金', '瑞士银行(UBS AG)', '1588391', '12', '中国人保资产管理股份有限公司', '定价', '2186675', '中能源电力燃料有限公司', '7000000', '内蒙古博源投资集团有限公司', '比尔盖茨和梅琳达基金会( Bill& Melinda Gates Foundation)', '2100923', '10000000', '上海证大投资发展有限公司', '无锡市新宝联投资有限公司', '36'}",1406736,2,"{'比尔盖茨和梅琳达基金会( Bill& Melinda Gates Foundation)', '瑞士银行(UBS AG)'}",9,"{'现金', '12', '中国人保资产管理股份有限公司', '定价', '中能源电力燃料有限公司', '内蒙古博源投资集团有限公司', '上海证大投资发展有限公司', '无锡市新宝联投资有限公司', '36'}",14,"{'现金', '1588391', '12', '中国人保资产管理股份有限公司', '定价', '2186675', '中能源电力燃料有限公司', '7000000', '内蒙古博源投资集团有限公司', '2100923', '10000000', '上海证大投资发展有限公司', '无锡市新宝联投资有限公司', '36'}"
6,"{'现金', '635169600', '连云港港口集团有限公司', '定价', '203580000', '36'}",1044281,1,{'635169600'},4,"{'定价', '现金', '36', '连云港港口集团有限公司'}",5,"{'现金', '连云港港口集团有限公司', '定价', '203580000', '36'}"
6,"{'现金', '360500000', '定价', '湖南泓鑫控股有限公司', '50000000', '36'}",1143333,2,"{'50000000', '360500000'}",4,"{'定价', '湖南泓鑫控股有限公司', '现金', '36'}",4,"{'定价', '湖南泓鑫控股有限公司', '现金', '36'}"
4,"{'上海汽车工业(集团)总公司', '现金', '36', '上汽集团核心员工持股计划(由受托管理该计划的资管机构长江养老设立专项产品予以认购)'}",15663121,0,set(),2,"{'现金', '36'}",4,"{'上海汽车工业(集团)总公司', '上汽集团核心员工持股计划(由受托管理该计划的资管机构长江养老设立专项产品予以认购)', '现金', '36'}"
4,"{'武汉武商集团股份有限公司', '前海开源基金管理有限公司', '周志聪', '36'}",282581,0,set(),4,"{'武汉武商集团股份有限公司', '前海开源基金管理有限公司', '周志聪', '36'}",4,"{'武汉武商集团股份有限公司', '前海开源基金管理有限公司', '周志聪', '36'}"
5,"{'现金', '碱业集团', '竞价', '180000000', '36'}",1911505,1,{'180000000'},4,"{'竞价', '现金', '36', '碱业集团'}",4,"{'竞价', '现金', '36', '碱业集团'}"
16,"{'杭州和易股权投资管理合伙企业(有限合伙)', '5028495', '太平洋资产管理有限责任公司', '现金', '150000000', '兴证证券资产管理有限公司', '大成基金管理有限公司', '定价', '238000000', '3754609', '7978544', '6704660', '112000000', '200000000', '杭州润青股权投资管理合伙企业(有限合伙)', '36'}",1598009,4,"{'238000000', '150000000', '200000000', '112000000'}",6,"{'太平洋资产管理有限责任公司', '现金', '兴证证券资产管理有限公司', '大成基金管理有限公司', '定价', '36'}",12,"{'杭州和易股权投资管理合伙企业(有限合伙)', '太平洋资产管理有限责任公司', '现金', '兴证证券资产管理有限公司', '大成基金管理有限公司', '定价', '3754609', '7978544', '6704660', '5028495', '杭州润青股权投资管理合伙企业(有限合伙)', '36'}"
20,"{'149600000', '29920000', '6000000', '现金', '王健摄', '国金证券', '东证资管', '118096000', '李培祥', '52800000', '5370000', '竞价', '17000000', '涌金控股', '47256000', '祥禾泓安', '3400000', '郑海若', '13420000', '36'}",347653,11,"{'149600000', '13420000', '118096000', '52800000', '5370000', '竞价', '3400000', '17000000', '47256000', '6000000', '29920000'}",9,"{'王健摄', '现金', '国金证券', '李培祥', '东证资管', '涌金控股', '郑海若', '祥禾泓安', '36'}",9,"{'现金', '王健摄', '国金证券', '东证资管', '李培祥', '涌金控股', '郑海若', '祥禾泓安', '36'}"
7,"{'现金', '400000000', '100000000', '北京东方君盛投资管理有限公司', '定价', '吴琼瑛', '36'}",1819525,1,{'100000000'},5,"{'现金', '北京东方君盛投资管理有限公司', '定价', '吴琼瑛', '36'}",6,"{'现金', '400000000', '北京东方君盛投资管理有限公司', '定价', '吴琼瑛', '36'}"
23,"{'277399996.8', '140299994.8', '17069701', '现金', '116265015.3', '定价', '财通基金管理有限公司', '21337126', '149999995.8', '华泰柏瑞基金管理有限公司', '信诚基金管理有限公司', '16538409', '东海基金管理有限责任公司', '18492176', '深圳市瑞丰林投资管理中心(有限合伙)', '19957325', '119999998', '39459459', '第一创业证券股份有限公司', '九泰基金管理有限公司', '129999997.3', '民生通惠资产管理有限公司', '12'}",15645331,5,"{'277399996.8', '140299994.8', '116265015.3', '129999997.3', '149999995.8'}",10,"{'现金', '第一创业证券股份有限公司', '九泰基金管理有限公司', '信诚基金管理有限公司', '定价', '东海基金管理有限责任公司', '财通基金管理有限公司', '民生通惠资产管理有限公司', '12', '华泰柏瑞基金管理有限公司'}",18,"{'39459459', '现金', '第一创业证券股份有限公司', '九泰基金管理有限公司', '19957325', '信诚基金管理有限公司', '16538409', '定价', '119999998', '东海基金管理有限责任公司', '财通基金管理有限公司', '21337126', '18492176', '华泰柏瑞基金管理有限公司', '深圳市瑞丰林投资管理中心(有限合伙)', '民生通惠资产管理有限公司', '12', '17069701'}"
6,"{'127548800', '现金', '定价', '合纵科技第一期员工持股计划', '3680000', '36'}",1728456,2,"{'127548800', '3680000'}",4,"{'现金', '定价', '36', '合纵科技第一期员工持股计划'}",4,"{'现金', '定价', '36', '合纵科技第一期员工持股计划'}"
5,"{'财信地产', '现金', '133418043', '定价', '36'}",1772645,0,set(),4,"{'财信地产', '定价', '现金', '36'}",5,"{'财信地产', '现金', '133418043', '定价', '36'}"
23,"{'9983361', '广发乾和投资有限公司', '12479201', '太平洋证券股份有限公司', '119999999.2', '现金', '106999996.6', '109999996.3', '竞价', '鹏华基金管理有限公司', '9151414', '中国电子财务有限责任公司', '8901830', '15141430', '博时基金管理有限公司', '国泰基金管理有限公司', '181999988.6', '西南证券股份有限公司', '234999991', '19550748', '149999996', '13810318', '12'}",14322251,3,"{'234999991', '竞价', '109999996.3'}",9,"{'现金', '12', '博时基金管理有限公司', '广发乾和投资有限公司', '国泰基金管理有限公司', '鹏华基金管理有限公司', '中国电子财务有限责任公司', '西南证券股份有限公司', '太平洋证券股份有限公司'}",20,"{'太平洋证券股份有限公司', '119999999.2', '9983361', '现金', '106999996.6', '19550748', '博时基金管理有限公司', '西南证券股份有限公司', '广发乾和投资有限公司', '国泰基金管理有限公司', '181999988.6', '鹏华基金管理有限公司', '15141430', '9151414', '149999996', '13810318', '12479201', '中国电子财务有限责任公司', '12', '8901830'}"
21,"{'800000000', '舟山创投', '北京海厚泰', '现金', '400000000', '定价', '43525571', '国开金泰', '150000000', '900000000', '8161044', '48966267', '罗相斌', '许木林', '21762785', '100000000', '5440696', '苏州海厚泰', '36', '横琴远诚', '罗恒'}",1662931,5,"{'800000000', '150000000', '900000000', '100000000', '舟山创投'}",10,"{'现金', '罗相斌', '定价', '许木林', '国开金泰', '北京海厚泰', '苏州海厚泰', '36', '横琴远诚', '罗恒'}",16,"{'横琴远诚', '现金', '8161044', '48966267', '400000000', '罗相斌', '定价', '43525571', '许木林', '5440696', '北京海厚泰', '21762785', '苏州海厚泰', '36', '国开金泰', '罗恒'}"
15,"{'5000000', '上投摩根基金管理有限公司', '郑州宇通集团有限公司', '西部证券股份有限公司', '4000000', '定价', '普天东方通信集团有限公司', '广东宝丽华新能源股份有限公司', '上海南都集团有限公司', '2000000', '厦门永红集团有限公司', '红塔证券股份有限公司', '13', '1000000', '12'}",823365,0,set(),10,"{'上投摩根基金管理有限公司', '郑州宇通集团有限公司', '西部证券股份有限公司', '普天东方通信集团有限公司', '定价', '广东宝丽华新能源股份有限公司', '厦门永红集团有限公司', '上海南都集团有限公司', '13', '12'}",15,"{'5000000', '上投摩根基金管理有限公司', '郑州宇通集团有限公司', '西部证券股份有限公司', '4000000', '普天东方通信集团有限公司', '广东宝丽华新能源股份有限公司', '厦门永红集团有限公司', '上海南都集团有限公司', '2000000', '定价', '红塔证券股份有限公司', '13', '1000000', '12'}"
22,"{'2774663', '14000082.72', '现金', '12', '定价', '上海小村资产管理有限公司', '宝盈基金管理有限公司', '392379', '127999966.2', '5325112', '1681614', '189999996.2', '3587443', '富国基金管理有限公司', '深圳市江河资本管理有限公司', '138999967.5', '3895739', '上海财通资产管理有限公司', '59999987.52', '张德华', '98999975.84', '36'}",6545124,1,{'189999996.2'},9,"{'36', '现金', '宝盈基金管理有限公司', '上海财通资产管理有限公司', '上海小村资产管理有限公司', '张德华', '深圳市江河资本管理有限公司', '富国基金管理有限公司', '12'}",21,"{'2774663', '14000082.72', '现金', '12', '定价', '上海小村资产管理有限公司', '宝盈基金管理有限公司', '392379', '127999966.2', '5325112', '1681614', '3587443', '富国基金管理有限公司', '深圳市江河资本管理有限公司', '138999967.5', '3895739', '上海财通资产管理有限公司', '59999987.52', '张德华', '98999975.84', '36'}"
3,"{'美罗集团', '股权', '36'}",544311,1,{'36'},2,"{'美罗集团', '股权'}",2,"{'美罗集团', '股权'}"
16,"{'现金', '149999977.4', '西藏元泽', '海尔创投', '定价', '199999996.1', '陆永', '17182128', '49999983.75', '亚东复星', '22909507', '34364260', '5727375', '299999989.8', '东方创投', '36'}",4924047,1,{'49999983.75'},8,"{'现金', '西藏元泽', '海尔创投', '定价', '陆永', '亚东复星', '东方创投', '36'}",15,"{'现金', '149999977.4', '西藏元泽', '海尔创投', '定价', '199999996.1', '陆永', '17182128', '亚东复星', '22909507', '34364260', '5727375', '299999989.8', '东方创投', '36'}"
16,"{'8869306', '4434654', '125412015.1', '长安基金管理有限公司', '上银瑞金资本管理有限公司', '2956437', '定价', '华福基金管理有限责任公司', '4434653', '250823973.7', '渤海证券股份有限公司', '125411986.8', '83608038.36', '华安未来资产管理(上海)有限公司', '12', '上银基金管理有限公司'}",1701384,2,"{'83608038.36', '250823973.7'}",7,"{'长安基金管理有限公司', '上银瑞金资本管理有限公司', '定价', '华福基金管理有限责任公司', '渤海证券股份有限公司', '12', '上银基金管理有限公司'}",14,"{'8869306', '4434654', '125412015.1', '长安基金管理有限公司', '上银瑞金资本管理有限公司', '2956437', '定价', '华福基金管理有限责任公司', '4434653', '渤海证券股份有限公司', '125411986.8', '华安未来资产管理(上海)有限公司', '12', '上银基金管理有限公司'}"
21,"{'33101264', '11438607', '180729990.6', '现金', '22183543', '长城(天津)股权投资基金管理有限责任公司', '武汉东湖国隆股权投资基金管理有限公司', '12', '竞价', '鹏华基金管理有限公司', '522999971.2', '12658227', '350499979.4', '199999986.6', '华融瑞通股权投资管理有限公司', '南通金玖锐信投资管理有限公司', '安信基金管理有限责任公司', '372070060.4', '11455696', '180999996.8', '23548738'}",17402440,1,{'522999971.2'},8,"{'现金', '武汉东湖国隆股权投资基金管理有限公司', '南通金玖锐信投资管理有限公司', '竞价', '鹏华基金管理有限公司', '安信基金管理有限责任公司', '华融瑞通股权投资管理有限公司', '12'}",20,"{'12658227', '350499979.4', '现金', '22183543', '33101264', '180999996.8', '武汉东湖国隆股权投资基金管理有限公司', '11438607', '长城(天津)股权投资基金管理有限责任公司', '199999986.6', '372070060.4', '南通金玖锐信投资管理有限公司', '竞价', '鹏华基金管理有限公司', '安信基金管理有限责任公司', '华融瑞通股权投资管理有限公司', '11455696', '180729990.6', '12', '23548738'}"
5,"{'现金', '定价', '448717900', '淮南矿业', '36'}",399948,1,{'448717900'},4,"{'淮南矿业', '36', '定价', '现金'}",4,"{'淮南矿业', '现金', '定价', '36'}"
13,"{'金塔投资', '现金', '长春城发', '129477298', '华安基金', '北方水泥', '108482368', '定价', '吉林敖东', '109722935', '冀东水泥', '98576482', '36'}",330270,4,"{'109722935', '108482368', '98576482', '129477298'}",9,"{'金塔投资', '现金', '长春城发', '华安基金', '北方水泥', '定价', '吉林敖东', '冀东水泥', '36'}",9,"{'金塔投资', '现金', '长春城发', '华安基金', '北方水泥', '定价', '吉林敖东', '冀东水泥', '36'}"
19,"{'8500000', '8000000', '5000000', '江苏瑞华投资发展有限公司', '张传义', '4000000', '武汉创联经贸发展有限公司', '西藏自治区投资有限公司', '上海英博企业发展有限公司', '竞价', '富邦资产管理有限公司', '李绍君', '4366666', '上海大正投资有限公司', '绍兴龙凯实业投资有限公司', '南方基金管理有限公司', '6000000', '10000000', '12'}",1248937,3,"{'4000000', '4366666', '竞价'}",1,{'12'},16,"{'8500000', '8000000', '5000000', '江苏瑞华投资发展有限公司', '张传义', '武汉创联经贸发展有限公司', '西藏自治区投资有限公司', '上海英博企业发展有限公司', '李绍君', '富邦资产管理有限公司', '上海大正投资有限公司', '南方基金管理有限公司', '绍兴龙凯实业投资有限公司', '6000000', '10000000', '12'}"
24,"{'华安基金管理有限公司', '12690476', '262930', '11903571', '泰达宏利基金管理有限公司', '10714285', '现金', '定价', '财通基金管理有限公司', '13422619', '鹏华基金管理有限公司', '12095238', '10716000', '五矿资本控股有限公司', '鹏华资产管理(深圳)有限公司', '36', '湘电集团有限公司', '10759325', '上银基金管理有限公司', '40476190', '平安资产管理有限公司', '天弘基金管理有限公司', '11880000', '12'}",1560236,0,set(),12,"{'现金', '华安基金管理有限公司', '12', '定价', '财通基金管理有限公司', '天弘基金管理有限公司', '湘电集团有限公司', '鹏华基金管理有限公司', '泰达宏利基金管理有限公司', '五矿资本控股有限公司', '36', '上银基金管理有限公司'}",24,"{'华安基金管理有限公司', '12690476', '262930', '11903571', '泰达宏利基金管理有限公司', '10714285', '现金', '定价', '财通基金管理有限公司', '13422619', '鹏华基金管理有限公司', '12095238', '10716000', '五矿资本控股有限公司', '鹏华资产管理(深圳)有限公司', '36', '湘电集团有限公司', '10759325', '上银基金管理有限公司', '40476190', '平安资产管理有限公司', '天弘基金管理有限公司', '11880000', '12'}"
6,"{'现金', '4800000000', '定价', '294117647', '康得集团', '36'}",15300108,1,{'4800000000'},4,"{'定价', '现金', '36', '康得集团'}",5,"{'现金', '定价', '294117647', '康得集团', '36'}"
10,"{'中航航空电子系统有限责任公司', '汉中航空工业(集团)有限公司', '1379664', '定价', '123552235', '152675262', '59466640', '中国航空工业集团公司', '中国航空科技工业股份有限公司', '36'}",1495102,1,{'定价'},1,{'中国航空工业集团公司'},9,"{'中航航空电子系统有限责任公司', '汉中航空工业(集团)有限公司', '1379664', '123552235', '152675262', '59466640', '中国航空工业集团公司', '中国航空科技工业股份有限公司', '36'}"
9,"{'现金', '泰康资管', '中国人寿', '52401746', '定价', '39301310', '8733625', '安徽铁发', '36'}",15367035,3,"{'52401746', '39301310', '8733625'}",6,"{'现金', '泰康资管', '中国人寿', '定价', '安徽铁发', '36'}",6,"{'现金', '泰康资管', '中国人寿', '定价', '安徽铁发', '36'}"
16,"{'38252500', '36', '现金', '5350000', '14000000', '100100000', '15150000', '108322500', '上海证大投资管理有限公司', '长春燃气控股有限公司', '240240000', '竞价', '东北证券股份有限公司(资产管理)', '33600000', '12', '东海证券有限责任公司'}",138062,7,"{'38252500', '14000000', '108322500', '100100000', '竞价', '240240000', '5350000'}",5,"{'现金', '长春燃气控股有限公司', '上海证大投资管理有限公司', '12', '东海证券有限责任公司'}",9,"{'36', '现金', '12', '15150000', '长春燃气控股有限公司', '上海证大投资管理有限公司', '33600000', '东北证券股份有限公司(资产管理)', '东海证券有限责任公司'}"
19,"{'现金', '深圳富邦', '7183908', '麦田投资', '39511494', '深圳龙源', '64655172', '定价', '北京卓远', '北京开元', '北京力天', '长江万汇', '35919540', '21551724', '郭宏杰', '达孜和润', '25143678', '36', '深圳智为'}",1764396,0,set(),13,"{'现金', '麦田投资', '深圳龙源', '北京卓远', '长江万汇', '定价', '北京开元', '北京力天', '郭宏杰', '达孜和润', '深圳富邦', '36', '深圳智为'}",19,"{'现金', '深圳富邦', '7183908', '麦田投资', '39511494', '深圳龙源', '64655172', '定价', '北京卓远', '北京开元', '北京力天', '长江万汇', '35919540', '21551724', '郭宏杰', '达孜和润', '25143678', '36', '深圳智为'}"
4,"{'36', '竞价', '现金', '国贸控股'}",1105276,0,set(),4,"{'36', '竞价', '现金', '国贸控股'}",4,"{'36', '竞价', '现金', '国贸控股'}"
13,"{'李北铎', '现金', '朱春生', '4000000', '60', '60000000', '山东东方海洋集团有限公司', '车志远', '竞价', '2000000', '10000000', '北京盛德玖富投资管理有限公司', '24000000'}",1815802,3,"{'竞价', '山东东方海洋集团有限公司', '60000000'}",6,"{'李北铎', '现金', '朱春生', '60', '车志远', '北京盛德玖富投资管理有限公司'}",10,"{'李北铎', '现金', '朱春生', '4000000', '60', '2000000', '车志远', '10000000', '北京盛德玖富投资管理有限公司', '24000000'}"
12,"{'27280000', '金鹰基金管理有限公司', '浙江荣盛控股集团有限公司', '乔晓辉', '12', '华龙证券股份有限公司', '财通基金管理有限公司', '33760000', '27200000', '80000000', '华安未来资产管理(上海)有限公司', '36'}",1875203,0,set(),7,"{'金鹰基金管理有限公司', '浙江荣盛控股集团有限公司', '乔晓辉', '12', '华龙证券股份有限公司', '财通基金管理有限公司', '36'}",12,"{'27280000', '金鹰基金管理有限公司', '浙江荣盛控股集团有限公司', '乔晓辉', '12', '华龙证券股份有限公司', '财通基金管理有限公司', '33760000', '27200000', '80000000', '华安未来资产管理(上海)有限公司', '36'}"
4,"{'现金', '140515222', '36', '巨化集团'}",386886,0,set(),3,"{'现金', '36', '巨化集团'}",4,"{'现金', '140515222', '36', '巨化集团'}"
4,"{'36', '现金', '保利集团', '1200000000'}",1450736,1,{'1200000000'},3,"{'36', '现金', '保利集团'}",3,"{'36', '现金', '保利集团'}"
4,"{'竞价', '现金', '华联集团', '36'}",717413,1,{'竞价'},3,"{'现金', '华联集团', '36'}",3,"{'现金', '华联集团', '36'}"
13,"{'现金', '杭州逸博投资管理有限公司', '3620192', '定价', '赣州启源金川投资中心(有限合伙)', '7158654', '153999996.8', '金鹰瑞东穗通定增359号资产管理计划1', '150599987.2', '297800006.4', '12', '王钢', '3701923'}",15969831,0,set(),5,"{'现金', '定价', '王钢', '12', '杭州逸博投资管理有限公司'}",13,"{'现金', '杭州逸博投资管理有限公司', '3620192', '定价', '赣州启源金川投资中心(有限合伙)', '7158654', '153999996.8', '金鹰瑞东穗通定增359号资产管理计划1', '150599987.2', '297800006.4', '12', '王钢', '3701923'}"
10,"{'22514600', '现金', '118670585', '彭韬', '潘利斌', '23000000', '21000000', '姚芳媛', '36', '朱蓉娟'}",1119310,0,set(),6,"{'现金', '彭韬', '潘利斌', '姚芳媛', '36', '朱蓉娟'}",10,"{'22514600', '现金', '118670585', '彭韬', '潘利斌', '23000000', '21000000', '姚芳媛', '36', '朱蓉娟'}"
10,"{'现金', '上海综艺控股有限公司', '31446540', '常高新集团有限公司', '定价', '78616352', '昝圣达', '110062893', '杨廷栋', '36'}",1852465,0,set(),7,"{'现金', '上海综艺控股有限公司', '常高新集团有限公司', '定价', '昝圣达', '杨廷栋', '36'}",10,"{'现金', '上海综艺控股有限公司', '31446540', '常高新集团有限公司', '定价', '78616352', '昝圣达', '110062893', '杨廷栋', '36'}"
18,"{'2850877', '现金', '110810052', '171449980.8', '定价', '西南证券股份有限公司', '广发乾和投资有限公司', '7519736', '4385964', '华鑫证券有限责任公司', '金鹰基金管理有限', '安信基金管理有限责任公司', '广西铁路发展投资基金(有限合伙)', '鹏华基金管理有限公司', '64999995.6', '12', '99999979.2', '4860090'}",2375325,0,set(),3,"{'定价', '现金', '12'}",18,"{'2850877', '现金', '110810052', '171449980.8', '定价', '西南证券股份有限公司', '广发乾和投资有限公司', '7519736', '4385964', '华鑫证券有限责任公司', '金鹰基金管理有限', '安信基金管理有限责任公司', '广西铁路发展投资基金(有限合伙)', '鹏华基金管理有限公司', '64999995.6', '12', '99999979.2', '4860090'}"
5,"{'现金', '尤友岳', '竞价', '50000000', '36'}",1816111,1,{'竞价'},3,"{'尤友岳', '现金', '36'}",4,"{'尤友岳', '现金', '50000000', '36'}"
17,"{'平安大华基金管理有限公司', '5000000', '现金', '14439990.4', '上海纺织投资管理有限公司', '江苏鑫惠创业投资有限公司', '1223728', '49560000', '70800000', '4200000', '106200000', '6000000', '9000000', '上海六禾松林投资中心(有限合伙)', '12', '59000000', '东海证券有限责任公司'}",1230751,0,set(),2,"{'现金', '12'}",17,"{'平安大华基金管理有限公司', '5000000', '现金', '14439990.4', '上海纺织投资管理有限公司', '江苏鑫惠创业投资有限公司', '1223728', '49560000', '70800000', '4200000', '106200000', '6000000', '9000000', '上海六禾松林投资中心(有限合伙)', '12', '59000000', '东海证券有限责任公司'}"
31,"{'夏曙东', '申万菱信(上海)资产管理有限公司', '中信建投基金管理有限公司', '189999965.6', '7520746', '4927385', '太平洋证券股份有限公司', '5705399', '现金', '2593360', '兴业全球基金管理有限公司', '5446058', '财通基金管理有限公司', '建投华科投资股份有限公司', '竞价', '青岛城投金融控股集团有限公司', '220000185.4', '江苏新扬子造船有限公司', '五矿资本控股有限公司', '289999965.8', '平安大华基金管理有限公司', '209999996.5', '99999961.6', '36', '诺安基金管理有限公司', '东海基金管理有限责任公司', '泓德基金管理有限公司', '浙江浙商证券资产管理有限公司', '5705394', '219999992.6', '12'}",1841160,3,"{'289999965.8', '209999996.5', '竞价'}",4,"{'36', '夏曙东', '现金', '12'}",28,"{'夏曙东', '申万菱信(上海)资产管理有限公司', '中信建投基金管理有限公司', '189999965.6', '7520746', '4927385', '太平洋证券股份有限公司', '5705399', '现金', '2593360', '兴业全球基金管理有限公司', '5446058', '财通基金管理有限公司', '建投华科投资股份有限公司', '青岛城投金融控股集团有限公司', '220000185.4', '江苏新扬子造船有限公司', '五矿资本控股有限公司', '平安大华基金管理有限公司', '36', '99999961.6', '诺安基金管理有限公司', '东海基金管理有限责任公司', '泓德基金管理有限公司', '浙江浙商证券资产管理有限公司', '5705394', '219999992.6', '12'}"
15,"{'5000000', '现金', '江苏瑞华投资有限公司', '4000000', '苏州工业园区资产管理有限公司', '华清基业投资管理有限公司', '江苏新恒通投资集团有限公司', '3000000', '深圳市高通投资发展有限公司', '江苏开元国际集团轻工业品进出口股份有限公司', '上海聚劲投资有限公司', '东方科学仪器进出口集团有限公司', '12', '上海元福投资有限公司', '北京国金投资管理有限公司'}",823918,0,set(),2,"{'现金', '12'}",15,"{'5000000', '现金', '江苏瑞华投资有限公司', '4000000', '苏州工业园区资产管理有限公司', '华清基业投资管理有限公司', '江苏新恒通投资集团有限公司', '3000000', '深圳市高通投资发展有限公司', '江苏开元国际集团轻工业品进出口股份有限公司', '上海聚劲投资有限公司', '东方科学仪器进出口集团有限公司', '12', '上海元福投资有限公司', '北京国金投资管理有限公司'}"
5,"{'现金', '竞价', '王冠一', '200000000', '36'}",4949609,1,{'200000000'},4,"{'王冠一', '竞价', '现金', '36'}",4,"{'王冠一', '竞价', '现金', '36'}"
4,"{'36', '竞价', '181575634', '靖远煤业集团有限责任公司'}",719661,1,{'竞价'},2,"{'36', '靖远煤业集团有限责任公司'}",3,"{'36', '181575634', '靖远煤业集团有限责任公司'}"
5,"{'现金', '100000000', '竞价', '阮鸿献', '36'}",2173579,1,{'100000000'},4,"{'竞价', '现金', '36', '阮鸿献'}",4,"{'竞价', '现金', '36', '阮鸿献'}"
18,"{'20000000', '现金', '40000000', '太和先机', '琨正投资', '18000000', '汉鼎世纪', '和兆玖盛', '90000000', '盛钜投资', '22000000', '46000000', '岩泰投资', '玖璨投资', '子衿和达', '36', '45000000', '19000000'}",348450,0,set(),10,"{'36', '现金', '太和先机', '琨正投资', '汉鼎世纪', '和兆玖盛', '岩泰投资', '玖璨投资', '子衿和达', '盛钜投资'}",18,"{'20000000', '36', '现金', '40000000', '太和先机', '琨正投资', '18000000', '汉鼎世纪', '和兆玖盛', '90000000', '22000000', '46000000', '岩泰投资', '玖璨投资', '盛钜投资', '子衿和达', '45000000', '19000000'}"
22,"{'兵器财务有限责任公司', '酒泉钢铁(集团)有限责任公司', '硅谷天堂创业投资有限公司', '江西省江信国际集团有限公司', '129740000', '155368640', '123752000', '中国银河投资管理有限公司', '中船重工财务有限责任公司', '深圳天寅投资有限公司', '11000000', '109780000', '12400000', '15000000', '14896729', '北京新世界数字多媒体技术有限公司', '149700000', '148669355.4', '江苏瑞华投资发展有限公司', '13000000', '15568000', '12'}",124446,0,set(),4,"{'硅谷天堂创业投资有限公司', '中国银河投资管理有限公司', '12', '中船重工财务有限责任公司'}",22,"{'兵器财务有限责任公司', '酒泉钢铁(集团)有限责任公司', '硅谷天堂创业投资有限公司', '江西省江信国际集团有限公司', '129740000', '155368640', '123752000', '中国银河投资管理有限公司', '中船重工财务有限责任公司', '深圳天寅投资有限公司', '11000000', '109780000', '12400000', '15000000', '14896729', '北京新世界数字多媒体技术有限公司', '149700000', '148669355.4', '江苏瑞华投资发展有限公司', '13000000', '15568000', '12'}"
7,"{'现金', '定价', '远大创业投资有限公司', '芜湖经开区光电产业投资发展有限公司', '龙窝湖建设开发有限公司', '珠海德豪电器有限公司', '36'}",1241038,0,set(),7,"{'现金', '定价', '远大创业投资有限公司', '芜湖经开区光电产业投资发展有限公司', '龙窝湖建设开发有限公司', '珠海德豪电器有限公司', '36'}",7,"{'现金', '定价', '远大创业投资有限公司', '芜湖经开区光电产业投资发展有限公司', '龙窝湖建设开发有限公司', '珠海德豪电器有限公司', '36'}"
13,"{'英特布鲁国际( Interbrew Investment International Holding Limited)', '3769685', '171418888', '定价', '2927974098', '92109991.04', '38299999.6', '9065944', '广州国资发展控股有限公司', '“广州证券鲲鹏珠江啤酒1号”定向资产管理计划', '288186427', '1741615902', '“广州证券鲲鹏珠江啤酒2号”定向资产管理计划'}",1771881,1,{'英特布鲁国际( Interbrew Investment International Holding Limited)'},2,"{'广州国资发展控股有限公司', '定价'}",12,"{'3769685', '171418888', '定价', '2927974098', '92109991.04', '38299999.6', '9065944', '广州国资发展控股有限公司', '“广州证券鲲鹏珠江啤酒1号”定向资产管理计划', '288186427', '1741615902', '“广州证券鲲鹏珠江啤酒2号”定向资产管理计划'}"
6,"{'竞价', '股权、债权、现金', '1400000000', '316350000', '平高集团有限公司', '36'}",1169141,4,"{'竞价', '股权、债权、现金', '1400000000', '316350000'}",2,"{'平高集团有限公司', '36'}",2,"{'平高集团有限公司', '36'}"
27,"{'20000000', '华泰资产管理有限公司', '139200000', '四川产业振兴发展投资基金有限公司', '现金', '兴业全球基金管理有限公司', '财通基金管理有限公司', '47200000', '竞价', '东吴证券股份有限公司', '238360000', '59100003.55', '诺安基金管理有限公司', '国华人寿保险股份有限公司', '702960000', '52657425', '120695000', '617615000', '23900000', '265919996.3', '122300000', '234349997', '中国银河证券股份有限公司', '11702971', '46405940', '101000000', '12'}",1087985,2,"{'竞价', '265919996.3'}",2,"{'现金', '12'}",25,"{'20000000', '华泰资产管理有限公司', '139200000', '四川产业振兴发展投资基金有限公司', '现金', '兴业全球基金管理有限公司', '财通基金管理有限公司', '47200000', '东吴证券股份有限公司', '238360000', '59100003.55', '诺安基金管理有限公司', '国华人寿保险股份有限公司', '702960000', '52657425', '120695000', '617615000', '23900000', '122300000', '234349997', '中国银河证券股份有限公司', '11702971', '46405940', '101000000', '12'}"
15,"{'1346153846', '荣基国际', '192307692', '万成亚太', '38461539', '115384616', '12', '摯东投资', '江阴晟汇', '国星集团', '1615384615', '海澜国贸', '346153846', '海澜集团', '36'}",905524,0,set(),9,"{'36', '荣基国际', '万成亚太', '12', '江阴晟汇', '国星集团', '海澜国贸', '海澜集团', '摯东投资'}",15,"{'1346153846', '荣基国际', '192307692', '万成亚太', '38461539', '115384616', '12', '摯东投资', '江阴晟汇', '国星集团', '1615384615', '海澜国贸', '346153846', '海澜集团', '36'}"
14,"{'899999232', '659999232', '信诚基金管理有限公司', '定价', '537999360', '光大保德信资产管理有限公司', '42968700', '639998976', '申万菱信基金管理有限公司', '35026000', '泰达宏利基金管理有限公司', '41666600', '12', '58593700'}",9877989,4,"{'659999232', '639998976', '899999232', '537999360'}",6,"{'信诚基金管理有限公司', '定价', '光大保德信资产管理有限公司', '申万菱信基金管理有限公司', '泰达宏利基金管理有限公司', '12'}",10,"{'信诚基金管理有限公司', '定价', '光大保德信资产管理有限公司', '42968700', '35026000', '申万菱信基金管理有限公司', '泰达宏利基金管理有限公司', '41666600', '12', '58593700'}"
15,"{'580000000', '12695725', '846381', '现金', '24545069', '20000000', '周文', '定价', '国禹资管', '2115954', '池驰', '300000000', '50000000', '丁劲松', '36'}",4942680,4,"{'580000000', '20000000', '300000000', '50000000'}",7,"{'现金', '周文', '定价', '国禹资管', '池驰', '丁劲松', '36'}",11,"{'12695725', '846381', '现金', '24545069', '周文', '定价', '国禹资管', '2115954', '池驰', '丁劲松', '36'}"
6,"{'2869764833', '现金', '定价', '39459266454', '中国移动通信集团广东有限公司', '36'}",1501158,1,{'39459266454'},4,"{'定价', '现金', '中国移动通信集团广东有限公司', '36'}",5,"{'2869764833', '现金', '定价', '中国移动通信集团广东有限公司', '36'}"
8,"{'大通燃气员工持股计划', '现金', '李可珍', '竞价', '陈蓉章', '大通集团', '36', '李朝波'}",1635901,1,{'竞价'},7,"{'大通燃气员工持股计划', '现金', '李可珍', '李朝波', '大通集团', '36', '陈蓉章'}",7,"{'大通燃气员工持股计划', '现金', '李可珍', '陈蓉章', '大通集团', '36', '李朝波'}"
5,"{'现金', '100000000', '588000000', '富泰(上海)有限公司及/或其指定的关联方', '36'}",1150369,2,"{'100000000', '588000000'}",2,"{'现金', '36'}",3,"{'现金', '36', '富泰(上海)有限公司及/或其指定的关联方'}"
5,"{'吉林省能源交通总公司', '现金', '竞价', '36', '中国电能成套设备有限公司'}",4954304,1,{'竞价'},4,"{'吉林省能源交通总公司', '现金', '36', '中国电能成套设备有限公司'}",4,"{'吉林省能源交通总公司', '现金', '36', '中国电能成套设备有限公司'}"
5,"{'现金', '100000000', '华泰集团', '竞价', '36'}",9878406,1,{'100000000'},4,"{'华泰集团', '竞价', '现金', '36'}",4,"{'华泰集团', '竞价', '现金', '36'}"
6,"{'大同通晋', '张振发', '19800000', '定价', '6200000', '36'}",1535684,0,set(),4,"{'张振发', '36', '定价', '大同通晋'}",6,"{'大同通晋', '张振发', '19800000', '定价', '6200000', '36'}"
17,"{'平安大华基金管理有限公司', '招商财富资产管理有限公司', '北京中商荣盛贸易有限公司', '现金', '308880308', '3861017', '中国铁路工程总公司', '12', '南京安赐投资管理有限公司', '167696256', '兴业财富资产管理有限公司', '财通基金管理有限公司', '竞价', '137323037', '643500643', '36', '141570141'}",1702290,1,{'竞价'},5,"{'现金', '中国铁路工程总公司', '南京安赐投资管理有限公司', '12', '36'}",16,"{'平安大华基金管理有限公司', '招商财富资产管理有限公司', '北京中商荣盛贸易有限公司', '现金', '308880308', '3861017', '中国铁路工程总公司', '12', '南京安赐投资管理有限公司', '167696256', '兴业财富资产管理有限公司', '财通基金管理有限公司', '137323037', '643500643', '36', '141570141'}"
9,"{'529999983.9', '现金', '国寿安保基金管理有限公司', '689999990.5', '竞价', '37520391', '28820010', '建信基金管理有限责任公司', '12'}",19202024,2,"{'竞价', '689999990.5'}",4,"{'国寿安保基金管理有限公司', '建信基金管理有限责任公司', '现金', '12'}",7,"{'529999983.9', '现金', '国寿安保基金管理有限公司', '37520391', '28820010', '建信基金管理有限责任公司', '12'}"
25,"{'湖北省中小企业金融服务中心有限公司', '1056000000', '武汉地产开发投资集团有限公司', '东方证券股份有限公司', '299999990.4', '2112000000', '中信建投基金管理有限公司', '200000000', '28409090', '809999995.2', '3856101', '财通基金管理有限公司', '竞价', '湖北省鄂西生态文化旅游圈投资有限公司', '40720426.56', '39393900', '38636364', '中信证券股份有限公司', '富国基金管理有限公司', '408000003.8', '湖北省长江产业投资集团有限公司', '100000000', '415999584', '76704545', '12'}",10789484,0,set(),13,"{'湖北省长江产业投资集团有限公司', '湖北省中小企业金融服务中心有限公司', '100000000', '武汉地产开发投资集团有限公司', '东方证券股份有限公司', '财通基金管理有限公司', '中信建投基金管理有限公司', '竞价', '中信证券股份有限公司', '湖北省鄂西生态文化旅游圈投资有限公司', '富国基金管理有限公司', '200000000', '12'}",25,"{'湖北省中小企业金融服务中心有限公司', '1056000000', '武汉地产开发投资集团有限公司', '东方证券股份有限公司', '299999990.4', '2112000000', '中信建投基金管理有限公司', '200000000', '28409090', '809999995.2', '3856101', '财通基金管理有限公司', '竞价', '湖北省鄂西生态文化旅游圈投资有限公司', '40720426.56', '39393900', '38636364', '中信证券股份有限公司', '富国基金管理有限公司', '408000003.8', '湖北省长江产业投资集团有限公司', '100000000', '415999584', '76704545', '12'}"
12,"{'清华控股有限公司', '现金', '银瑞信基金管理有限公司', '紫光集团有限公司', '博时基金管理有限公司', '2000000000', '68681318', '500000000', '1500000000', '206043956', '36', '274725274'}",579357,1,{'2000000000'},6,"{'清华控股有限公司', '现金', '银瑞信基金管理有限公司', '紫光集团有限公司', '博时基金管理有限公司', '36'}",11,"{'清华控股有限公司', '现金', '银瑞信基金管理有限公司', '紫光集团有限公司', '博时基金管理有限公司', '68681318', '500000000', '1500000000', '206043956', '36', '274725274'}"
16,"{'现金', '赢盛通典', '华富基金-鸿盛14号资产管理计划', '39840600', '1000000000', '丰实云兰', '竞价', '56915200', '700000000', '天弘基金定增40号资产管理计划', '28457600', '500000000', '安鹏资本', '300000000', '17074600', '36'}",1838405,9,"{'39840600', '28457600', '56915200', '1000000000', '竞价', '700000000', '300000000', '500000000', '17074600'}",5,"{'现金', '赢盛通典', '安鹏资本', '丰实云兰', '36'}",7,"{'现金', '赢盛通典', '华富基金-鸿盛14号资产管理计划', '安鹏资本', '天弘基金定增40号资产管理计划', '丰实云兰', '36'}"
8,"{'现金', '华安基金管理有限公司', '20526315', '40350877', '19842808', '融通基金管理有限公司', '英大基金管理有限公司', '12'}",1055120,0,set(),2,"{'现金', '12'}",8,"{'现金', '华安基金管理有限公司', '20526315', '40350877', '19842808', '融通基金管理有限公司', '英大基金管理有限公司', '12'}"
17,"{'20000000', '36', '梁桐灿', '新华人寿保险股份有限公司', '1000000', '中国人保资产管理股份有限公司', '15000000', '易方达基金管理有限公司', '广发基金管理有限公司', '竞价', '11000000', '9000000', '南方基金管理有限公司', '荣盛控股股份有限公司', '10000000', '12', '高源'}",594361,3,"{'9000000', '15000000', '竞价'}",9,"{'梁桐灿', '新华人寿保险股份有限公司', '12', '易方达基金管理有限公司', '广发基金管理有限公司', '南方基金管理有限公司', '荣盛控股股份有限公司', '高源', '36'}",14,"{'20000000', '36', '梁桐灿', '新华人寿保险股份有限公司', '1000000', '中国人保资产管理股份有限公司', '易方达基金管理有限公司', '广发基金管理有限公司', '11000000', '南方基金管理有限公司', '荣盛控股股份有限公司', '10000000', '12', '高源'}"
21,"{'天津证大金龙股权投资基金合伙企业(有限合伙)', '6590000', '52800000', '4000000', '铜陵化学工业集团有限公司', '铜陵市工业投资控股有限公司', '山西信托有限责任公司', '3000000', '5000000', '现金', '46200000', '竞价', '86988000', '36', '66000000', '3500000', '39600000', '广州安州投资管理有限公司', '南亚军', '博弘数君(天津)股权投资基金合伙企业(有限合伙)', '12'}",1166871,7,"{'66000000', '52800000', '39600000', '46200000', '竞价', '山西信托有限责任公司', '86988000'}",5,"{'现金', '12', '铜陵化学工业集团有限公司', '铜陵市工业投资控股有限公司', '36'}",14,"{'5000000', '现金', '3500000', '天津证大金龙股权投资基金合伙企业(有限合伙)', '6590000', '12', '4000000', '铜陵化学工业集团有限公司', '铜陵市工业投资控股有限公司', '3000000', '广州安州投资管理有限公司', '博弘数君(天津)股权投资基金合伙企业(有限合伙)', '南亚军', '36'}"
16,"{'华龙证券有限责任公司', '工银瑞信基金管理有限公司', '7499090', '国信证券股份有限公司', '甘肃省国有资产投资集团有限公司', '7000000', '中国北方工业公司', '22000000', '11000000', '17000000', '北京阳光嘉瑞科技开发有限公司', '10000000', '12750455', '12', '孙慧', '东海证券有限责任公司'}",406187,0,set(),1,{'12'},16,"{'华龙证券有限责任公司', '工银瑞信基金管理有限公司', '7499090', '国信证券股份有限公司', '甘肃省国有资产投资集团有限公司', '7000000', '中国北方工业公司', '22000000', '11000000', '17000000', '北京阳光嘉瑞科技开发有限公司', '10000000', '12750455', '12', '孙慧', '东海证券有限责任公司'}"
13,"{'12000000', '150000000', '现金', '顾玉兔', '38000000', '施建刚', '定价', '15000000', '120000000', '380000000', '华昌化工', '周一峰', '36'}",212167,6,"{'12000000', '150000000', '38000000', '15000000', '120000000', '380000000'}",7,"{'顾玉兔', '现金', '施建刚', '定价', '华昌化工', '周一峰', '36'}",7,"{'现金', '顾玉兔', '施建刚', '定价', '华昌化工', '周一峰', '36'}"
21,"{'40798416', '28599464', '32653061', '29387755', '广东富氧基金管理有限公司', '广东恒健资本管理有限公司', '28693877', '现金', '财通基金管理有限公司', '竞价', '鹏华基金管理有限公司', '珠海华发集团有限公司', '华夏人寿保险股份有限公司', '28571428', '36', '国华人寿保险股份有限公司', '博时基金管理有限公司', '国泰基金管理有限公司', '29124571', '105600000', '12'}",1824563,1,{'竞价'},4,"{'36', '现金', '12', '珠海华发集团有限公司'}",20,"{'40798416', '28599464', '32653061', '现金', '28571428', '华夏人寿保险股份有限公司', '29387755', '12', '国华人寿保险股份有限公司', '博时基金管理有限公司', '广东富氧基金管理有限公司', '财通基金管理有限公司', '国泰基金管理有限公司', '29124571', '105600000', '广东恒健资本管理有限公司', '鹏华基金管理有限公司', '珠海华发集团有限公司', '28693877', '36'}"
4,"{'13625058', '吕钢', '290349986', '36'}",1876710,2,"{'13625058', '290349986'}",2,"{'吕钢', '36'}",2,"{'吕钢', '36'}"
3,"{'山钢集团', '竞价', '36'}",319019,0,set(),3,"{'山钢集团', '竞价', '36'}",3,"{'山钢集团', '竞价', '36'}"
15,"{'一汽集团', '太钢投资', '亚东投资', '315710981', '36081255', '180406275', '45101569', '198446903', '12', '定价', '中久资管', '宁波华翔', '天亿投资', '126284393', '36'}",918480,0,set(),9,"{'一汽集团', '36', '太钢投资', '亚东投资', '定价', '中久资管', '宁波华翔', '天亿投资', '12'}",15,"{'一汽集团', '太钢投资', '亚东投资', '315710981', '36081255', '180406275', '45101569', '198446903', '12', '定价', '中久资管', '宁波华翔', '天亿投资', '126284393', '36'}"
24,"{'12000000', '广州金骏资产管理有限公司', '4000000', '南方基金管理有限公司', '泉州市美加美仿瓷餐具有限公司', '5000000', '现金', '11000000', '揭东县永泰化工塑料有限公司', '德意志银行( QFII)', '30000000', '24000000', '2500000', '66000000', '博时基金管理有限公司', '15000000', '广州市粤丰创业投资有限公司', '富国基金管理有限公司', '无锡市宝联投资有限公司', '4500000', '2000000', '五矿集团财务有限公司', '27000000', '12'}",1523245,8,"{'66000000', '现金', '15000000', '11000000', '27000000', '德意志银行( QFII)', '24000000', '2500000'}",2,"{'泉州市美加美仿瓷餐具有限公司', '12'}",16,"{'12000000', '5000000', '广州金骏资产管理有限公司', '4500000', '4000000', '博时基金管理有限公司', '2000000', '五矿集团财务有限公司', '广州市粤丰创业投资有限公司', '揭东县永泰化工塑料有限公司', '富国基金管理有限公司', '南方基金管理有限公司', '泉州市美加美仿瓷餐具有限公司', '30000000', '12', '无锡市宝联投资有限公司'}"
4,"{'36', '竞价', '现金', '国贸控股'}",1662862,0,set(),4,"{'36', '竞价', '现金', '国贸控股'}",4,"{'36', '竞价', '现金', '国贸控股'}"
4,"{'竞价', '中粮集团', '36', '股权、现金'}",1142246,1,{'股权、现金'},3,"{'竞价', '中粮集团', '36'}",3,"{'竞价', '中粮集团', '36'}"
18,"{'金鹰基金管理有限公司', '181999997', '现金', '545999990.9', '12', '35725055', '37995824', '342246026.9', '金元顺安基金管理有限公司', '竞价', '18997912', '363999993.9', '建信基金管理有限公司', '浙江嘉化集团股份有限公司', '56993736', '华安未来资产管理(上海)有限公司', '36', '红塔红土基金管理有限公司'}",16377000,2,"{'181999997', '545999990.9'}",9,"{'36', '金鹰基金管理有限公司', '现金', '金元顺安基金管理有限公司', '竞价', '建信基金管理有限公司', '浙江嘉化集团股份有限公司', '12', '红塔红土基金管理有限公司'}",16,"{'金鹰基金管理有限公司', '现金', '12', '35725055', '37995824', '342246026.9', '金元顺安基金管理有限公司', '18997912', '建信基金管理有限公司', '363999993.9', '竞价', '浙江嘉化集团股份有限公司', '56993736', '华安未来资产管理(上海)有限公司', '36', '红塔红土基金管理有限公司'}"
28,"{'31087375', '159999999.2', '63398057', '277999899.5', '358000004.6', '现金', '53980563', '中融基金管理有限公司', '定价', '31067961', '财通基金管理有限公司', '东海证券股份有限公司', '鹏华基金管理有限公司', '69514564', '160099981.3', '36', '95400114.1', '北信瑞丰基金管理有限公司', '新兴际华集团有限公司', '252000000.9', '326499993.6', '银华基金管理股份有限公司', '安徽高新毅达皖江产业发展创业投资基金(有限合伙)', '18524294', '31067962', '160000004.3', '12', '48932039'}",15884698,5,"{'277999899.5', '252000000.9', '159999999.2', '326499993.6', '160099981.3'}",11,"{'36', '现金', '北信瑞丰基金管理有限公司', '中融基金管理有限公司', '银华基金管理股份有限公司', '新兴际华集团有限公司', '定价', '财通基金管理有限公司', '东海证券股份有限公司', '鹏华基金管理有限公司', '12'}",23,"{'31087375', '63398057', '358000004.6', '现金', '53980563', '中融基金管理有限公司', '定价', '31067961', '财通基金管理有限公司', '东海证券股份有限公司', '鹏华基金管理有限公司', '69514564', '36', '95400114.1', '北信瑞丰基金管理有限公司', '新兴际华集团有限公司', '银华基金管理股份有限公司', '安徽高新毅达皖江产业发展创业投资基金(有限合伙)', '18524294', '31067962', '160000004.3', '12', '48932039'}"
8,"{'现金', '架桥资本', '定价', '东灿贸易', '何晓玉', '36', '法尔胜泓昇', '华西集团'}",1730420,0,set(),8,"{'现金', '架桥资本', '定价', '东灿贸易', '何晓玉', '36', '法尔胜泓昇', '华西集团'}",8,"{'现金', '架桥资本', '定价', '东灿贸易', '何晓玉', '36', '法尔胜泓昇', '华西集团'}"
4,"{'大连美罗集团有限公司', '资产', '36', '38000000'}",549889,0,set(),3,"{'大连美罗集团有限公司', '资产', '36'}",4,"{'大连美罗集团有限公司', '资产', '36', '38000000'}"
9,"{'1006357', '7944915', '苏州市历史文化名城发展集团创业投资有限公司', '兴业财富资产管理有限公司', '新华基金管理股份有限公司', '财通基金管理有限公司', '竞价', '13241525', '渤海汇金证券资产管理有限公司'}",15663215,1,{'竞价'},0,set(),8,"{'1006357', '7944915', '苏州市历史文化名城发展集团创业投资有限公司', '兴业财富资产管理有限公司', '新华基金管理股份有限公司', '财通基金管理有限公司', '13241525', '渤海汇金证券资产管理有限公司'}"
5,"{'莆田国投', '现金', '福建电子信息投资', '2500000000', '36'}",2049931,1,{'2500000000'},4,"{'福建电子信息投资', '莆田国投', '现金', '36'}",4,"{'福建电子信息投资', '莆田国投', '现金', '36'}"
17,"{'12000000', '现金', '8000000', '新华基金管理有限公司', '百年化妆护理品有限公司', '新华人寿保险有限公司', '嘉实基金管理有限公司-全国社保基金五零四组合', '定价', '章小格', '华安证券有限责任公司', '7000000', '尤飞煌', '9000000', '中信证券股份有限公司', '10000000', '12', '中国东方资产管理公司'}",1503098,0,set(),11,"{'新华基金管理有限公司', '现金', '百年化妆护理品有限公司', '新华人寿保险有限公司', '华安证券有限责任公司', '章小格', '定价', '中信证券股份有限公司', '尤飞煌', '12', '中国东方资产管理公司'}",17,"{'12000000', '8000000', '新华基金管理有限公司', '现金', '百年化妆护理品有限公司', '新华人寿保险有限公司', '嘉实基金管理有限公司-全国社保基金五零四组合', '章小格', '华安证券有限责任公司', '定价', '7000000', '尤飞煌', '9000000', '中信证券股份有限公司', '10000000', '12', '中国东方资产管理公司'}"
6,"{'现金', '定价', '中国平安人寿保险股份有限公司', '50000000', '36', '1393500000'}",1406402,2,"{'50000000', '1393500000'}",4,"{'36', '定价', '现金', '中国平安人寿保险股份有限公司'}",4,"{'定价', '现金', '36', '中国平安人寿保险股份有限公司'}"
17,"{'胡惠康', '现金', '5555556', '长航联合', '厦门华鑫丰', '7407407', '当代文化', '13888889', '吕桧瑛', '134259259', '南方资本-当代东方定向增发专项资产管理计划', '50925926', '4629630', '先锋亚太', '9259259', '36', '厦门旭熙'}",735173,4,"{'13888889', '9259259', '134259259', '50925926'}",9,"{'胡惠康', '现金', '长航联合', '厦门华鑫丰', '当代文化', '吕桧瑛', '先锋亚太', '36', '厦门旭熙'}",13,"{'胡惠康', '现金', '5555556', '长航联合', '厦门华鑫丰', '7407407', '当代文化', '吕桧瑛', '南方资本-当代东方定向增发专项资产管理计划', '4629630', '先锋亚太', '36', '厦门旭熙'}"
17,"{'海南普林投资管理有限公司', '122700000', '现金', '北京安泰博讯投资咨询有限公司', '12', '4000000', '定价', '18000000', '41000000', '海南富可实业有限公司', '147240000', '15000000', '上海南戴湖企业发展有限公司', '335380000', '32720000', '新理益集团有限公司', '36'}",1382455,5,"{'122700000', '定价', '147240000', '335380000', '32720000'}",4,"{'36', '现金', '新理益集团有限公司', '12'}",12,"{'海南普林投资管理有限公司', '现金', '北京安泰博讯投资咨询有限公司', '12', '4000000', '18000000', '15000000', '海南富可实业有限公司', '41000000', '上海南戴湖企业发展有限公司', '新理益集团有限公司', '36'}"
10,"{'现金', '华安基金', '45413260', '80108991', '36330608', '齐鲁证券', '建信基金', '27247956', '白药控股', '36'}",228164,4,"{'27247956', '45413260', '80108991', '36330608'}",6,"{'现金', '华安基金', '齐鲁证券', '建信基金', '白药控股', '36'}",6,"{'现金', '华安基金', '齐鲁证券', '建信基金', '白药控股', '36'}"
25,"{'12000000', '高安良', '16000000', '7000000', '6500000', '5000000', '现金', '16530000', '竞价', '东海证券股份有限公司', '张怀斌', '南京瑞森投资管理合伙企业(有限合伙)', '36', '3096168', '国华人寿保险股份有限公司', '42800000', '136960000', '横店集团控股有限公司', '中国国际金融有限公司', '59920000', '55640000', '141496800', '26503198.08', '102720000', '12'}",361793,1,{'竞价'},3,"{'36', '现金', '12'}",24,"{'12000000', '高安良', '16000000', '7000000', '6500000', '5000000', '现金', '16530000', '东海证券股份有限公司', '张怀斌', '南京瑞森投资管理合伙企业(有限合伙)', '36', '3096168', '国华人寿保险股份有限公司', '42800000', '136960000', '横店集团控股有限公司', '中国国际金融有限公司', '59920000', '55640000', '141496800', '26503198.08', '102720000', '12'}"
6,"{'100000000', '邓建宇', '定价', '员工持股计划', '3899000', '36'}",15487509,0,set(),4,"{'邓建宇', '定价', '36', '员工持股计划'}",6,"{'100000000', '邓建宇', '定价', '员工持股计划', '3899000', '36'}"
13,"{'孔鑫明', '现金', '北京鑫达唯特投资管理中心(有限合伙)', '浙江硅谷天堂产业投资管理有限公司', '定价', '深圳市创东方长盈投资企业(有限合伙)', '上海晨灿投资中心(有限合伙)', '鹏华基金管理有限公司', '2820000', '杭州君达投资管理有限公司', '泰达宏利基金管理有限公司', '5640000', '36'}",1671937,1,{'5640000'},8,"{'孔鑫明', '现金', '浙江硅谷天堂产业投资管理有限公司', '定价', '鹏华基金管理有限公司', '杭州君达投资管理有限公司', '泰达宏利基金管理有限公司', '36'}",12,"{'孔鑫明', '现金', '北京鑫达唯特投资管理中心(有限合伙)', '浙江硅谷天堂产业投资管理有限公司', '定价', '深圳市创东方长盈投资企业(有限合伙)', '上海晨灿投资中心(有限合伙)', '鹏华基金管理有限公司', '2820000', '杭州君达投资管理有限公司', '泰达宏利基金管理有限公司', '36'}"
16,"{'浙江天堂硅谷盈丰股权投资合伙企业(有限合伙)', '现金', '安徽省投资集团有限责任公司', '中航鑫港担保有限公司', '江苏瑞华投资发展有限公司', '中融国际信托有限公司', '16000000', '江苏鑫惠创业投资有限公司', '定价', '15000000', '4000000', '中钢投资有限公司', '铜陵市工业投资控股有限公司', '10000000', '中海基金管理有限公司', '12'}",1498726,0,set(),11,"{'现金', '安徽省投资集团有限责任公司', '中航鑫港担保有限公司', '江苏瑞华投资发展有限公司', '中融国际信托有限公司', '江苏鑫惠创业投资有限公司', '定价', '中钢投资有限公司', '铜陵市工业投资控股有限公司', '中海基金管理有限公司', '12'}",16,"{'浙江天堂硅谷盈丰股权投资合伙企业(有限合伙)', '安徽省投资集团有限责任公司', '现金', '中航鑫港担保有限公司', '江苏瑞华投资发展有限公司', '中融国际信托有限公司', '16000000', '江苏鑫惠创业投资有限公司', '4000000', '15000000', '定价', '中钢投资有限公司', '铜陵市工业投资控股有限公司', '10000000', '中海基金管理有限公司', '12'}"
19,"{'平安大华基金管理有限公司', '现金', '第一创业证券股份有限公司', '5552470', '80499981.38', '159999975.5', '12', '8883952', '财通基金管理有限公司', '北京矿冶研究总院', '4469738', '竞价', '1081844', '19484010.44', '国投瑞银基金管理有限公司', '40015986.76', '36', '2221876', '99999984.7'}",1806916,1,{'竞价'},8,"{'平安大华基金管理有限公司', '现金', '第一创业证券股份有限公司', '12', '财通基金管理有限公司', '北京矿冶研究总院', '国投瑞银基金管理有限公司', '36'}",18,"{'平安大华基金管理有限公司', '现金', '第一创业证券股份有限公司', '5552470', '80499981.38', '159999975.5', '12', '8883952', '财通基金管理有限公司', '北京矿冶研究总院', '4469738', '1081844', '19484010.44', '国投瑞银基金管理有限公司', '40015986.76', '36', '2221876', '99999984.7'}"
5,"{'现金', '保利集团', '竞价', '1500000000', '36'}",1436372,1,{'1500000000'},4,"{'36', '竞价', '现金', '保利集团'}",4,"{'36', '竞价', '现金', '保利集团'}"
17,"{'平安大华基金管理有限公司', '现金', '16000000', '兴业全球基金管理有限公司', '华夏基金管理有限公司', '19200000', '13624691', '融通基金管理有限公司', '15700000', '长信基金管理有限公司', '竞价', '西藏瑞华投资发展有限公司', '泰达宏利基金管理有限公司', '华商基金管理有限公司', '28500000', '30000000', '12'}",412039,0,set(),17,"{'平安大华基金管理有限公司', '现金', '16000000', '兴业全球基金管理有限公司', '华夏基金管理有限公司', '19200000', '13624691', '融通基金管理有限公司', '15700000', '长信基金管理有限公司', '竞价', '西藏瑞华投资发展有限公司', '泰达宏利基金管理有限公司', '华商基金管理有限公司', '28500000', '30000000', '12'}",17,"{'平安大华基金管理有限公司', '现金', '16000000', '兴业全球基金管理有限公司', '华夏基金管理有限公司', '19200000', '13624691', '融通基金管理有限公司', '15700000', '长信基金管理有限公司', '竞价', '西藏瑞华投资发展有限公司', '泰达宏利基金管理有限公司', '华商基金管理有限公司', '28500000', '30000000', '12'}"
15,"{'天津和悦', '现金', '20839536', '4019053', '天津顺祺', '定价', '5180113', '天津善臻', '天津鸿勋', '4614468', '天津通明', '4048824', '8931230', '36', '天津康顺'}",309259,6,"{'20839536', '4019053', '5180113', '4614468', '4048824', '8931230'}",9,"{'天津和悦', '现金', '天津顺祺', '定价', '天津善臻', '天津鸿勋', '天津通明', '36', '天津康顺'}",9,"{'天津和悦', '现金', '天津顺祺', '定价', '天津善臻', '天津鸿勋', '天津通明', '36', '天津康顺'}"
9,"{'现金', '240000000', '320000000', '深圳金务股权投资中心', '64000000', '深圳金慧股权投资中心', '深圳金素资产管理中心', '48000000', '36'}",310078,4,"{'240000000', '320000000', '64000000', '48000000'}",5,"{'现金', '深圳金务股权投资中心', '深圳金慧股权投资中心', '深圳金素资产管理中心', '36'}",5,"{'现金', '深圳金务股权投资中心', '深圳金慧股权投资中心', '深圳金素资产管理中心', '36'}"
12,"{'14980975', '重庆福勤投资管理合伙企业(有限合伙)', '中国华电集团资本控股有限公司', '40000000', '55000000', '定价', '重庆富诚投资管理合伙企业(有限合伙)', '华宝信托有限责任公司', '广发基金管理有限公司', '华能资本服务有限公司', '深圳市平安创新资本投资有限公司', '12'}",173231,1,{'14980975'},7,"{'中国华电集团资本控股有限公司', '12', '定价', '华宝信托有限责任公司', '广发基金管理有限公司', '深圳市平安创新资本投资有限公司', '华能资本服务有限公司'}",11,"{'重庆福勤投资管理合伙企业(有限合伙)', '中国华电集团资本控股有限公司', '40000000', '55000000', '定价', '重庆富诚投资管理合伙企业(有限合伙)', '华宝信托有限责任公司', '广发基金管理有限公司', '华能资本服务有限公司', '深圳市平安创新资本投资有限公司', '12'}"
5,"{'现金', '竞价', '50000000', '杨晓涛', '36'}",447798,1,{'50000000'},4,"{'36', '竞价', '现金', '杨晓涛'}",4,"{'杨晓涛', '竞价', '现金', '36'}"
6,"{'177372636', '现金', '定价', '1626507072', '中电投集团', '36'}",1298068,1,{'1626507072'},4,"{'定价', '现金', '36', '中电投集团'}",5,"{'177372636', '现金', '定价', '中电投集团', '36'}"
15,"{'卓创众银', '宁波赛客', '赛伯乐集团', '350000000', '宁波赛特', '定价', '北京兴诚旺', '南京创毅', '170000000', '北京云诺', '33073930', '68093385', '745300000', '36', '145000000'}",2267369,3,"{'350000000', '170000000', '745300000'}",8,"{'卓创众银', '宁波赛客', '赛伯乐集团', '宁波赛特', '北京兴诚旺', '南京创毅', '北京云诺', '36'}",12,"{'卓创众银', '宁波赛客', '赛伯乐集团', '宁波赛特', '定价', '北京兴诚旺', '南京创毅', '北京云诺', '33073930', '68093385', '36', '145000000'}"
16,"{'96950000', '现金', '海恒公司', '12149122', '稳可信公司', '唐郡', '丰琪投资', '陈军', '林绍康', '76539473', '64633300', '14578947', '407190000', '77560000', '36', '18223684'}",14468614,8,"{'96950000', '12149122', '64633300', '14578947', '407190000', '77560000', '76539473', '18223684'}",8,"{'36', '稳可信公司', '现金', '丰琪投资', '林绍康', '海恒公司', '陈军', '唐郡'}",8,"{'稳可信公司', '现金', '唐郡', '丰琪投资', '林绍康', '海恒公司', '陈军', '36'}"
14,"{'12600000', '5000000', '朱敏剑', '12', '新疆远策恒益股权投资合伙企业(有限合伙)', '王东力', '竞价', '德华集团控股股份有限公司', '丁敏芳', '泰康资产管理有限责任公司', '6000000', '10000000', '8409890', '36'}",1221316,1,{'竞价'},6,"{'36', '朱敏剑', '王东力', '丁敏芳', '德华集团控股股份有限公司', '12'}",13,"{'12600000', '5000000', '朱敏剑', '12', '新疆远策恒益股权投资合伙企业(有限合伙)', '王东力', '德华集团控股股份有限公司', '丁敏芳', '泰康资产管理有限责任公司', '6000000', '10000000', '8409890', '36'}"
25,"{'新沃基金', '基石投资', '40089801', '200000000', '博时基金', '1250000000', '现金', '金牛投资', '9621552', '400000000', '定价', '李缜', '300000000', '11225144', '12828736', '毅达投资', '11866581', '370000000', '10583708', '6414368', '330000000', '350000000', '南方资本', '上汽投资', '36'}",15444380,14,"{'6414368', '9621552', '330000000', '400000000', '350000000', '11866581', '370000000', '300000000', '10583708', '40089801', '11225144', '12828736', '200000000', '1250000000'}",11,"{'现金', '金牛投资', '毅达投资', '定价', '新沃基金', '李缜', '基石投资', '南方资本', '上汽投资', '36', '博时基金'}",11,"{'现金', '金牛投资', '毅达投资', '定价', '新沃基金', '李缜', '基石投资', '南方资本', '上汽投资', '36', '博时基金'}"
4,"{'竞价', '现金', '36', '江苏旷达创业投资有限公司'}",1903227,0,set(),4,"{'竞价', '现金', '36', '江苏旷达创业投资有限公司'}",4,"{'竞价', '现金', '36', '江苏旷达创业投资有限公司'}"
31,"{'东莞市创裕实业发展有限公司', '70000000', '160000000', '50000000', '湖南省轻工盐业集团有限责任公司', '上海聚丰投资管理有限公司', '252800000', '现金', '400000000', '65000000', '定价', '125000000', '224000000', '常州投资集团有限公司', '208000000', '无锡市新宝联投资有限公司', '79000000', '36', '中融国际信托有限公司', '259200000', '60000000', '192000000', '绍兴县英维特投资有限公司', '深圳市国恒实业发展有限公司', '166400000', '101693750', '52000000', '325420000', '81000000', '上海竹千代投资有限公司', '12'}",1244646,10,"{'166400000', '160000000', '101693750', '224000000', '208000000', '325420000', '259200000', '79000000', '252800000', '192000000'}",6,"{'现金', '中融国际信托有限公司', '深圳市国恒实业发展有限公司', '12', '定价', '36'}",21,"{'东莞市创裕实业发展有限公司', '70000000', '50000000', '湖南省轻工盐业集团有限责任公司', '上海聚丰投资管理有限公司', '现金', '400000000', '65000000', '定价', '125000000', '常州投资集团有限公司', '无锡市新宝联投资有限公司', '36', '中融国际信托有限公司', '60000000', '绍兴县英维特投资有限公司', '深圳市国恒实业发展有限公司', '52000000', '81000000', '上海竹千代投资有限公司', '12'}"
13,"{'现金', '友邦华泰基金管理有限公司', '华安基金管理有限公司', '中国太平洋人寿保险股份有限公司', '12', '定价', '15000000', '天津海泰控股集团有限公司', '2892500', '天津滨海新城镇产业投资有限公司', '17000000', '10000000', '36'}",1348854,2,"{'15000000', '2892500'}",9,"{'36', '现金', '友邦华泰基金管理有限公司', '华安基金管理有限公司', '中国太平洋人寿保险股份有限公司', '定价', '天津海泰控股集团有限公司', '天津滨海新城镇产业投资有限公司', '12'}",11,"{'现金', '友邦华泰基金管理有限公司', '华安基金管理有限公司', '中国太平洋人寿保险股份有限公司', '12', '定价', '天津海泰控股集团有限公司', '天津滨海新城镇产业投资有限公司', '17000000', '10000000', '36'}"
6,"{'现金', '吉林名门电力实业集团公司', '5346767', '中邮创业基金管理有限公司', '1782256', '12'}",1363084,0,set(),4,"{'现金', '吉林名门电力实业集团公司', '12', '中邮创业基金管理有限公司'}",6,"{'现金', '吉林名门电力实业集团公司', '5346767', '中邮创业基金管理有限公司', '1782256', '12'}"
22,"{'28513238', '绿地地产集团有限公司', '上海建筑材料(集团)总公司', '华泰资产管理有限公司', '99999996.18', '50916496', '现金', '72027726.18', '竞价', '69999999.29', '20366598', '上海诚鼎二期股权投资基金合伙企业(有限合伙)', '14669598', '249999995.4', '36', '龚磊', '139999998.6', '中信证券股份有限公司', '367972280.6', '14256619', '12', '74943438'}",1038579,4,"{'139999998.6', '249999995.4', '竞价', '367972280.6'}",7,"{'龚磊', '现金', '绿地地产集团有限公司', '12', '华泰资产管理有限公司', '中信证券股份有限公司', '36'}",18,"{'50916496', '28513238', '龚磊', '现金', '绿地地产集团有限公司', '72027726.18', '12', '上海建筑材料(集团)总公司', '上海诚鼎二期股权投资基金合伙企业(有限合伙)', '华泰资产管理有限公司', '69999999.29', '中信证券股份有限公司', '99999996.18', '14256619', '20366598', '14669598', '36', '74943438'}"
7,"{'现金', '900000000', '401700000', '员工持股计划', '闽西兴杭', '竞价', '36'}",9425338,3,"{'竞价', '900000000', '401700000'}",4,"{'现金', '36', '员工持股计划', '闽西兴杭'}",4,"{'现金', '36', '员工持股计划', '闽西兴杭'}"
4,"{'竞价', '现金', '36', '煜明投资'}",232007,0,set(),4,"{'竞价', '现金', '36', '煜明投资'}",4,"{'竞价', '现金', '36', '煜明投资'}"
12,"{'杭州西子孚信科技有限公司', '5000000', '现金', '定价', '江西国际信托股份有限公司', '施宝忠', '天津凯石益盛股权投资基金合伙企业(有限合伙)', '浙江言信诚有限公司', '2550000', '7700000', '12', '赵辉'}",497316,1,{'2550000'},8,"{'杭州西子孚信科技有限公司', '现金', '定价', '江西国际信托股份有限公司', '施宝忠', '浙江言信诚有限公司', '12', '赵辉'}",11,"{'杭州西子孚信科技有限公司', '5000000', '现金', '定价', '江西国际信托股份有限公司', '施宝忠', '天津凯石益盛股权投资基金合伙企业(有限合伙)', '浙江言信诚有限公司', '7700000', '12', '赵辉'}"
16,"{'1406250', '现金', '蒋小三', '31250000', '唐笑波', '49375000', '李先桃', '18750000', '26718750', '6250000', '秦本军', '天堂硅谷合行', '吴军凡', '36', '37500000', '天堂硅谷奕新'}",1800440,7,"{'1406250', '31250000', '49375000', '6250000', '26718750', '18750000', '37500000'}",9,"{'现金', '蒋小三', '唐笑波', '李先桃', '秦本军', '天堂硅谷合行', '吴军凡', '36', '天堂硅谷奕新'}",9,"{'现金', '蒋小三', '唐笑波', '李先桃', '秦本军', '天堂硅谷合行', '吴军凡', '36', '天堂硅谷奕新'}"
4,"{'竞价', '现金', '华联集团', '36'}",679791,1,{'竞价'},3,"{'现金', '华联集团', '36'}",3,"{'现金', '华联集团', '36'}"
10,"{'现金', '林建伟', '林峻', '陶晓海', '6050761', '定价', '49933909', '143039990', '1180437608', '36'}",9897837,0,set(),6,"{'现金', '林建伟', '林峻', '陶晓海', '定价', '36'}",10,"{'现金', '林建伟', '林峻', '陶晓海', '6050761', '定价', '49933909', '143039990', '1180437608', '36'}"
19,"{'金鹰基金管理有限公司', '1020600000', '现金', '65044091', '410000000', '重庆科创嘉源投资合伙企业(有限合伙)', '72310405', '北京泰生鸿明投资中心(有限合伙)', '368800000', '厦门国贸资产管理有限公司', '深圳市弘源汇鑫股权投资企业(有限合伙)', '52910054', '300000000', '851000000', '150088185', '永诚财产保险股份有限公司', '180000000', '36', '深圳盛屯集团有限公司'}",2042469,8,"{'1020600000', '72310405', '368800000', '52910054', '300000000', '851000000', '150088185', '180000000'}",6,"{'金鹰基金管理有限公司', '现金', '厦门国贸资产管理有限公司', '永诚财产保险股份有限公司', '36', '深圳盛屯集团有限公司'}",11,"{'金鹰基金管理有限公司', '65044091', '现金', '重庆科创嘉源投资合伙企业(有限合伙)', '410000000', '北京泰生鸿明投资中心(有限合伙)', '厦门国贸资产管理有限公司', '深圳市弘源汇鑫股权投资企业(有限合伙)', '永诚财产保险股份有限公司', '36', '深圳盛屯集团有限公司'}"
12,"{'平安大华基金管理有限公司', '现金', '40000000', '华鑫国际信托有限公司', '172800000', '四川省水电投资经营集团有限公司', '15000000', '129600000', '64800000', '30000000', '12', '汪荣列'}",147447,3,"{'172800000', '129600000', '64800000'}",2,"{'现金', '12'}",9,"{'平安大华基金管理有限公司', '华鑫国际信托有限公司', '40000000', '现金', '四川省水电投资经营集团有限公司', '15000000', '30000000', '12', '汪荣列'}"
6,"{'中国信达资产管理股份有限公司', '现金', '定价', '1900000000', '36', '353159851'}",9877675,1,{'1900000000'},4,"{'定价', '中国信达资产管理股份有限公司', '现金', '36'}",5,"{'中国信达资产管理股份有限公司', '现金', '定价', '36', '353159851'}"
4,"{'竞价', '现金', '36', '精功集团'}",1392584,0,set(),3,"{'竞价', '现金', '精功集团'}",4,"{'竞价', '现金', '36', '精功集团'}"
17,"{'瑞丰林投资', '3940887', '现金', '9852216', '15763546', '7881772', '坤儒投资', '曹国熊', '西藏泓杉', '小村创投', '定价', '谢世煌', '1970443', '倪正东', '4926108', '瞩望投资', '36'}",1654090,6,"{'3940887', '9852216', '15763546', '7881772', '1970443', '4926108'}",11,"{'36', '瑞丰林投资', '现金', '坤儒投资', '曹国熊', '谢世煌', '小村创投', '定价', '倪正东', '瞩望投资', '西藏泓杉'}",11,"{'瑞丰林投资', '36', '现金', '坤儒投资', '曹国熊', '谢世煌', '小村创投', '定价', '倪正东', '瞩望投资', '西藏泓杉'}"
14,"{'66447609', '平安大华基金管理有限公司', '现金', '16317016', '兴证证券资产管理有限公司', '23776223', '12', '嘉实基金管理有限公司', '财通基金管理有限公司', '37200550', '上海交运(集团)公司', '安信证券股份有限公司', '36', '11188811'}",15397037,4,"{'66447609', '23776223', '16317016', '37200550'}",3,"{'36', '现金', '12'}",10,"{'平安大华基金管理有限公司', '36', '现金', '兴证证券资产管理有限公司', '嘉实基金管理有限公司', '财通基金管理有限公司', '上海交运(集团)公司', '安信证券股份有限公司', '12', '11188811'}"
4,"{'浙江大东南集团有限公司', '竞价', '现金', '36'}",206333,0,set(),4,"{'浙江大东南集团有限公司', '竞价', '现金', '36'}",4,"{'浙江大东南集团有限公司', '竞价', '现金', '36'}"
4,"{'竞价', '现金', '36', '电子信息集团'}",1134403,1,{'竞价'},3,"{'现金', '36', '电子信息集团'}",3,"{'现金', '36', '电子信息集团'}"
4,"{'竞价', '现金', '36', '金世旗'}",510126,0,set(),4,"{'竞价', '现金', '36', '金世旗'}",4,"{'竞价', '现金', '36', '金世旗'}"
21,"{'12184230', '共青城朴海投资管理合伙企业(有限合伙)', '朔明德投资有限公司', '5414230', '920910', '99946685.8', '现金', '4333694', '224920885.8', '竞价', '常州投资集团有限公司', '69856885.8', '1625135', '16999998.6', '29999992.1', '79999991.24', '3784230', '上海爱屋企业管理有限公司', '上海趵朴投资管理有限公司', '12', '汇安基金管理有限责任公司'}",19351860,1,{'竞价'},7,"{'现金', '上海爱屋企业管理有限公司', '朔明德投资有限公司', '上海趵朴投资管理有限公司', '常州投资集团有限公司', '12', '汇安基金管理有限责任公司'}",20,"{'1625135', '现金', '上海爱屋企业管理有限公司', '12184230', '16999998.6', '朔明德投资有限公司', '共青城朴海投资管理合伙企业(有限合伙)', '5414230', '99946685.8', '224920885.8', '汇安基金管理有限责任公司', '29999992.1', '上海趵朴投资管理有限公司', '920910', '常州投资集团有限公司', '4333694', '79999991.24', '69856885.8', '12', '3784230'}"
5,"{'现金', '60000000', '竞价', '滨州国资公司', '36'}",4942614,1,{'60000000'},4,"{'竞价', '现金', '滨州国资公司', '36'}",4,"{'竞价', '现金', '滨州国资公司', '36'}"
16,"{'53296146', '5000000', '现金', '1452320000', '299750000', '定价', '11000000', '136250000', '东营国际金融贸易港有限公司', '北京市东方银湖科技有限公司', '银湖资本投资管理有限公司', '817500000', '杭州里程股权投资合伙企业(有限合伙)', '万载县长欣咨询服务有限公司', '30000000', '36'}",1671761,8,"{'53296146', '5000000', '1452320000', '299750000', '11000000', '136250000', '817500000', '30000000'}",6,"{'现金', '定价', '东营国际金融贸易港有限公司', '北京市东方银湖科技有限公司', '银湖资本投资管理有限公司', '36'}",8,"{'现金', '定价', '东营国际金融贸易港有限公司', '北京市东方银湖科技有限公司', '银湖资本投资管理有限公司', '杭州里程股权投资合伙企业(有限合伙)', '万载县长欣咨询服务有限公司', '36'}"
8,"{'现金', '陈柏林', '281906', '海润和晶2号', '7688364', '海润九号', '36', '31009740'}",14139710,3,"{'7688364', '281906', '31009740'}",4,"{'现金', '陈柏林', '36', '海润九号'}",5,"{'现金', '陈柏林', '海润和晶2号', '海润九号', '36'}"
17,"{'蔺静', '5000000', '现金', '73800000', '国机财务有限责任公司', '890000', '无锡市德联投资有限公司', '10947000', '竞价', '深圳市海丰源投资股份有限公司', '周银翠', '61500000', '方正证券有限责任公司', '沈汉标', '6000000', '上海天誉投资有限公司', '12'}",1495641,4,"{'61500000', '竞价', '73800000', '10947000'}",10,"{'蔺静', '现金', '国机财务有限责任公司', '无锡市德联投资有限公司', '深圳市海丰源投资股份有限公司', '周银翠', '方正证券有限责任公司', '沈汉标', '上海天誉投资有限公司', '12'}",13,"{'蔺静', '5000000', '现金', '国机财务有限责任公司', '890000', '无锡市德联投资有限公司', '深圳市海丰源投资股份有限公司', '周银翠', '方正证券有限责任公司', '沈汉标', '6000000', '上海天誉投资有限公司', '12'}"
30,"{'127401582', '129949991.5', '7480537', '上海诚鼎德同股权投资基金有限公司', '广发基金管理有限公司', '广东恒健资本管理有限公司', '5841051', '97925712.76', '现金', '兴业全球基金管理有限公司', '12', '5629696', '财通基金管理有限公司', '224999974.4', '169284552.3', '竞价', '5661475', '江苏弘业股份有限公司', '132182984.1', '4327252', '太平洋资产管理有限责任公司', '民生加银基金管理有限公司', '9942553', '136115987.6', '5742377', '5629765', '128119179.3', '6014847', '127400020.5', '东兴证券股份有限公司'}",383610,4,"{'128119179.3', '127401582', '127400020.5', '224999974.4'}",12,"{'太平洋资产管理有限责任公司', '现金', '民生加银基金管理有限公司', '兴业全球基金管理有限公司', '12', '上海诚鼎德同股权投资基金有限公司', '财通基金管理有限公司', '广发基金管理有限公司', '竞价', '广东恒健资本管理有限公司', '江苏弘业股份有限公司', '东兴证券股份有限公司'}",26,"{'129949991.5', '7480537', '上海诚鼎德同股权投资基金有限公司', '广发基金管理有限公司', '广东恒健资本管理有限公司', '5841051', '97925712.76', '现金', '兴业全球基金管理有限公司', '12', '5629696', '财通基金管理有限公司', '169284552.3', '竞价', '5661475', '江苏弘业股份有限公司', '132182984.1', '4327252', '太平洋资产管理有限责任公司', '民生加银基金管理有限公司', '9942553', '136115987.6', '5742377', '5629765', '6014847', '东兴证券股份有限公司'}"
23,"{'100000', '12310000', '何晓生', '3817000', '周满意', '469872700', '竞价', '李良斌', '陈习良', '合力腾飞投资', '190000', '7252300', '徐培旺', '400000', '38170000', '肖柏影', '76340000', '许荣煌', '2000000', '1000000', '15268000', '36', '许群义'}",1576622,6,"{'76340000', '3817000', '469872700', '竞价', '38170000', '15268000'}",10,"{'36', '徐培旺', '许荣煌', '何晓生', '周满意', '李良斌', '陈习良', '合力腾飞投资', '肖柏影', '许群义'}",17,"{'肖柏影', '徐培旺', '190000', '许荣煌', '12310000', '100000', '何晓生', '周满意', '2000000', '400000', '7252300', '李良斌', '1000000', '合力腾飞投资', '陈习良', '36', '许群义'}"
10,"{'银华财富资本管理(北京)有限公司', '现金', '53929122', '定价', '国华人寿保险股份有限公司', '7704160', '重庆中新融鑫投资中心(有限合伙)', '15408321', '华安未来资产管理(上海)有限公司', '36'}",1872728,1,{'现金'},3,"{'定价', '国华人寿保险股份有限公司', '36'}",9,"{'银华财富资本管理(北京)有限公司', '53929122', '国华人寿保险股份有限公司', '定价', '7704160', '15408321', '重庆中新融鑫投资中心(有限合伙)', '华安未来资产管理(上海)有限公司', '36'}"
13,"{'蔡锦山', '现金', '960000000', '周荣来', '18018018', '竞价', '45519203', '380000000', '黄友荣', '茅智华', '李文彬', '洪清平', '36'}",1899330,3,"{'960000000', '竞价', '380000000'}",8,"{'蔡锦山', '现金', '洪清平', '周荣来', '黄友荣', '李文彬', '茅智华', '36'}",10,"{'蔡锦山', '现金', '周荣来', '18018018', '45519203', '黄友荣', '茅智华', '李文彬', '洪清平', '36'}"
20,"{'金鹰基金管理有限公司', '14262734', '现金', '山东省金融资产管理股份有限公司', '海富通基金管理有限公司', '256353052.8', '28418230', '上海丰煜投资有限公司', '14209115', '264999994.8', '794999984.3', '青岛国信资本投资有限公司', '13745472', '竞价', '深圳市红塔资产管理有限公司', '529999989.5', '265999989.1', '42627345', '12', '浙江浙银资本管理有限公司'}",15628512,3,"{'竞价', '264999994.8', '794999984.3'}",9,"{'金鹰基金管理有限公司', '现金', '上海丰煜投资有限公司', '青岛国信资本投资有限公司', '深圳市红塔资产管理有限公司', '海富通基金管理有限公司', '山东省金融资产管理股份有限公司', '12', '浙江浙银资本管理有限公司'}",17,"{'金鹰基金管理有限公司', '14262734', '现金', '山东省金融资产管理股份有限公司', '海富通基金管理有限公司', '256353052.8', '28418230', '上海丰煜投资有限公司', '14209115', '青岛国信资本投资有限公司', '13745472', '深圳市红塔资产管理有限公司', '529999989.5', '265999989.1', '42627345', '12', '浙江浙银资本管理有限公司'}"
18,"{'现金', '丰煜稳盈玖号', '1699999986', '23319082', '利得安盈定增1号', '郁金香资本', '3192720069', '定价', '66070734', '299999989.9', '124085506', '38865137', '599999979.9', '雁裕投资', '新世纪公司', '11659541', '999999975', '36'}",1858793,2,"{'1699999986', '599999979.9'}",7,"{'丰煜稳盈玖号', '现金', '郁金香资本', '定价', '雁裕投资', '新世纪公司', '36'}",16,"{'现金', '丰煜稳盈玖号', '23319082', '利得安盈定增1号', '郁金香资本', '3192720069', '299999989.9', '66070734', '定价', '124085506', '38865137', '雁裕投资', '新世纪公司', '11659541', '999999975', '36'}"
19,"{'6109230', '17558974', '161000000', '59010000', '国信证券股份有限公司', '6052307', '100000000', '14197438', '6338461', '申万菱信(上海)资产管理有限公司', '财通基金管理有限公司', '171200000', '61800000', '10256410', '东海基金管理有限责任公司', '马红燕', '长城证券有限责任公司', '12', '59565000'}",288914,8,"{'161000000', '17558974', '59010000', '100000000', '14197438', '171200000', '61800000', '59565000'}",1,{'12'},11,"{'6109230', '6052307', '国信证券股份有限公司', '6338461', '申万菱信(上海)资产管理有限公司', '财通基金管理有限公司', '10256410', '东海基金管理有限责任公司', '马红燕', '长城证券有限责任公司', '12'}"
4,"{'36', '现金', '永泰控股', '41908137'}",15594591,1,{'41908137'},3,"{'36', '现金', '永泰控股'}",3,"{'36', '现金', '永泰控股'}"
6,"{'251371800', '现金', '21540000', '定价', '杨林', '36'}",1836899,1,{'251371800'},4,"{'定价', '现金', '36', '杨林'}",5,"{'现金', '21540000', '定价', '杨林', '36'}"
6,"{'61394893', '现金', '上海荣闪投资中心(有限合伙)', '荣郅投资', '36', '1250000000'}",304345,2,"{'上海荣闪投资中心(有限合伙)', '1250000000'}",3,"{'荣郅投资', '现金', '36'}",4,"{'61394893', '现金', '荣郅投资', '36'}"
11,"{'5000000', '现金', '华夏基金管理有限公司', '新疆凯迪投资有限责任公司', '11000000', '竞价', '特变电工股份有限公司', '10017347', '10000000', '中海基金管理有限公司', '12'}",1401492,2,"{'11000000', '10000000'}",4,"{'特变电工股份有限公司', '竞价', '现金', '12'}",9,"{'5000000', '现金', '华夏基金管理有限公司', '新疆凯迪投资有限责任公司', '特变电工股份有限公司', '竞价', '10017347', '中海基金管理有限公司', '12'}"
6,"{'147012578', '定价', '郑州投资控股', '25943396', '富鼎电子', '36'}",9901796,0,set(),4,"{'定价', '36', '富鼎电子', '郑州投资控股'}",6,"{'147012578', '定价', '郑州投资控股', '25943396', '富鼎电子', '36'}"
15,"{'29579063', '九泰基金', '499999987.8', '泰康资管', '499999943.9', '1299999819', '11376564', '平安资管', '11376563', '竞价', '兴证资管', '799999962.9', '18202502', '36', '博时基金'}",1819773,7,"{'29579063', '499999943.9', '1299999819', '11376563', '竞价', '11376564', '18202502'}",6,"{'九泰基金', '泰康资管', '平安资管', '兴证资管', '36', '博时基金'}",8,"{'499999987.8', '九泰基金', '泰康资管', '平安资管', '兴证资管', '799999962.9', '36', '博时基金'}"
5,"{'现金', '195400000', '昝圣达', '1205618000', '36'}",63625,1,{'1205618000'},3,"{'昝圣达', '现金', '36'}",4,"{'昝圣达', '现金', '36', '195400000'}"
10,"{'现金', '王学堂系公司的关联自然人', '常以立', '张其宾', '谭瑞清', '许刚', '韩健华', '杨民乐', '36', '王霞'}",675966,0,set(),10,"{'36', '现金', '王学堂系公司的关联自然人', '常以立', '张其宾', '谭瑞清', '韩健华', '杨民乐', '许刚', '王霞'}",10,"{'36', '现金', '王学堂系公司的关联自然人', '常以立', '张其宾', '谭瑞清', '韩健华', '杨民乐', '许刚', '王霞'}"
3,"{'36', '现金', '中国电子'}",1385083,0,set(),3,"{'中国电子', '现金', '36'}",3,"{'36', '现金', '中国电子'}"
23,"{'5200126', '315713500', '169999979.7', '华安基金管理有限公司', '国联安基金管理有限公司', '申万宏源证券有限公司', '9250000', '5042546', '财通基金管理有限公司', '华融期货有限责任公司', '竞价', '28536756.26', '博时基金管理有限公司', '164999998', '221948779.9', '293502500', '9950000', '159999984.6', '6994919', '5357705', '天弘基金管理有限公司', '12', '899362'}",9898845,4,"{'221948779.9', '169999979.7', '164999998', '159999984.6'}",9,"{'华安基金管理有限公司', '博时基金管理有限公司', '国联安基金管理有限公司', '财通基金管理有限公司', '华融期货有限责任公司', '申万宏源证券有限公司', '天弘基金管理有限公司', '竞价', '12'}",19,"{'5200126', '315713500', '6994919', '5357705', '华安基金管理有限公司', '9950000', '博时基金管理有限公司', '国联安基金管理有限公司', '财通基金管理有限公司', '华融期货有限责任公司', '申万宏源证券有限公司', '天弘基金管理有限公司', '899362', '竞价', '28536756.26', '293502500', '9250000', '12', '5042546'}"
9,"{'现金', '百善仁', '定价', '中色科金', '福建电子信息集团', '26463700', '8313817', '5737705', '36'}",936679,3,"{'8313817', '26463700', '5737705'}",6,"{'现金', '百善仁', '定价', '中色科金', '福建电子信息集团', '36'}",6,"{'现金', '百善仁', '定价', '中色科金', '福建电子信息集团', '36'}"
14,"{'新疆天弘旗实业有限公司', '20000000', '133400000', '现金', '333500000', '定价', '70000000', '四川大耀实业有限责任公司', '杨林', '四川裕嘉阁酒店管理有限责任公司', '50000000', '广安神龙投资有限公司', '466900000', '36'}",2341178,3,"{'466900000', '133400000', '333500000'}",7,"{'新疆天弘旗实业有限公司', '现金', '定价', '四川大耀实业有限责任公司', '杨林', '广安神龙投资有限公司', '36'}",11,"{'新疆天弘旗实业有限公司', '20000000', '现金', '70000000', '定价', '四川大耀实业有限责任公司', '杨林', '四川裕嘉阁酒店管理有限责任公司', '50000000', '广安神龙投资有限公司', '36'}"
11,"{'现金', '深圳市国资委', '600000000', '李永明', '方东红', '400000', '竞价', '800000', '蒋灿明', '蓝思远', '36'}",1255850,4,"{'竞价', '800000', '400000', '600000000'}",7,"{'现金', '深圳市国资委', '李永明', '方东红', '蒋灿明', '蓝思远', '36'}",7,"{'现金', '深圳市国资委', '李永明', '方东红', '蒋灿明', '蓝思远', '36'}"
18,"{'20000000', '现金', '8000000', '201500000', '13000000', '定价', '招商基金管理有限公司', '宋睿', '博时基金管理有限公司', '155000000', '341000000', '22000000', '124000000', '光大永明资产管理股份有限公司', '10000000', '深圳市平安创新资本投资有限公司', '310000000', '36'}",298797,9,"{'201500000', '13000000', '155000000', '124000000', '341000000', '22000000', '10000000', '8000000', '310000000'}",8,"{'36', '现金', '博时基金管理有限公司', '招商基金管理有限公司', '宋睿', '定价', '光大永明资产管理股份有限公司', '深圳市平安创新资本投资有限公司'}",9,"{'20000000', '现金', '定价', '招商基金管理有限公司', '宋睿', '博时基金管理有限公司', '深圳市平安创新资本投资有限公司', '光大永明资产管理股份有限公司', '36'}"
5,"{'150000000', '现金', '60', '竞价', '北京华信六合投资有限公司'}",163270,1,{'150000000'},4,"{'北京华信六合投资有限公司', '竞价', '60', '现金'}",4,"{'北京华信六合投资有限公司', '竞价', '60', '现金'}"
9,"{'现金', '11182000', '王军华', '竞价', '14843000', '19975000', '符冠华', '36', '苏交科第1期员工持股计划'}",1662858,3,"{'竞价', '11182000', '14843000'}",4,"{'36', '现金', '符冠华', '王军华'}",6,"{'现金', '王军华', '19975000', '符冠华', '36', '苏交科第1期员工持股计划'}"
4,"{'陶国平', '现金', '36', '160000000'}",16079421,0,set(),3,"{'陶国平', '现金', '36'}",4,"{'陶国平', '现金', '36', '160000000'}"
14,"{'上海虢实投资合伙企业(有限合伙)', '金鹰基金管理有限公司', '现金', '海通资产管理——上海银行——海通海富7号集合资产管理计划', '16689466', '8207934', '西藏凤凰股权投资管理合伙企业(有限合伙)', '17510260', '8344733', '顾学群', '10943912', '宋文雷', '12', '17647058'}",1036875,0,set(),5,"{'金鹰基金管理有限公司', '现金', '顾学群', '宋文雷', '12'}",14,"{'上海虢实投资合伙企业(有限合伙)', '金鹰基金管理有限公司', '现金', '海通资产管理——上海银行——海通海富7号集合资产管理计划', '16689466', '8207934', '西藏凤凰股权投资管理合伙企业(有限合伙)', '17510260', '8344733', '顾学群', '10943912', '宋文雷', '12', '17647058'}"
9,"{'5931198', '现金', '湖南红翔投资合伙企业(有限合伙)', '100000000', '定价', '朱明楚', '69000000', '4092526', '36'}",1555857,3,"{'5931198', '4092526', '100000000'}",4,"{'朱明楚', '定价', '现金', '36'}",6,"{'现金', '湖南红翔投资合伙企业(有限合伙)', '定价', '朱明楚', '69000000', '36'}"
16,"{'16542506', '现金', '诺安基金管理有限公司', '博时基金管理有限公司', '26656433', '财通基金管理有限公司', '20092023', '21647675', '中信证券股份有限公司', '青岛城投金融控股集团有限公司', '安信基金管理有限责任公司', '15622261', '15775635', '银河金汇证券资产管理有限公司', '12', '德盈润泰实业有限公司'}",2371258,0,set(),10,"{'现金', '诺安基金管理有限公司', '博时基金管理有限公司', '财通基金管理有限公司', '中信证券股份有限公司', '青岛城投金融控股集团有限公司', '安信基金管理有限责任公司', '银河金汇证券资产管理有限公司', '12', '德盈润泰实业有限公司'}",16,"{'16542506', '现金', '诺安基金管理有限公司', '博时基金管理有限公司', '26656433', '财通基金管理有限公司', '20092023', '21647675', '中信证券股份有限公司', '青岛城投金融控股集团有限公司', '安信基金管理有限责任公司', '15622261', '15775635', '银河金汇证券资产管理有限公司', '12', '德盈润泰实业有限公司'}"
21,"{'3754367', '青岛煜明投资中心(有限合伙)', '7000000', '8000000', '现金', '兴业全球基金管理有限公司', '12', '招商基金管理有限公司', '财通基金管理有限公司', '竞价', '宝盈基金管理有限公司', '9000000', '东海瑞京资产管理(上海)有限公司', '民生加银基金管理有限公司', '18100000', '7700000', '兴证证券资产管理有限公司', '7595000', '天弘基金管理有限公司', '7800000', '36'}",308665,1,{'竞价'},9,"{'现金', '民生加银基金管理有限公司', '兴证证券资产管理有限公司', '兴业全球基金管理有限公司', '12', '招商基金管理有限公司', '天弘基金管理有限公司', '宝盈基金管理有限公司', '36'}",20,"{'东海瑞京资产管理(上海)有限公司', '36', '3754367', '现金', '民生加银基金管理有限公司', '兴证证券资产管理有限公司', '兴业全球基金管理有限公司', '招商基金管理有限公司', '青岛煜明投资中心(有限合伙)', '财通基金管理有限公司', '7000000', '天弘基金管理有限公司', '9000000', '7595000', '7800000', '宝盈基金管理有限公司', '18100000', '8000000', '7700000', '12'}"
20,"{'郭朝进', '54750000', '现金', '5000000', '237250000', '65000000', '定价', '广东韶钢松山股份有限公司', '35000000', '127750000', '91250000', '15000000', '耒阳市国有资产投资经营有限公司', '25000000', '广东温氏投资有限公司', '翁辉武', '华商基金管理有限公司', '深圳日昇创沅资产管理有限公司', '12', '18250000'}",1225197,6,"{'54750000', '237250000', '广东韶钢松山股份有限公司', '127750000', '91250000', '18250000'}",9,"{'郭朝进', '现金', '定价', '耒阳市国有资产投资经营有限公司', '广东温氏投资有限公司', '翁辉武', '华商基金管理有限公司', '深圳日昇创沅资产管理有限公司', '12'}",14,"{'郭朝进', '5000000', '现金', '65000000', '35000000', '定价', '15000000', '耒阳市国有资产投资经营有限公司', '25000000', '广东温氏投资有限公司', '翁辉武', '华商基金管理有限公司', '深圳日昇创沅资产管理有限公司', '12'}"
9,"{'现金', '690000000', '广西新发展交通集团有限公司', '广西农村投资集团有限公司', '定价', '41591320', '18685955', '310000000', '36'}",4938361,2,"{'310000000', '690000000'}",5,"{'现金', '广西新发展交通集团有限公司', '广西农村投资集团有限公司', '定价', '36'}",7,"{'现金', '广西新发展交通集团有限公司', '广西农村投资集团有限公司', '定价', '41591320', '18685955', '36'}"
11,"{'现金', '1852500000', '162500000', '新毅控股', '54166666', '勤满有限', '617500000', '弘毅贰零壹伍', '72807018', '830000000', '36'}",2039166,5,"{'1852500000', '162500000', '54166666', '617500000', '72807018'}",5,"{'现金', '新毅控股', '勤满有限', '弘毅贰零壹伍', '36'}",6,"{'现金', '新毅控股', '勤满有限', '弘毅贰零壹伍', '830000000', '36'}"
16,"{'2450001148', '449999620', '现金', '太平洋资产管理有限责任公司', '工银瑞信基金管理有限公司', '新华人寿保险股份有限公司', '12', '149999654', '22796300', '易方达基金管理有限公司', '竞价', '中国海洋石油总公司', '68389000', '信达澳银基金管理有限公司', '36', '372340600'}",223342,0,set(),9,"{'太平洋资产管理有限责任公司', '现金', '工银瑞信基金管理有限公司', '新华人寿保险股份有限公司', '12', '易方达基金管理有限公司', '竞价', '信达澳银基金管理有限公司', '中国海洋石油总公司'}",16,"{'2450001148', '449999620', '太平洋资产管理有限责任公司', '现金', '工银瑞信基金管理有限公司', '新华人寿保险股份有限公司', '12', '149999654', '22796300', '易方达基金管理有限公司', '竞价', '中国海洋石油总公司', '68389000', '信达澳银基金管理有限公司', '36', '372340600'}"
16,"{'20000000', '京基集团有限公司', '29000000', '黄仙兰', '35000000', '15000000', '26000000', '嘉实基金管理有限公司', '广发基金管理有限公司', '浙江双可达纺织有限公司', '竞价', '无锡均衡创业投资有限公司', '28000000', '东莞市君德富创业投资有限公司', '深圳市一声达通信技术有限公司', '12'}",418818,4,"{'20000000', '29000000', '15000000', '26000000'}",10,"{'京基集团有限公司', '黄仙兰', '嘉实基金管理有限公司', '广发基金管理有限公司', '浙江双可达纺织有限公司', '竞价', '无锡均衡创业投资有限公司', '东莞市君德富创业投资有限公司', '深圳市一声达通信技术有限公司', '12'}",12,"{'京基集团有限公司', '黄仙兰', '35000000', '嘉实基金管理有限公司', '广发基金管理有限公司', '浙江双可达纺织有限公司', '竞价', '无锡均衡创业投资有限公司', '28000000', '东莞市君德富创业投资有限公司', '深圳市一声达通信技术有限公司', '12'}"
21,"{'兵器财务有限责任公司', '4000000', '易方达基金管理有限公司', '南方基金管理有限公司', '南京仙林房地产开发有限公司', '6000000', '5000000', '现金', '5400000', '11000000', '竞价', '国泰君安证券股份有限公司', '10000000', '博时基金管理有限公司', '长盛基金管理有限公司', '三峡财务有限责任公司', '5500000', '4100000', '中国人寿资产管理有限公司', '12', '招商证券股份有限公司'}",1492254,10,"{'5000000', '现金', '4000000', '4100000', '5500000', '5400000', '11000000', '竞价', '6000000', '10000000'}",1,{'12'},11,"{'兵器财务有限责任公司', '博时基金管理有限公司', '长盛基金管理有限公司', '三峡财务有限责任公司', '易方达基金管理有限公司', '国泰君安证券股份有限公司', '南方基金管理有限公司', '中国人寿资产管理有限公司', '南京仙林房地产开发有限公司', '12', '招商证券股份有限公司'}"
17,"{'438401073', '7625753', '天保投资', '12', '通合投资', '定价', '34662514', '远景投资', '41595017', '11554171', '燕山投资', '天诚投资', '海航实业', '天信投资', '119065736', '23108342', '36'}",884992,2,"{'燕山投资', '定价'}",8,"{'天保投资', '12', '通合投资', '远景投资', '天诚投资', '海航实业', '天信投资', '36'}",15,"{'438401073', '7625753', '天保投资', '12', '通合投资', '远景投资', '34662514', '11554171', '41595017', '天诚投资', '海航实业', '天信投资', '119065736', '23108342', '36'}"
18,"{'5000000', '现金', '刘连红', '周鸣江', '1000000', '5220000', '龚新度', '52200000', '周宏江', '130000000', '农银无锡', '周海燕', '红豆集团', '678600000', '新余红树', '10000000', '26100000', '36'}",320821,7,"{'26100000', '1000000', '52200000', '130000000', '678600000', '10000000', '5220000'}",10,"{'36', '现金', '刘连红', '周鸣江', '龚新度', '周宏江', '农银无锡', '周海燕', '红豆集团', '新余红树'}",11,"{'36', '5000000', '现金', '刘连红', '周鸣江', '龚新度', '周宏江', '农银无锡', '周海燕', '红豆集团', '新余红树'}"
26,"{'449999996.5', '杭州东方邦信赤孝股权投资基金合伙企业(有限合伙)', '102995391', '泰达宏利基金管理有限公司', '17654763', '现金', '56798000', '定价', '893999993.9', '57034220', '449999995.8', '北信瑞丰基金管理有限公司', '447016000', '447000260', '上海国泰君安证券资产管理有限公司', '56800000', '富国基金管理有限公司', '52403283', '889999997', '华宝信托有限责任公司', '138942984.8', '中信建投证券股份有限公司', '安信基金管理有限责任公司', '56390977', '12', '104705882'}",16725535,2,"{'449999996.5', '893999993.9'}",10,"{'现金', '北信瑞丰基金管理有限公司', '定价', '华宝信托有限责任公司', '上海国泰君安证券资产管理有限公司', '中信建投证券股份有限公司', '安信基金管理有限责任公司', '富国基金管理有限公司', '泰达宏利基金管理有限公司', '12'}",24,"{'杭州东方邦信赤孝股权投资基金合伙企业(有限合伙)', '102995391', '泰达宏利基金管理有限公司', '17654763', '现金', '56798000', '定价', '57034220', '449999995.8', '北信瑞丰基金管理有限公司', '447016000', '447000260', '上海国泰君安证券资产管理有限公司', '56800000', '富国基金管理有限公司', '52403283', '889999997', '华宝信托有限责任公司', '138942984.8', '中信建投证券股份有限公司', '安信基金管理有限责任公司', '56390977', '12', '104705882'}"
32,"{'179150000', '50000000', '辽宁能源投资(集团)有限责任公司', '557000000', '799963400', '现金', '89766606', '新华人寿保险股份有限公司', '哈尔滨动力设备股份有限公司', '定价', '35900000', '279708656.6', '中国海洋石油总公司', '199963000', '36', '997865500', '建银国际资本管理(天津)有限公司', '中国华能集团公司', '东方电气股份有限公司', '278500000', '50216994', '100000000', '中国长江三峡集团公司', '大成基金管理有限公司', '143620000', '2785000000', '499999995.4', '1399999448', '500000000', '中国人寿资产管理有限公司', '251346400', '12'}",1496169,1,{'279708656.6'},7,"{'36', '现金', '哈尔滨动力设备股份有限公司', '定价', '中国华能集团公司', '东方电气股份有限公司', '12'}",31,"{'179150000', '50000000', '辽宁能源投资(集团)有限责任公司', '557000000', '799963400', '现金', '89766606', '新华人寿保险股份有限公司', '哈尔滨动力设备股份有限公司', '定价', '35900000', '中国海洋石油总公司', '199963000', '36', '997865500', '建银国际资本管理(天津)有限公司', '中国华能集团公司', '东方电气股份有限公司', '278500000', '50216994', '100000000', '中国长江三峡集团公司', '大成基金管理有限公司', '143620000', '2785000000', '499999995.4', '1399999448', '500000000', '中国人寿资产管理有限公司', '251346400', '12'}"
6,"{'重庆商社(集团)有限公司', '现金', '竞价', '33435047', '616415214', '36'}",1055233,1,{'竞价'},2,"{'现金', '36'}",5,"{'重庆商社(集团)有限公司', '现金', '33435047', '616415214', '36'}"
4,"{'现金', '金世旗控股', '定价', '36'}",1807540,0,set(),4,"{'36', '金世旗控股', '定价', '现金'}",4,"{'36', '金世旗控股', '定价', '现金'}"
9,"{'现金', '广发恒定18号', '翁霖', '定价', '14047619', '106966667', '8428571', '翁耀根', '36'}",1929770,0,set(),5,"{'现金', '翁霖', '定价', '翁耀根', '36'}",9,"{'现金', '广发恒定18号', '翁霖', '14047619', '定价', '106966667', '8428571', '翁耀根', '36'}"
22,"{'深圳市创新投资集团有限公司', '149999995.2', '399498000', '160053003', '8491310', '现金', '151409999.4', '60530000', '定价', '河南黄河实业集团股份有限公司', '36', '56042646', '22727272', '150016350', '24250455', '上银基金管理有限公司', '兴证证券资产管理有限公司', '22940909', '安信证券股份有限公司', '泰康资产管理有限责任公司', '22729750', '12'}",66165,0,set(),10,"{'36', '现金', '兴证证券资产管理有限公司', '深圳市创新投资集团有限公司', '定价', '河南黄河实业集团股份有限公司', '安信证券股份有限公司', '泰康资产管理有限责任公司', '12', '上银基金管理有限公司'}",22,"{'深圳市创新投资集团有限公司', '149999995.2', '399498000', '160053003', '8491310', '现金', '151409999.4', '60530000', '定价', '河南黄河实业集团股份有限公司', '36', '56042646', '22727272', '150016350', '24250455', '上银基金管理有限公司', '兴证证券资产管理有限公司', '22940909', '安信证券股份有限公司', '泰康资产管理有限责任公司', '22729750', '12'}"
21,"{'186641517.4', '162932790', '现金', '285132382', '定价', '203665987', '38012529', '299999998.4', '149999999.2', '36', '中信证券中兵投资驰宏锌锗定向资产管理计划', '国华人寿保险股份有限公司', '61099796', '1399999996', '郑积华', '30549898', '999999996.2', '中信证券驰宏锌锗投资1号定向资产管理计划', '799999998.9', '珠海金润中泽投资中心(有限合伙)', '云南冶金集团股份有限公司'}",16946941,5,"{'186641517.4', '1399999996', '999999996.2', '299999998.4', '149999999.2'}",5,"{'现金', '定价', '云南冶金集团股份有限公司', '郑积华', '36'}",16,"{'162932790', '现金', '285132382', '中信证券中兵投资驰宏锌锗定向资产管理计划', '中信证券驰宏锌锗投资1号定向资产管理计划', '国华人寿保险股份有限公司', '61099796', '203665987', '定价', '38012529', '云南冶金集团股份有限公司', '郑积华', '799999998.9', '珠海金润中泽投资中心(有限合伙)', '30549898', '36'}"
13,"{'上海圣雍创业投资合伙企业(有限合伙)', '现金', '青海溢峰科技投资有限公司', '深圳市创东方富达投资企业(有限合伙)', '兴业全球基金管理有限公司', '18000000', '财通基金管理有限公司', '青海机电国有控股有限公司', '199430000', '97020000', '37000000', '北京千石创富资本管理有限公司', '36'}",478921,4,"{'18000000', '199430000', '97020000', '37000000'}",7,"{'青海溢峰科技投资有限公司', '现金', '兴业全球基金管理有限公司', '财通基金管理有限公司', '青海机电国有控股有限公司', '北京千石创富资本管理有限公司', '36'}",9,"{'上海圣雍创业投资合伙企业(有限合伙)', '现金', '青海溢峰科技投资有限公司', '深圳市创东方富达投资企业(有限合伙)', '兴业全球基金管理有限公司', '财通基金管理有限公司', '青海机电国有控股有限公司', '北京千石创富资本管理有限公司', '36'}"
6,"{'4502024', '现金', '12787722', '六安信实', '符冠华', '36'}",16364211,1,{'4502024'},4,"{'六安信实', '现金', '符冠华', '36'}",5,"{'现金', '12787722', '六安信实', '符冠华', '36'}"
11,"{'南京瑞森投资管理合伙企业(有限合伙)', '长城国融投资管理有限公司', '23216652', '11582395', '20225974', '定价', '德清县乌灵股权投资合伙企业(有限合伙)', '3457432', '长信基金管理有限责任公司', '俞有强', '36'}",1690365,0,set(),5,"{'长城国融投资管理有限公司', '定价', '长信基金管理有限责任公司', '俞有强', '36'}",11,"{'南京瑞森投资管理合伙企业(有限合伙)', '长城国融投资管理有限公司', '23216652', '11582395', '20225974', '定价', '德清县乌灵股权投资合伙企业(有限合伙)', '3457432', '长信基金管理有限责任公司', '俞有强', '36'}"
23,"{'78899999.68', '兵器财务有限责任公司', '73145992.96', '现金', '邦信资产管理有限公司', '7091935', '199392000', '定价', '北京能源投资(集团)有限公司', '深圳市平安创新资本投资有限公司', '15656250', '36', '70351995.2', '164000009.3', '20100000', '16532259', '7373588', '江苏嘉睿创业投资有限公司', '7953629', '江西育科投资有限责任公司', '155310000', '12', '中国东方资产管理公司'}",1503299,1,{'164000009.3'},10,"{'36', '兵器财务有限责任公司', '现金', '邦信资产管理有限公司', '定价', '江苏嘉睿创业投资有限公司', '江西育科投资有限责任公司', '深圳市平安创新资本投资有限公司', '12', '中国东方资产管理公司'}",22,"{'78899999.68', '兵器财务有限责任公司', '73145992.96', '155310000', '现金', '邦信资产管理有限公司', '7091935', '199392000', '定价', '北京能源投资(集团)有限公司', '深圳市平安创新资本投资有限公司', '15656250', '36', '20100000', '16532259', '7373588', '江苏嘉睿创业投资有限公司', '7953629', '江西育科投资有限责任公司', '70351995.2', '12', '中国东方资产管理公司'}"
6,"{'8789722', '现金', '深圳市架桥富凯九号股权投资企业(有限合伙)', '129999988.4', '竞价', '12'}",14784709,2,"{'竞价', '129999988.4'}",2,"{'现金', '12'}",4,"{'现金', '8789722', '深圳市架桥富凯九号股权投资企业(有限合伙)', '12'}"
5,"{'5000000', '现金', '史万福', '竞价', '36'}",680208,0,set(),4,"{'36', '竞价', '史万福', '现金'}",5,"{'5000000', '现金', '史万福', '竞价', '36'}"
22,"{'南方工业资产', '现金', '中信建投基金银河2号', '竞价', '13449899', '张家书', '中信建投基金银河1号', '20174848', '22232683', '15467383', '16099529', '林增佛', '林超', '北信瑞丰-南方资产-共进1号资产管理计划', '9414929', '28244788', '西藏瑞华投资', '2017484', '杨晓玲', '11432414', '华安-中兵资产管理计划', '36'}",1668782,1,{'竞价'},10,"{'西藏瑞华投资', '南方工业资产', '36', '现金', '杨晓玲', '北信瑞丰-南方资产-共进1号资产管理计划', '林增佛', '华安-中兵资产管理计划', '林超', '张家书'}",21,"{'南方工业资产', '现金', '中信建投基金银河2号', '13449899', '张家书', '中信建投基金银河1号', '20174848', '22232683', '15467383', '16099529', '林增佛', '林超', '北信瑞丰-南方资产-共进1号资产管理计划', '9414929', '28244788', '西藏瑞华投资', '2017484', '杨晓玲', '11432414', '华安-中兵资产管理计划', '36'}"
15,"{'12000000', '沈阳八达通信科技开发公司', '洋浦远望投资发展有限公司', '现金', '4000000', '博时基金管理有限公司', '金元证券有限责任公司', '东方证券股份有限公司', '清华大学教育基金会', '竞价', '国泰君安证券股份有限公司', '3000000', '6000000', '12', '德润国际投资有限公司'}",1493107,6,"{'12000000', '现金', '4000000', '竞价', '3000000', '6000000'}",1,{'12'},9,"{'沈阳八达通信科技开发公司', '洋浦远望投资发展有限公司', '博时基金管理有限公司', '金元证券有限责任公司', '东方证券股份有限公司', '清华大学教育基金会', '国泰君安证券股份有限公司', '12', '德润国际投资有限公司'}"
5,"{'现金', '三林万业', '竞价', '407469800', '36'}",384747,1,{'407469800'},4,"{'三林万业', '竞价', '现金', '36'}",4,"{'三林万业', '竞价', '现金', '36'}"
4,"{'新世纪公司', '竞价', '现金', '36'}",14758598,0,set(),4,"{'新世纪公司', '竞价', '现金', '36'}",4,"{'新世纪公司', '竞价', '现金', '36'}"
18,"{'正奇投资', '现金', '16000000', '扬州尚颀', '3550000', '5847953', '定价', '36423000', '3450000', '60000000', '4152047', '35397000', '164160000', '42600000', '万家基金—恒赢定增5号资产管理计划', '上汽投资', '万家基金—恒赢定增6号资产管理计划', '36'}",363669,5,"{'36423000', '60000000', '35397000', '164160000', '42600000'}",6,"{'正奇投资', '现金', '扬州尚颀', '定价', '上汽投资', '36'}",13,"{'正奇投资', '现金', '16000000', '扬州尚颀', '3550000', '5847953', '定价', '3450000', '4152047', '万家基金—恒赢定增5号资产管理计划', '上汽投资', '万家基金—恒赢定增6号资产管理计划', '36'}"
10,"{'82135523', '章建平', '41067761', '工银瑞信基金管理有限公司', '安徽省铁路建设投资基金有限公司', '天安财产保险股份有限公司', '1599999988', '竞价', '799999984.3', '12'}",2374518,2,"{'799999984.3', '竞价'}",5,"{'章建平', '工银瑞信基金管理有限公司', '安徽省铁路建设投资基金有限公司', '天安财产保险股份有限公司', '12'}",8,"{'82135523', '章建平', '41067761', '工银瑞信基金管理有限公司', '安徽省铁路建设投资基金有限公司', '天安财产保险股份有限公司', '1599999988', '12'}"
4,"{'36', '定价', '现金', '国开金融'}",1857562,0,set(),4,"{'国开金融', '定价', '现金', '36'}",4,"{'36', '定价', '现金', '国开金融'}"
23,"{'博时资本管理有限公司', '申万菱信(上海)资产管理有限公司', '天津滨海发展投资控股有限公司', '449999995.5', '现金', '7254546', '定价', '27272727', '81818181', '109090909', '36', '149999998.5', '167099999', '东海基金管理有限责任公司', '39900003', '上海沅乙投资中心(有限合伙)', '招商财富资产管理有限公司', '华夏基金管理有限公司', '30381818', '26000000', '143000000', '599999999.5', '12'}",1560308,0,set(),9,"{'招商财富资产管理有限公司', '36', '现金', '博时资本管理有限公司', '华夏基金管理有限公司', '定价', '东海基金管理有限责任公司', '12', '天津滨海发展投资控股有限公司'}",23,"{'博时资本管理有限公司', '申万菱信(上海)资产管理有限公司', '天津滨海发展投资控股有限公司', '449999995.5', '现金', '7254546', '定价', '27272727', '81818181', '109090909', '36', '149999998.5', '167099999', '东海基金管理有限责任公司', '39900003', '上海沅乙投资中心(有限合伙)', '招商财富资产管理有限公司', '华夏基金管理有限公司', '30381818', '26000000', '143000000', '599999999.5', '12'}"
4,"{'卢柏强', '竞价', '现金', '36'}",1176148,1,{'竞价'},3,"{'卢柏强', '现金', '36'}",3,"{'卢柏强', '现金', '36'}"
32,"{'259999997.4', '张炳城', '299999997', '110999997.9', '45757575', '邓天洲', '452999992.5', '现金', '298999998', '财通证券资产管理有限公司', '49999999.5', '定价', '11616161', '52222222', '30303030', '516999997.8', '安徽中安资本管理有限公司', '36', '常州翔嘉中舟投资中心(有限合伙)', '杭州东方嘉富资产管理有限公司', '114999993.9', '东海基金管理有限责任公司', '11212121', '5050505', '26262626', '黄博', '79999999.2', '30202020', '8080808', '英大基金管理有限公司', '融通基金管理有限公司', '12'}",16493787,0,set(),13,"{'安徽中安资本管理有限公司', '36', '现金', '财通证券资产管理有限公司', '杭州东方嘉富资产管理有限公司', '定价', '英大基金管理有限公司', '融通基金管理有限公司', '东海基金管理有限责任公司', '张炳城', '黄博', '邓天洲', '12'}",32,"{'259999997.4', '张炳城', '299999997', '110999997.9', '45757575', '邓天洲', '452999992.5', '现金', '298999998', '财通证券资产管理有限公司', '49999999.5', '定价', '11616161', '52222222', '30303030', '516999997.8', '安徽中安资本管理有限公司', '36', '常州翔嘉中舟投资中心(有限合伙)', '杭州东方嘉富资产管理有限公司', '114999993.9', '东海基金管理有限责任公司', '11212121', '5050505', '26262626', '黄博', '79999999.2', '30202020', '8080808', '英大基金管理有限公司', '融通基金管理有限公司', '12'}"
18,"{'3587197', '6898455', '2207506', '现金', '长安平安富贵东方通资产管理计划', '250000009.2', '80000017.44', '朱曼', '827834', '30000704.16', '黄永军', '9255684', '335425988.2', '竞价', '兴全沈惠中特定客户资产管理计划', '130000019.3', '36', '平安汇通星通资本定向投资4号资产管理计划'}",1823789,5,"{'335425988.2', '80000017.44', '30000704.16', '竞价', '130000019.3'}",7,"{'现金', '长安平安富贵东方通资产管理计划', '朱曼', '黄永军', '兴全沈惠中特定客户资产管理计划', '36', '平安汇通星通资本定向投资4号资产管理计划'}",13,"{'3587197', '6898455', '2207506', '现金', '长安平安富贵东方通资产管理计划', '250000009.2', '朱曼', '827834', '黄永军', '9255684', '兴全沈惠中特定客户资产管理计划', '36', '平安汇通星通资本定向投资4号资产管理计划'}"
20,"{'招商财富资产管理有限公司', '现金', '132999995.3', '6647398', '7687861', '341999997.8', '114999985.4', '19768786', '6589595', '113999993.5', '天安财产保险股份有限公司', '5356857', '广东温氏投资有限公司', '申万菱信基金管理有限公司', '92673626.1', '340999988.6', '华富基金管理有限公司', '12', '华泰柏瑞基金管理有限公司', '19710982'}",1856304,0,set(),7,"{'现金', '天安财产保险股份有限公司', '广东温氏投资有限公司', '申万菱信基金管理有限公司', '华富基金管理有限公司', '12', '华泰柏瑞基金管理有限公司'}",20,"{'招商财富资产管理有限公司', '现金', '132999995.3', '6647398', '7687861', '341999997.8', '114999985.4', '19768786', '6589595', '113999993.5', '天安财产保险股份有限公司', '5356857', '广东温氏投资有限公司', '申万菱信基金管理有限公司', '92673626.1', '340999988.6', '华富基金管理有限公司', '12', '华泰柏瑞基金管理有限公司', '19710982'}"
21,"{'3515625', '50000000', '32882995.2', '现金', '北京诚明汇投资管理中心(有限合伙)', '12', '定价', '广发原驰•高德红外投资1号定向资产管理计划', '300000000', '1953125', '平安大华基金管理有限公司', '48071398.4', '90000000', '国泰基金管理有限公司', '1877789', '富国基金管理有限公司', '泓德基金管理有限公司', '天弘基金管理有限公司', '1284492', '36', '11718750'}",14781439,0,set(),4,"{'36', '定价', '现金', '12'}",21,"{'3515625', '50000000', '32882995.2', '现金', '北京诚明汇投资管理中心(有限合伙)', '12', '定价', '广发原驰•高德红外投资1号定向资产管理计划', '300000000', '1953125', '平安大华基金管理有限公司', '48071398.4', '90000000', '国泰基金管理有限公司', '1877789', '富国基金管理有限公司', '泓德基金管理有限公司', '天弘基金管理有限公司', '1284492', '36', '11718750'}"
16,"{'西安长令投资管理有限合伙企业', '上海密列恩投资管理合伙企业(有限合伙)', '天津盛熙股权投资基金合伙企业(有限合伙)', '34695000', '46260000', '常州市新发展实业公司', '71960000', '2000000', '竞价', '25700000', '中钢投资有限公司', '2700000', '5600000', '3600000', '12', '华泰柏瑞基金管理有限公司'}",215250,4,"{'46260000', '25700000', '34695000', '71960000'}",2,"{'竞价', '12'}",12,"{'西安长令投资管理有限合伙企业', '上海密列恩投资管理合伙企业(有限合伙)', '天津盛熙股权投资基金合伙企业(有限合伙)', '常州市新发展实业公司', '2000000', '中钢投资有限公司', '竞价', '2700000', '5600000', '3600000', '12', '华泰柏瑞基金管理有限公司'}"
11,"{'现金', '34013600', '京蓝控股', '上海衢富', '楼泰投资', '信诚投资', '25510200', '127551000', '17006800', '36', '盈创嘉业'}",379213,4,"{'127551000', '17006800', '34013600', '25510200'}",7,"{'36', '现金', '京蓝控股', '上海衢富', '楼泰投资', '信诚投资', '盈创嘉业'}",7,"{'现金', '京蓝控股', '上海衢富', '楼泰投资', '信诚投资', '36', '盈创嘉业'}"
4,"{'竞价', '现金', '蚌埠玻璃工业设计研究院所', '36'}",169827,1,{'竞价'},3,"{'现金', '蚌埠玻璃工业设计研究院所', '36'}",3,"{'现金', '蚌埠玻璃工业设计研究院所', '36'}"
31,"{'20000000', '29000000', '华安基金管理有限公司', '7000000', '3000000', '现金', '14000000', '定价', '258060000', '常州投资集团有限公司', '17000000', '鹏华基金管理有限公司', '212520000', '10000000', '15000000', '151800000', '6750000', '45540000', '102465000', '中凡投资管理有限公司', '江苏瑞华投资发展有限公司', '华夏基金管理有限公司', '国信证券股份有限公司', '106260000', '上海世讯会展服务有限公司', '嘉实基金管理有限公司', '440220000', '中国人寿资产管理有限公司', '227700000', '12', '303600000'}",1181154,14,"{'102465000', '20000000', '29000000', '227700000', '15000000', '106260000', '440220000', '258060000', '151800000', '17000000', '212520000', '6750000', '303600000', '45540000'}",6,"{'现金', '江苏瑞华投资发展有限公司', '定价', '上海世讯会展服务有限公司', '12', '中凡投资管理有限公司'}",17,"{'现金', '华安基金管理有限公司', '江苏瑞华投资发展有限公司', '华夏基金管理有限公司', '国信证券股份有限公司', '14000000', '定价', '上海世讯会展服务有限公司', '7000000', '嘉实基金管理有限公司', '常州投资集团有限公司', '3000000', '鹏华基金管理有限公司', '中国人寿资产管理有限公司', '10000000', '12', '中凡投资管理有限公司'}"
5,"{'现金', '招商局轮船', '2000000000', '576368876', '36'}",314689,1,{'2000000000'},3,"{'招商局轮船', '现金', '36'}",4,"{'招商局轮船', '现金', '576368876', '36'}"
13,"{'现金', '294811', '16115566', '589623', '前海大宇定增2号私募基金', '定价', '周雯', '3000000', '孙红霞', '瀚信定增3号证券投资基金', '10000000', '36', '林洺锋'}",1863949,5,"{'294811', '589623', '3000000', '10000000', '16115566'}",6,"{'现金', '定价', '周雯', '孙红霞', '36', '林洺锋'}",8,"{'现金', '前海大宇定增2号私募基金', '定价', '周雯', '孙红霞', '瀚信定增3号证券投资基金', '36', '林洺锋'}"
4,"{'定价', '美都集团', '36', '63000000'}",551689,2,"{'定价', '63000000'}",2,"{'美都集团', '36'}",2,"{'美都集团', '36'}"
17,"{'东吴基金管理有限公司', '35372848', '上银瑞金资本管理有限公司', '369999990.1', '114993', '43021032', '财通基金管理有限公司', '35277246', '1202826.78', '上海国泰君安证券资产管理有限公司', '竞价', '368999993.2', '创金合信基金管理有限公司', '28393881', '296999995.3', '449999994.7', '12'}",4950865,4,"{'369999990.1', '竞价', '296999995.3', '368999993.2'}",6,"{'东吴基金管理有限公司', '上银瑞金资本管理有限公司', '财通基金管理有限公司', '上海国泰君安证券资产管理有限公司', '创金合信基金管理有限公司', '12'}",13,"{'东吴基金管理有限公司', '35372848', '上银瑞金资本管理有限公司', '114993', '43021032', '财通基金管理有限公司', '35277246', '1202826.78', '上海国泰君安证券资产管理有限公司', '创金合信基金管理有限公司', '28393881', '449999994.7', '12'}"
11,"{'陈海昌', '日昇创沅', '庄敏', '蒋俊杰', '108797736', '339992924', '庄明', '841482488', '27199434', '42499116', '36'}",78225,5,"{'42499116', '108797736', '339992924', '841482488', '27199434'}",6,"{'陈海昌', '日昇创沅', '庄敏', '蒋俊杰', '庄明', '36'}",6,"{'陈海昌', '日昇创沅', '庄敏', '蒋俊杰', '庄明', '36'}"
12,"{'现金', '41548631', '南通元鼎投资有限公司', '郭仁祥', '兴证资管鑫众—吉艾科技1号定向资产管理计划', '定价', '3208000', '4721435', '50000000', '440000000', '33972720', '36'}",12040986,2,"{'33972720', '50000000'}",5,"{'现金', '郭仁祥', '定价', '南通元鼎投资有限公司', '36'}",10,"{'现金', '41548631', '郭仁祥', '兴证资管鑫众—吉艾科技1号定向资产管理计划', '定价', '3208000', '4721435', '440000000', '南通元鼎投资有限公司', '36'}"
3,"{'2400000000', '现金', '中国长安汽车集团股份有限公司'}",1644360,1,{'2400000000'},2,"{'现金', '中国长安汽车集团股份有限公司'}",2,"{'现金', '中国长安汽车集团股份有限公司'}"
4,"{'青岛企发', '竞价', '36', '350000000'}",1923023,2,"{'350000000', '竞价'}",2,"{'青岛企发', '36'}",2,"{'青岛企发', '36'}"
20,"{'招商财富资产管理有限公司', '719999997.2', '143769968', '齐鲁证券(上海)资产管理有限公司', '95846645', '299999998.9', '宝盈基金管理有限公司', '申万菱信(上海)资产管理有限公司', '东海基金管理有限责任公司', '财通基金管理有限公司', '竞价', '359999998.6', '海通证券股份有限公司', '申万菱信基金管理有限公司', '115015974', '230031948', '86261983', '449999999.8', '12', '270000006.8'}",304666,3,"{'299999998.9', '竞价', '270000006.8'}",1,{'12'},17,"{'招商财富资产管理有限公司', '719999997.2', '143769968', '齐鲁证券(上海)资产管理有限公司', '95846645', '宝盈基金管理有限公司', '申万菱信(上海)资产管理有限公司', '东海基金管理有限责任公司', '财通基金管理有限公司', '359999998.6', '海通证券股份有限公司', '申万菱信基金管理有限公司', '115015974', '230031948', '86261983', '449999999.8', '12'}"
16,"{'121951223.3', '现金', '大连高金科技发展有限公司', '中合中小企业融资担保股份有限公司', '宣家鑫', '4957366', '定价', '上海猜特投资管理中心(有限合伙)', '14634146.4', '249999999.4', '西藏世纪融通投资管理合伙企业(有限合伙)', '48780481.44', '12393417', '1487210', '36', '25406504'}",9890043,2,"{'121951223.3', '249999999.4'}",6,"{'现金', '中合中小企业融资担保股份有限公司', '宣家鑫', '大连高金科技发展有限公司', '定价', '36'}",14,"{'现金', '大连高金科技发展有限公司', '中合中小企业融资担保股份有限公司', '宣家鑫', '4957366', '定价', '上海猜特投资管理中心(有限合伙)', '14634146.4', '西藏世纪融通投资管理合伙企业(有限合伙)', '48780481.44', '12393417', '1487210', '36', '25406504'}"
14,"{'561280483', '中再资产管理股份有限公司', '中国华录集团有限公司', '8013131', '13837716', '中国华融资产管理股份有限公司', '竞价', '231579485.9', '19421470', '199809976', '宁波华易智诚投资合伙企业(有限合伙)', '36', '6913840', '399909992.4'}",1772219,1,{'竞价'},4,"{'中国华录集团有限公司', '中再资产管理股份有限公司', '中国华融资产管理股份有限公司', '36'}",13,"{'561280483', '中再资产管理股份有限公司', '中国华录集团有限公司', '8013131', '13837716', '中国华融资产管理股份有限公司', '231579485.9', '19421470', '199809976', '宁波华易智诚投资合伙企业(有限合伙)', '36', '6913840', '399909992.4'}"
7,"{'东方外贸', '塔城国际', '中环技', '定价', '39573914', '227550008', '36'}",1747157,1,{'定价'},4,"{'中环技', '36', '东方外贸', '塔城国际'}",6,"{'东方外贸', '塔城国际', '中环技', '39573914', '227550008', '36'}"
5,"{'中国水务投资有限公司', '现金', '竞价', '浙江省水利水电投资集团有限公司', '36'}",1140631,0,set(),5,"{'中国水务投资有限公司', '现金', '竞价', '浙江省水利水电投资集团有限公司', '36'}",5,"{'中国水务投资有限公司', '现金', '竞价', '浙江省水利水电投资集团有限公司', '36'}"
18,"{'平安大华基金管理有限公司', '现金', '40715200', '551400420', '定价', '30206300', '295999504', '财通基金管理有限公司', '199999881', '中国银河证券股份有限公司', '219599801', '74690500', '泰康资产管理有限责任公司', '75846000', '542999935', '华安未来资产管理(上海)有限公司', '12', '27510300'}",1924836,4,"{'199999881', '551400420', '542999935', '295999504'}",7,"{'平安大华基金管理有限公司', '现金', '定价', '财通基金管理有限公司', '中国银河证券股份有限公司', '泰康资产管理有限责任公司', '12'}",14,"{'平安大华基金管理有限公司', '现金', '40715200', '30206300', '定价', '财通基金管理有限公司', '中国银河证券股份有限公司', '219599801', '74690500', '泰康资产管理有限责任公司', '75846000', '华安未来资产管理(上海)有限公司', '12', '27510300'}"
5,"{'现金', '67655240', '定价', '1194115000', '当代科技'}",16861474,2,"{'1194115000', '67655240'}",3,"{'定价', '当代科技', '现金'}",3,"{'定价', '当代科技', '现金'}"
11,"{'3800000', '高歌平', '现金', '深圳华强投资担保有限公司', '3500000', '中山市联成投资有限公司', '4600000', '博时基金管理有限公司', '上海天誉投资管理公司', '12', '6480000'}",1079794,3,"{'中山市联成投资有限公司', '3500000', '6480000'}",5,"{'深圳华强投资担保有限公司', '现金', '高歌平', '博时基金管理有限公司', '12'}",8,"{'3800000', '高歌平', '深圳华强投资担保有限公司', '现金', '4600000', '博时基金管理有限公司', '上海天誉投资管理公司', '12'}"
6,"{'799999958.3', '现金', '湖南老百姓医药投资管理有限公司', '定价', '17945266', '36'}",16923565,2,"{'799999958.3', '定价'}",3,"{'现金', '湖南老百姓医药投资管理有限公司', '36'}",4,"{'17945266', '现金', '湖南老百姓医药投资管理有限公司', '36'}"
9,"{'金花投资控股集团有限公司', '现金', '10099999.42', '定价', '1076759', '66897654', '金花1号定向资产管理计划', '627499994.5', '36'}",20212396,0,set(),4,"{'金花投资控股集团有限公司', '定价', '现金', '36'}",9,"{'金花投资控股集团有限公司', '现金', '10099999.42', '定价', '1076759', '66897654', '金花1号定向资产管理计划', '627499994.5', '36'}"
23,"{'108999999.2', '20652173', '国寿安保基金管理有限公司', '上海长江财富资产管理有限公司', '申万菱信基金管理有限公司', '现金', '定价', '财通基金管理有限公司', '8152173', '11847826', '49400025.6', '189999991.6', '7934782', '72599996.8', '156999996.4', '74999991.6', '东海基金管理有限责任公司', '72999994.4', '5369568', '长信基金管理有限责任公司', '7891304', '第一创业证券股份有限公司', '17065217'}",1893971,0,set(),9,"{'现金', '第一创业证券股份有限公司', '国寿安保基金管理有限公司', '定价', '上海长江财富资产管理有限公司', '财通基金管理有限公司', '东海基金管理有限责任公司', '申万菱信基金管理有限公司', '长信基金管理有限责任公司'}",23,"{'108999999.2', '20652173', '国寿安保基金管理有限公司', '上海长江财富资产管理有限公司', '申万菱信基金管理有限公司', '现金', '定价', '财通基金管理有限公司', '8152173', '11847826', '49400025.6', '189999991.6', '7934782', '72599996.8', '156999996.4', '74999991.6', '东海基金管理有限责任公司', '72999994.4', '5369568', '长信基金管理有限责任公司', '7891304', '第一创业证券股份有限公司', '17065217'}"
6,"{'牛奶有限公司', '现金', '5691703276', '竞价', '813100468', '36'}",1572968,2,"{'5691703276', '竞价'}",3,"{'现金', '牛奶有限公司', '36'}",4,"{'813100468', '牛奶有限公司', '现金', '36'}"
25,"{'北京康海天达科技有限公司', '5300000', '72239569.6', '6000000', '5000000', '现金', '新华基金管理有限公司', '81400000', '工银瑞信基金管理有限公司', '北京泰腾博越资本管理中心(有限合伙)', '西部证券股份有限公司', '4600000', '中国银河投资管理有限公司', '竞价', '12063480', '信达澳银基金管理有限公司', '97680000', '4437320', '北京华创智业投资有限公司', '申银万国证券股份有限公司', '74888000', '北京郁金香股权投资中心(有限合伙)', '86284000', '741000', '12'}",1093088,1,{'竞价'},6,"{'现金', '北京康海天达科技有限公司', '中国银河投资管理有限公司', '北京华创智业投资有限公司', '申银万国证券股份有限公司', '12'}",24,"{'北京康海天达科技有限公司', '5300000', '72239569.6', '6000000', '5000000', '现金', '新华基金管理有限公司', '81400000', '工银瑞信基金管理有限公司', '北京泰腾博越资本管理中心(有限合伙)', '西部证券股份有限公司', '4600000', '中国银河投资管理有限公司', '12063480', '信达澳银基金管理有限公司', '97680000', '4437320', '北京华创智业投资有限公司', '申银万国证券股份有限公司', '74888000', '北京郁金香股权投资中心(有限合伙)', '86284000', '741000', '12'}"
22,"{'2774663', '14000082.72', '现金', '12', '竞价', '上海小村资产管理有限公司', '宝盈基金管理有限公司', '392379', '127999966.2', '5325112', '1681614', '189999996.2', '3587443', '富国基金管理有限公司', '深圳市江河资本管理有限公司', '138999967.5', '3895739', '上海财通资产管理有限公司', '59999987.52', '张德华', '98999975.84', '36'}",6545128,2,"{'竞价', '189999996.2'}",9,"{'现金', '12', '上海财通资产管理有限公司', '上海小村资产管理有限公司', '张德华', '宝盈基金管理有限公司', '深圳市江河资本管理有限公司', '富国基金管理有限公司', '36'}",20,"{'36', '现金', '5325112', '1681614', '2774663', '上海财通资产管理有限公司', '59999987.52', '392379', '14000082.72', '3587443', '上海小村资产管理有限公司', '深圳市江河资本管理有限公司', '宝盈基金管理有限公司', '张德华', '98999975.84', '138999967.5', '富国基金管理有限公司', '12', '127999966.2', '3895739'}"
6,"{'20000000', '36', '现金', '刘磅', '27000000', '贾虹'}",344214,0,set(),4,"{'现金', '贾虹', '刘磅', '36'}",6,"{'20000000', '36', '现金', '刘磅', '27000000', '贾虹'}"
4,"{'69370629', '现金', '上海中能', '36'}",1849788,1,{'69370629'},3,"{'现金', '上海中能', '36'}",3,"{'现金', '上海中能', '36'}"
6,"{'现金', '587199992.8', '定价', '北京有色金属研究总院', '36', '60349434'}",1192001,0,set(),4,"{'定价', '现金', '北京有色金属研究总院', '36'}",6,"{'现金', '587199992.8', '定价', '北京有色金属研究总院', '36', '60349434'}"
14,"{'金鹰基金管理有限公司', '1736111', '现金', '2430555', '3333333', '兴业财富资产管理有限公司', '博时基金管理有限公司', '7152777', '君禾股权投资基金管理(上海)有限公司', '竞价', '277780', '天治基金管理有限公司', '12', '泓德基金管理有限公司'}",14765157,1,{'竞价'},2,"{'现金', '12'}",13,"{'金鹰基金管理有限公司', '1736111', '现金', '2430555', '3333333', '兴业财富资产管理有限公司', '博时基金管理有限公司', '7152777', '君禾股权投资基金管理(上海)有限公司', '277780', '天治基金管理有限公司', '12', '泓德基金管理有限公司'}"
20,"{'南京瑞森投资管理合伙企业(有限合伙)', '13144058', '兴业全球基金管理有限公司', '249999992.7', '26288117', '无锡坤然股权投资企业(有限合伙)', '财通基金管理有限公司', '国联安基金管理有限公司', '易方达基金管理有限公司', '141999991.5', '竞价', '199999997.9', '14931650', '王世忱', '国泰基金管理有限公司', '8723461', '124999991.6', '82960114.11', '12', '21030494'}",347068,4,"{'249999992.7', '124999991.6', '竞价', '82960114.11'}",7,"{'兴业全球基金管理有限公司', '国联安基金管理有限公司', '财通基金管理有限公司', '易方达基金管理有限公司', '国泰基金管理有限公司', '王世忱', '12'}",16,"{'南京瑞森投资管理合伙企业(有限合伙)', '13144058', '兴业全球基金管理有限公司', '26288117', '无锡坤然股权投资企业(有限合伙)', '财通基金管理有限公司', '国联安基金管理有限公司', '易方达基金管理有限公司', '141999991.5', '199999997.9', '国泰基金管理有限公司', '14931650', '王世忱', '8723461', '12', '21030494'}"
17,"{'20000000', '143100000', '现金', '国开泰富', '431000000', '350000000', '240000000', '15587008', '王云友', '16241299', '润晖香港', '6640371', '11136890', '兴证资管', '中关村国盛', '36', '335900000'}",319392,9,"{'20000000', '143100000', '431000000', '350000000', '15587008', '16241299', '6640371', '11136890', '335900000'}",7,"{'现金', '国开泰富', '王云友', '润晖香港', '兴证资管', '中关村国盛', '36'}",8,"{'现金', '国开泰富', '240000000', '王云友', '润晖香港', '兴证资管', '中关村国盛', '36'}"
3,"{'定价', '浙江宏润控股有限公司', '36'}",1383177,0,set(),3,"{'定价', '浙江宏润控股有限公司', '36'}",3,"{'定价', '浙江宏润控股有限公司', '36'}"
12,"{'财通基金-富春72号资产管理计划', '现金', '宏图瑞利', '6810000', '定价', '兴业基金管理的兴全定增61号特定多客户资产管理计划', '兴全定增62号特定多客户资产管理计划', '7230000', '14050000', '财通基金管理的财通基金-富春71号资产管理计划', '36', '7440000'}",91712,8,"{'6810000', '兴业基金管理的兴全定增61号特定多客户资产管理计划', '兴全定增62号特定多客户资产管理计划', '7440000', '14050000', '财通基金管理的财通基金-富春71号资产管理计划', '财通基金-富春72号资产管理计划', '7230000'}",4,"{'36', '定价', '宏图瑞利', '现金'}",4,"{'现金', '定价', '宏图瑞利', '36'}"
28,"{'合众建能', '欧擎北能', '欧擎北源', '西域红业', '中新建招商', '中节新能', '中国节能', '招商局银科', '14953288', '32613638', '12890766', '山南锦龙', '23074471', '中核投资', '18047072', '蹈德咏仁', '谦德咏仁', '深圳华禹', '西证阳光', '408278920', '34705908', '20625225', '4957987', '沃乾润', '4898491', '35320699', '25781532', '邦信资产'}",1974510,8,"{'20625225', '4957987', '14953288', '4898491', '32613638', '12890766', '18047072', '408278920'}",16,"{'谦德咏仁', '欧擎北能', '合众建能', '欧擎北源', '沃乾润', '西域红业', '招商局银科', '中新建招商', '深圳华禹', '中节新能', '中核投资', '西证阳光', '中国节能', '邦信资产', '山南锦龙', '蹈德咏仁'}",20,"{'34705908', '谦德咏仁', '欧擎北能', '合众建能', '欧擎北源', '沃乾润', '西域红业', '招商局银科', '中新建招商', '深圳华禹', '中节新能', '中核投资', '35320699', '西证阳光', '中国节能', '23074471', '25781532', '邦信资产', '山南锦龙', '蹈德咏仁'}"
5,"{'现金', '105081081', '周世平', '36', '972000000'}",2230904,1,{'972000000'},3,"{'现金', '36', '周世平'}",4,"{'现金', '36', '105081081', '周世平'}"
5,"{'定价', '许继集团', '180464606', '股权', '36'}",904006,1,{'180464606'},4,"{'许继集团', '定价', '股权', '36'}",4,"{'许继集团', '定价', '股权', '36'}"
20,"{'199999998.5', '华夏人寿保险股份有限公司', '138999999.6', '118152319', '49523809', '376999997.9', '44444444', '139999998.6', '44126984', '财通基金管理有限公司', '重庆骏旺投资咨询有限公司', '372179804.9', '竞价', '155999998.4', '119682539', '江海证券有限公司', '建信基金管理有限责任公司', '63492063', '汇添富基金管理股份有限公司', '12'}",358149,6,"{'199999998.5', '118152319', '376999997.9', '竞价', '155999998.4', '372179804.9'}",7,"{'华夏人寿保险股份有限公司', '财通基金管理有限公司', '重庆骏旺投资咨询有限公司', '建信基金管理有限责任公司', '江海证券有限公司', '汇添富基金管理股份有限公司', '12'}",14,"{'138999999.6', '华夏人寿保险股份有限公司', '49523809', '44444444', '139999998.6', '44126984', '财通基金管理有限公司', '重庆骏旺投资咨询有限公司', '119682539', '江海证券有限公司', '建信基金管理有限责任公司', '63492063', '汇添富基金管理股份有限公司', '12'}"
5,"{'900000000', '现金', '竞价', '北京燕京啤酒有限公司', '36'}",808652,1,{'900000000'},4,"{'北京燕京啤酒有限公司', '竞价', '现金', '36'}",4,"{'北京燕京啤酒有限公司', '竞价', '现金', '36'}"
33,"{'泰生鸿明', '天安财险', '70000000', '337142857', '36960000', '2076800000', '6000000', '5000000', '现金', '40000000', '90379870', '214204545', '定价', '130000000', '616000000', '1319500000', '兴隆18号资管计划', '800800000', '30000000', '431200000', '30800000', '丰信管理', '信利隆科技', '有为管理', '君承投资', '兴隆17号资管计划', '246400000', '184800000', '100000000', '556740000', '德勤贸易', '龙跃投资', '36'}",1684886,17,"{'184800000', '30800000', '90379870', '214204545', '100000000', '70000000', '337142857', '130000000', '36960000', '2076800000', '616000000', '1319500000', '556740000', '800800000', '30000000', '431200000', '246400000'}",11,"{'现金', '泰生鸿明', '天安财险', '丰信管理', '定价', '信利隆科技', '德勤贸易', '有为管理', '君承投资', '龙跃投资', '36'}",16,"{'6000000', '现金', '40000000', '5000000', '泰生鸿明', '兴隆17号资管计划', '天安财险', '定价', '丰信管理', '信利隆科技', '德勤贸易', '有为管理', '君承投资', '龙跃投资', '兴隆18号资管计划', '36'}"
21,"{'何建东', '23912005', '40866302', '现金', '兴业全球基金管理有限公司', '24249658', '定价', '24283765', '财通基金管理有限公司', '德邦基金管理有限公司', '平安大华基金管理有限公司', '28738062', '北信瑞丰基金管理有限公司', '国华人寿保险股份有限公司', '20359486', '九泰基金管理有限公司', '25238744', '27285129', '兴证证券资产管理有限公司', '24181446', '12'}",14784379,0,set(),7,"{'现金', '兴证证券资产管理有限公司', '兴业全球基金管理有限公司', '何建东', '定价', '国华人寿保险股份有限公司', '12'}",21,"{'何建东', '23912005', '40866302', '现金', '兴业全球基金管理有限公司', '24249658', '定价', '24283765', '财通基金管理有限公司', '德邦基金管理有限公司', '平安大华基金管理有限公司', '28738062', '北信瑞丰基金管理有限公司', '国华人寿保险股份有限公司', '20359486', '九泰基金管理有限公司', '25238744', '27285129', '兴证证券资产管理有限公司', '24181446', '12'}"
20,"{'平安大华基金管理有限公司', '太平洋资产管理有限责任公司', '179999970.6', '现金', '北京基业华商投资管理中心(有限合伙)', '3118316', '安徽省铁路建设投资基金有限公司', '定价', '国华人寿保险股份有限公司', '199999994.7', '财通基金管理有限公司', '678799984.9', '22003241', '6482982', '上海原点资产管理有限公司', '5834683', '96200048.6', '164999991', '5348460', '12'}",1834083,2,"{'678799984.9', '179999970.6'}",9,"{'平安大华基金管理有限公司', '太平洋资产管理有限责任公司', '现金', '安徽省铁路建设投资基金有限公司', '国华人寿保险股份有限公司', '定价', '财通基金管理有限公司', '上海原点资产管理有限公司', '12'}",18,"{'平安大华基金管理有限公司', '太平洋资产管理有限责任公司', '3118316', '北京基业华商投资管理中心(有限合伙)', '现金', '安徽省铁路建设投资基金有限公司', '定价', '国华人寿保险股份有限公司', '199999994.7', '财通基金管理有限公司', '22003241', '6482982', '上海原点资产管理有限公司', '5834683', '96200048.6', '164999991', '5348460', '12'}"
10,"{'金鹰基金管理有限公司', '13000000', '13600000', '15000000', '中国长城资产管理公司', '竞价', '18400000', '泰达宏利基金管理有限公司', '常州产业投资集团有限公司', '12'}",4920399,2,"{'竞价', '13600000'}",5,"{'金鹰基金管理有限公司', '中国长城资产管理公司', '泰达宏利基金管理有限公司', '常州产业投资集团有限公司', '12'}",8,"{'金鹰基金管理有限公司', '13000000', '15000000', '中国长城资产管理公司', '18400000', '泰达宏利基金管理有限公司', '常州产业投资集团有限公司', '12'}"
4,"{'现金', '竞价', '程宗玉', '36'}",15653894,0,set(),4,"{'36', '竞价', '程宗玉', '现金'}",4,"{'现金', '竞价', '程宗玉', '36'}"
4,"{'36', '仪电集团', '58000000', '498800000'}",1314025,2,"{'58000000', '498800000'}",2,"{'仪电集团', '36'}",2,"{'仪电集团', '36'}"
25,"{'上海安霞', '110200000', '34629634', '嘉实基金', '现金', '25186584.68', '定价', '瑞和祥华', '120997748.6', '南翔资产', '中邮基金', '10000000', '15905000', '398924000', '672220000', '光控安宇', '61000000', '嘉定建业', '卫保川', '381618566.7', '36200000', '2285534', '175273100', '10979832', '36'}",1683210,2,"{'381618566.7', '25186584.68'}",11,"{'现金', '上海安霞', '定价', '瑞和祥华', '南翔资产', '光控安宇', '嘉实基金', '中邮基金', '嘉定建业', '卫保川', '36'}",23,"{'上海安霞', '110200000', '34629634', '嘉实基金', '现金', '定价', '瑞和祥华', '120997748.6', '南翔资产', '中邮基金', '10000000', '15905000', '398924000', '672220000', '光控安宇', '61000000', '嘉定建业', '卫保川', '36200000', '2285534', '175273100', '10979832', '36'}"
4,"{'竞价', '现金', '华峰集团', '36'}",1021914,0,set(),4,"{'竞价', '现金', '华峰集团', '36'}",4,"{'竞价', '现金', '华峰集团', '36'}"
25,"{'178999503', '1600000757', '309999925', '泰达宏利基金管理有限公司', '太平洋证券股份有限公司', '现金', '159998975', '竞价', '诺德基金管理有限公司', '深圳市南方同正投资有限公司', '13082500', '130825900', '14636100', '36', '129852025', '12767700', '156148971', '464999276', '金鹰基金管理有限公司', '38021200', '新华基金管理股份有限公司', '10617500', '金元顺安基金管理有限公司', '12', '25347500'}",14663359,1,{'竞价'},10,"{'金鹰基金管理有限公司', '现金', '12', '新华基金管理股份有限公司', '金元顺安基金管理有限公司', '泰达宏利基金管理有限公司', '诺德基金管理有限公司', '深圳市南方同正投资有限公司', '36', '太平洋证券股份有限公司'}",24,"{'178999503', '1600000757', '309999925', '泰达宏利基金管理有限公司', '太平洋证券股份有限公司', '现金', '159998975', '诺德基金管理有限公司', '深圳市南方同正投资有限公司', '13082500', '130825900', '14636100', '36', '129852025', '12767700', '156148971', '464999276', '金鹰基金管理有限公司', '38021200', '新华基金管理股份有限公司', '10617500', '金元顺安基金管理有限公司', '12', '25347500'}"
27,"{'深圳市创新投资集团有限公司', '广发基金管理有限公司', '青岛嘉豪投资企业(有限合伙)', '海通证券股份有限公司', '15200000', '13200000', '163215000', '35100000', '65100000', '兴业全球基金管理有限公司', '14000000', '76260000', '竞价', '19300000', '8370000', '89745000', '16400000', '69750000', '15000000', '1800000', '中信证券股份有限公司', '70680000', '国联证券股份有限公司-国联汇融8号定向资产管理计划', '北京华山弘业股权投资基金(有限合伙)', '融通基金管理有限公司', '61380000', '12'}",1136849,11,"{'163215000', '65100000', '69750000', '北京华山弘业股权投资基金(有限合伙)', '76260000', '61380000', '竞价', '8370000', '70680000', '89745000', '15200000'}",3,"{'广发基金管理有限公司', '12', '兴业全球基金管理有限公司'}",16,"{'35100000', '国联证券股份有限公司-国联汇融8号定向资产管理计划', '兴业全球基金管理有限公司', '深圳市创新投资集团有限公司', '14000000', '15000000', '融通基金管理有限公司', '1800000', '广发基金管理有限公司', '青岛嘉豪投资企业(有限合伙)', '海通证券股份有限公司', '中信证券股份有限公司', '19300000', '12', '13200000', '16400000'}"
28,"{'6795608', '学思投资', '20125457', '科劲投资', '紫光育才', '现金', '544999983.8', '129999981', '1568217', '谷多投资', '银润投资首期1号员工持股计划', '269999997.4', '28489283', '36', '74751698', '29999991.21', '乐耘投资', '384999992.4', '14113957', '乐金兄弟', '10454783', '106638787', '2039999995', '健坤长青', '长城嘉信', '1429999983', '199999998.8', '国研宝业'}",14212024,4,"{'29999991.21', '544999983.8', '1429999983', '199999998.8'}",11,"{'学思投资', '现金', '健坤长青', '乐耘投资', '长城嘉信', '科劲投资', '紫光育才', '谷多投资', '36', '乐金兄弟', '国研宝业'}",24,"{'6795608', '学思投资', '20125457', '科劲投资', '紫光育才', '现金', '129999981', '1568217', '谷多投资', '银润投资首期1号员工持股计划', '269999997.4', '28489283', '74751698', '乐耘投资', '384999992.4', '14113957', '乐金兄弟', '10454783', '106638787', '2039999995', '健坤长青', '长城嘉信', '36', '国研宝业'}"
19,"{'1348920', '现金', '270000000', '12140287', '梁桂秋', '100000000', '朱蘅', '449640', '定价', '太平洋资管', '张成华', '101535000', '4496402', '4565422', '飞晟投资', '10000000', '尚阳投资', '30000000', '36'}",357879,5,"{'270000000', '100000000', '101535000', '10000000', '30000000'}",9,"{'现金', '太平洋资管', '朱蘅', '梁桂秋', '定价', '张成华', '飞晟投资', '尚阳投资', '36'}",14,"{'1348920', '现金', '朱蘅', '12140287', '梁桂秋', '449640', '太平洋资管', '定价', '张成华', '4496402', '4565422', '飞晟投资', '尚阳投资', '36'}"
30,"{'324291896.1', '14323847', '长城国融投资管理有限公司', '国寿安保基金管理有限公司', '中信建投基金管理有限公司', '申万菱信基金管理有限公司', '泰达宏利基金管理有限公司', '700095497.4', '现金', '64743374', '12', '定价', '1465789987', '财通基金管理有限公司', '青岛城投金融控股集团有限公司', '信达新兴财富(北京)资产管理有限公司', '33126015', '30928816', '30928312', '700228394.2', '950129982.1', '31319787', '招商财富资产管理有限公司', '30927310', '749972979.6', '709079977.7', '700216983.7', '700194298.4', '41966872', '30922946'}",1876423,4,"{'324291896.1', '709079977.7', '950129982.1', '700216983.7'}",11,"{'招商财富资产管理有限公司', '现金', '长城国融投资管理有限公司', '国寿安保基金管理有限公司', '定价', '财通基金管理有限公司', '中信建投基金管理有限公司', '青岛城投金融控股集团有限公司', '申万菱信基金管理有限公司', '泰达宏利基金管理有限公司', '12'}",26,"{'14323847', '长城国融投资管理有限公司', '国寿安保基金管理有限公司', '中信建投基金管理有限公司', '申万菱信基金管理有限公司', '泰达宏利基金管理有限公司', '700095497.4', '现金', '64743374', '12', '定价', '1465789987', '财通基金管理有限公司', '青岛城投金融控股集团有限公司', '信达新兴财富(北京)资产管理有限公司', '33126015', '30928816', '30928312', '700228394.2', '31319787', '招商财富资产管理有限公司', '30927310', '749972979.6', '700194298.4', '41966872', '30922946'}"
16,"{'现金', '23419204', '北信瑞丰基金管理有限公司', '2341921', '11709602', '郭仁祥', '兴证资管鑫众—吉艾科技1号定向资产管理计划', '定价', '100000000', '250000000', '50000000', '500000000', '宋新军', '4683840', '南通元鼎投资有限公司', '36'}",1656166,4,"{'100000000', '250000000', '50000000', '500000000'}",7,"{'现金', '北信瑞丰基金管理有限公司', '郭仁祥', '定价', '宋新军', '南通元鼎投资有限公司', '36'}",12,"{'现金', '23419204', '北信瑞丰基金管理有限公司', '2341921', '11709602', '郭仁祥', '兴证资管鑫众—吉艾科技1号定向资产管理计划', '定价', '宋新军', '4683840', '南通元鼎投资有限公司', '36'}"
17,"{'兵器财务有限责任公司', '32700000', '13000000', '定价', '上海中创信实业投资有限公司', '雅戈尔投资有限公司', '9734426', '新世界策略(北京)投资顾问有限公司', '32800000', '10000000', '39300000', '航天科技财务有限责任公司', '中财明远投资管理有限公司', '深圳市平安创新资本投资有限公司', '12', '江苏汇鸿国际集团有限公司', '16400000'}",58502,1,{'定价'},1,{'12'},16,"{'兵器财务有限责任公司', '32700000', '13000000', '上海中创信实业投资有限公司', '雅戈尔投资有限公司', '9734426', '新世界策略(北京)投资顾问有限公司', '32800000', '10000000', '39300000', '航天科技财务有限责任公司', '中财明远投资管理有限公司', '深圳市平安创新资本投资有限公司', '12', '江苏汇鸿国际集团有限公司', '16400000'}"
12,"{'132450300', '60', '定价', '中国烟草总公司', '中国烟草总公司广东省公司', '99337700', '阳光控股有限公司', '496688700', '福建省财政厅', '430463500', '中国烟草总公司福建省公司', '36'}",15921310,2,"{'132450300', '99337700'}",8,"{'60', '定价', '中国烟草总公司', '阳光控股有限公司', '中国烟草总公司福建省公司', '福建省财政厅', '中国烟草总公司广东省公司', '36'}",10,"{'定价', '60', '中国烟草总公司', '阳光控股有限公司', '中国烟草总公司广东省公司', '496688700', '福建省财政厅', '430463500', '中国烟草总公司福建省公司', '36'}"
12,"{'5000000', '现金', '陶雷', '定价', '18000000', '黄舒敏', '50000000', '高壹名', '北京古茂投资管理中心(有限合伙)', '黄宇', '36', '105571428'}",397327,3,"{'18000000', '50000000', '105571428'}",7,"{'现金', '陶雷', '定价', '黄舒敏', '高壹名', '黄宇', '36'}",9,"{'5000000', '现金', '陶雷', '定价', '黄舒敏', '高壹名', '北京古茂投资管理中心(有限合伙)', '黄宇', '36'}"
29,"{'深圳名正', '上海喜待', '上海爽达', '39682539', '130277495', '79365079', '玉环捷瑞', '宁波裕盛', '现金', '643000000', '630000000', '北京天晟', '定价', '300000000', '上海哲萱', '宁波雨博', '820748200', '宁波骏和', '92063492', '102063492', '111111111', '580000000', '100000000', '47619047', '宁波万福', '700000000', '250000000', '500000000', '36'}",4936021,8,"{'580000000', '643000000', '630000000', '250000000', '700000000', '300000000', '500000000', '820748200'}",13,"{'宁波裕盛', '现金', '深圳名正', '北京天晟', '宁波骏和', '上海喜待', '定价', '宁波雨博', '宁波万福', '上海爽达', '上海哲萱', '玉环捷瑞', '36'}",21,"{'深圳名正', '上海喜待', '上海爽达', '39682539', '130277495', '79365079', '玉环捷瑞', '宁波裕盛', '现金', '北京天晟', '定价', '上海哲萱', '宁波雨博', '宁波骏和', '92063492', '102063492', '111111111', '100000000', '47619047', '宁波万福', '36'}"
18,"{'12000000', '8500000', '现金', '昆明盈鑫叁玖投资中心(有限合伙)', '兴业全球基金管理有限公司', '9100000', '新华人寿保险股份有限公司', '7400000', '定价', '7000000', '11000000', '天津晟乾鸿典股权投资基金合伙企业(有限合伙)', '南方基金管理有限公司', '上海混沌投资(集团)有限公司', '泰康资产管理有限责任公司', '华宝投资有限公司', '8000000', '12'}",161390,3,"{'7400000', '11000000', '8500000'}",8,"{'现金', '新华人寿保险股份有限公司', '兴业全球基金管理有限公司', '定价', '南方基金管理有限公司', '泰康资产管理有限责任公司', '华宝投资有限公司', '12'}",15,"{'12000000', '昆明盈鑫叁玖投资中心(有限合伙)', '现金', '兴业全球基金管理有限公司', '9100000', '新华人寿保险股份有限公司', '定价', '7000000', '天津晟乾鸿典股权投资基金合伙企业(有限合伙)', '南方基金管理有限公司', '上海混沌投资(集团)有限公司', '泰康资产管理有限责任公司', '华宝投资有限公司', '8000000', '12'}"
5,"{'224524100', '现金', '竞价', '华友投资', '36'}",2359495,1,{'224524100'},4,"{'竞价', '现金', '华友投资', '36'}",4,"{'竞价', '现金', '华友投资', '36'}"
13,"{'1990049', '兴证证券资产管理有限公司', '浙江浙商证券资产管理有限公司', '101754385', '4975124', '12', '663351', '财通基金管理有限公司', '995024', '三胞集团有限公司', '国投瑞银基金管理有限公司', '36', '泓德基金管理有限公司'}",1823480,0,set(),7,"{'兴证证券资产管理有限公司', '浙江浙商证券资产管理有限公司', '财通基金管理有限公司', '三胞集团有限公司', '国投瑞银基金管理有限公司', '12', '泓德基金管理有限公司'}",13,"{'1990049', '兴证证券资产管理有限公司', '浙江浙商证券资产管理有限公司', '101754385', '4975124', '12', '663351', '财通基金管理有限公司', '995024', '三胞集团有限公司', '国投瑞银基金管理有限公司', '36', '泓德基金管理有限公司'}"
12,"{'中再资产管理股份有限公司', '华安基金管理有限公司', '工银瑞信基金管理有限公司', '4000000', '竞价', '3000000', '9800000', '富国基金管理有限公司', '1250000', '6000000', '新理益集团有限公司', '12'}",821753,2,"{'竞价', '1250000'}",6,"{'中再资产管理股份有限公司', '华安基金管理有限公司', '工银瑞信基金管理有限公司', '富国基金管理有限公司', '新理益集团有限公司', '12'}",10,"{'中再资产管理股份有限公司', '华安基金管理有限公司', '工银瑞信基金管理有限公司', '4000000', '9800000', '3000000', '富国基金管理有限公司', '6000000', '新理益集团有限公司', '12'}"
15,"{'12000000', '5000000', '深圳市东融投资发展有限公司', '现金', '中融国际信托有限公司', '光大证券股份有限公司', '4000000', '定价', '苏州工业园区海富投资有限公司', '南京金陶房地产有限公司', '江苏宝鼎投资担保有限公司', '深圳市河东基业投资有限公司', '3000000', '1000000', '12'}",547835,1,{'定价'},2,"{'现金', '12'}",14,"{'12000000', '5000000', '深圳市东融投资发展有限公司', '光大证券股份有限公司', '中融国际信托有限公司', '现金', '4000000', '南京金陶房地产有限公司', '苏州工业园区海富投资有限公司', '江苏宝鼎投资担保有限公司', '深圳市河东基业投资有限公司', '3000000', '1000000', '12'}"
17,"{'南京瑞森投资管理合伙企业(有限合伙)', '40000000', '16000000', '165000000', '88000000', '国华人寿保险股份有限公司', '18000000', '财通基金管理有限公司', '30000000', '220000000', '99000000', '竞价', '227975000', '宝盈基金管理有限公司', '41450000', '汇添富基金管理股份有限公司', '12'}",649487,8,"{'165000000', '88000000', '18000000', '220000000', '99000000', '竞价', '227975000', '41450000'}",5,"{'国华人寿保险股份有限公司', '财通基金管理有限公司', '宝盈基金管理有限公司', '汇添富基金管理股份有限公司', '12'}",9,"{'南京瑞森投资管理合伙企业(有限合伙)', '40000000', '16000000', '国华人寿保险股份有限公司', '财通基金管理有限公司', '30000000', '宝盈基金管理有限公司', '汇添富基金管理股份有限公司', '12'}"
4,"{'东盛和投资', '竞价', '现金', '36'}",2369189,0,set(),4,"{'东盛和投资', '竞价', '现金', '36'}",4,"{'东盛和投资', '竞价', '现金', '36'}"
4,"{'三林万业(上海)企业集团有限公司', '竞价', '现金', '36'}",310721,1,{'三林万业(上海)企业集团有限公司'},3,"{'竞价', '现金', '36'}",3,"{'竞价', '现金', '36'}"
10,"{'上海证券聚赢定增1号', '吴涛', '前海开源以其成立和管理的前海开源嘉得天晟定增1号', '竞价', '9778067', '1802884', '3004807', '上海证券聚赢定增2号', '上海证券聚赢定增3号', '36'}",2384280,3,"{'前海开源以其成立和管理的前海开源嘉得天晟定增1号', '竞价', '1802884'}",2,"{'吴涛', '36'}",7,"{'上海证券聚赢定增1号', '吴涛', '9778067', '3004807', '上海证券聚赢定增2号', '上海证券聚赢定增3号', '36'}"
29,"{'369999987', '599099987.3', '何建东', '350549993.3', '355499986.3', '23912005', '40866302', '354499998.4', '兴业全球基金管理有限公司', '421299988.9', '24249658', '定价', '24283765', '298470064.8', '财通基金管理有限公司', '德邦基金管理有限公司', '平安大华基金管理有限公司', '北信瑞丰基金管理有限公司', '28738062', '国华人寿保险股份有限公司', '399999991.1', '20359486', '九泰基金管理有限公司', '25238744', '27285129', '兴证证券资产管理有限公司', '24181446', '355999994.9', '12'}",14784380,3,"{'298470064.8', '355499986.3', '354499998.4'}",6,"{'兴证证券资产管理有限公司', '兴业全球基金管理有限公司', '何建东', '定价', '国华人寿保险股份有限公司', '12'}",26,"{'369999987', '599099987.3', '何建东', '350549993.3', '23912005', '40866302', '兴业全球基金管理有限公司', '421299988.9', '24249658', '定价', '24283765', '财通基金管理有限公司', '德邦基金管理有限公司', '平安大华基金管理有限公司', '28738062', '北信瑞丰基金管理有限公司', '国华人寿保险股份有限公司', '399999991.1', '20359486', '九泰基金管理有限公司', '25238744', '27285129', '兴证证券资产管理有限公司', '24181446', '355999994.9', '12'}"
4,"{'竞价', '现金', '36', '国投公司'}",14879062,1,{'竞价'},3,"{'现金', '36', '国投公司'}",3,"{'现金', '36', '国投公司'}"
10,"{'福建华映显示科技有限公司', '厦门建发集团有限公司', '华映视讯(吴江)有限公司', '15873015', '9523809', '47619047', '定价', '华映光电股份有限公司', '79365079', '36'}",1127171,1,{'9523809'},5,"{'福建华映显示科技有限公司', '厦门建发集团有限公司', '定价', '华映光电股份有限公司', '36'}",9,"{'福建华映显示科技有限公司', '厦门建发集团有限公司', '华映视讯(吴江)有限公司', '15873015', '47619047', '定价', '华映光电股份有限公司', '79365079', '36'}"
9,"{'36', '31847133', '仲桂兰', '定价', '郭华', '15923566', '上海红樱资产管理有限公司', '北京富徳昊邦投资中心(有限合伙)', '佛山市科技孵化合伙企业(有限合伙)'}",2324330,1,{'佛山市科技孵化合伙企业(有限合伙)'},5,"{'仲桂兰', '定价', '郭华', '上海红樱资产管理有限公司', '36'}",8,"{'36', '31847133', '仲桂兰', '定价', '郭华', '15923566', '上海红樱资产管理有限公司', '北京富徳昊邦投资中心(有限合伙)'}"
7,"{'现金', '2181004', '定价', '28140000', '财通基金管理有限公司', '长信基金管理有限责任公司', '12'}",534727,1,{'28140000'},3,"{'定价', '现金', '12'}",6,"{'现金', '2181004', '定价', '财通基金管理有限公司', '长信基金管理有限责任公司', '12'}"
15,"{'9056603', '189999991.5', '现金', '鹏华资产管理有限公司', '147999995.8', '新华基金管理股份有限公司', '11169811', '竞价', '苏博', '119999989.8', '145030021.5', '邹月普', '10945662', '12', '14339622'}",16919209,3,"{'竞价', '119999989.8', '147999995.8'}",6,"{'现金', '鹏华资产管理有限公司', '新华基金管理股份有限公司', '苏博', '邹月普', '12'}",12,"{'9056603', '189999991.5', '现金', '鹏华资产管理有限公司', '新华基金管理股份有限公司', '11169811', '苏博', '145030021.5', '邹月普', '10945662', '12', '14339622'}"
4,"{'重庆财信房地产开发有限公司', '现金', '36', '130922693'}",92128,1,{'130922693'},3,"{'重庆财信房地产开发有限公司', '现金', '36'}",3,"{'重庆财信房地产开发有限公司', '现金', '36'}"
4,"{'竞价', '现金', '新筑投资', '36'}",681090,1,{'竞价'},3,"{'现金', '新筑投资', '36'}",3,"{'现金', '新筑投资', '36'}"
15,"{'5000000', '天津凯石兴利股权投资基金合伙企业(有限合伙)', '4500000', '华安基金管理有限公司', '宏源证券股份有限公司', '圳市平安创新资本投资有限公司', '4700000', '博时基金管理有限公司', '易方达基金管理有限公司', '竞价', '天津凯石益金股权投资基金合伙企业(有限合伙)', '7300000', '4200000', '10000000', '12'}",1172078,4,"{'4700000', '竞价', '4200000', '4500000'}",5,"{'华安基金管理有限公司', '宏源证券股份有限公司', '博时基金管理有限公司', '易方达基金管理有限公司', '12'}",11,"{'5000000', '天津凯石兴利股权投资基金合伙企业(有限合伙)', '华安基金管理有限公司', '圳市平安创新资本投资有限公司', '宏源证券股份有限公司', '博时基金管理有限公司', '易方达基金管理有限公司', '天津凯石益金股权投资基金合伙企业(有限合伙)', '7300000', '10000000', '12'}"
10,"{'第一创业证券股份有限公司', '申万菱信(上海)资产管理有限公司', '浙江华侨股权投资管理有限公司', '288184', '竞价', '1582342', '2013684', '张怀斌', '12', '447368'}",103685,4,"{'1582342', '447368', '288184', '2013684'}",5,"{'第一创业证券股份有限公司', '浙江华侨股权投资管理有限公司', '竞价', '张怀斌', '12'}",6,"{'第一创业证券股份有限公司', '申万菱信(上海)资产管理有限公司', '浙江华侨股权投资管理有限公司', '竞价', '张怀斌', '12'}"
5,"{'现金', '52800000', '陈志江', '401280000', '36'}",292744,2,"{'52800000', '401280000'}",3,"{'陈志江', '现金', '36'}",3,"{'陈志江', '现金', '36'}"
13,"{'招商财富资产管理有限公司', '现金', '民生加银基金管理有限公司', '70298769', '新华基金管理有限公司', '华夏基金管理有限公司', '50087873', '天弘基金管理有限公司', '竞价', '22847100', '建信基金管理有限责任公司', '39543057', '12'}",321210,1,{'竞价'},2,"{'现金', '12'}",12,"{'招商财富资产管理有限公司', '新华基金管理有限公司', '民生加银基金管理有限公司', '70298769', '现金', '华夏基金管理有限公司', '50087873', '天弘基金管理有限公司', '22847100', '建信基金管理有限责任公司', '39543057', '12'}"
18,"{'人保资产', '定价', '中国人民保险集团股份有限公司', '中国人民财产保险股份有限公司', '632000000', '1380434400', '中国烟草总公司', '125687300', '中国人民人寿保险股份有限公司', '409025000', '5055549000', '116434400', '17062169184', '1439129184', '1553495028', '上海正阳国际经贸有限公司', '36', '7811520000'}",1262304,8,"{'中国人民保险集团股份有限公司', '125687300', '5055549000', '17062169184', '116434400', '1439129184', '1553495028', '7811520000'}",7,"{'人保资产', '定价', '中国人民财产保险股份有限公司', '中国烟草总公司', '中国人民人寿保险股份有限公司', '上海正阳国际经贸有限公司', '36'}",10,"{'人保资产', '定价', '中国人民财产保险股份有限公司', '632000000', '1380434400', '中国烟草总公司', '409025000', '中国人民人寿保险股份有限公司', '上海正阳国际经贸有限公司', '36'}"
20,"{'融德资产管理有限公司', '8000000', '现金', '5000000', '瑞士银行(UBS AG)', '81250000', '观唐投资控股有限公司', '定价', '48830665', '上海世讯会展服务有限公司', '3004964', '130000000', '上海洪鑫源实业有限公司', '吴轶', '北京同盛行商业投资管理有限公司', '6000000', '无锡市新宝联投资有限公司', '薛非', '12', '97500000'}",1159902,7,"{'瑞士银行(UBS AG)', '定价', '48830665', '3004964', '130000000', '81250000', '97500000'}",10,"{'融德资产管理有限公司', '现金', '观唐投资控股有限公司', '上海世讯会展服务有限公司', '上海洪鑫源实业有限公司', '吴轶', '北京同盛行商业投资管理有限公司', '无锡市新宝联投资有限公司', '薛非', '12'}",13,"{'融德资产管理有限公司', '8000000', '5000000', '现金', '观唐投资控股有限公司', '上海世讯会展服务有限公司', '上海洪鑫源实业有限公司', '吴轶', '北京同盛行商业投资管理有限公司', '6000000', '无锡市新宝联投资有限公司', '薛非', '12'}"
12,"{'现金', '赵小强', '23600000', '2000000', '21190000', '竞价', '杭州比因美特卡通影视有限公司', '95355000', '250042000', '郭瑞', '9000000', '36'}",1688299,1,{'竞价'},5,"{'现金', '赵小强', '杭州比因美特卡通影视有限公司', '郭瑞', '36'}",11,"{'现金', '赵小强', '23600000', '2000000', '21190000', '杭州比因美特卡通影视有限公司', '95355000', '250042000', '郭瑞', '9000000', '36'}"
11,"{'现金', '38303693', '28727770', '41039671', '李庆林', '金牛鹏博', '天泽世纪', '竞价', '71135430', '正弘致远', '36'}",1597990,5,"{'38303693', '28727770', '41039671', '竞价', '71135430'}",6,"{'36', '现金', '金牛鹏博', '天泽世纪', '正弘致远', '李庆林'}",6,"{'现金', '李庆林', '金牛鹏博', '天泽世纪', '正弘致远', '36'}"
5,"{'现金', '李林琳', '21914700', '中农大投资', '36'}",972045,1,{'21914700'},4,"{'36', '现金', '李林琳', '中农大投资'}",4,"{'36', '现金', '李林琳', '中农大投资'}"
24,"{'20000000', '16800000', '67800000', '89496000', '现金', '理成定向4号资产管理计划', '19200000', '兴全定增88号资产管理计划', '兴全定增89号资产管理计划', '52600000', '国泰君安创新投资', '10000000', '银河证券', '50850000', '理成定向5号资产管理计划', '15000000', '65088000', '33900000', '178314000', '26400000', '黄伟国', '董博', '56952000', '36'}",340216,14,"{'20000000', '16800000', '26400000', '67800000', '19200000', '15000000', '65088000', '33900000', '52600000', '10000000', '89496000', '178314000', '56952000', '50850000'}",6,"{'现金', '黄伟国', '国泰君安创新投资', '董博', '银河证券', '36'}",10,"{'现金', '理成定向5号资产管理计划', '理成定向4号资产管理计划', '兴全定增89号资产管理计划', '兴全定增88号资产管理计划', '黄伟国', '国泰君安创新投资', '董博', '银河证券', '36'}"
25,"{'50255000', '48070000', '7000000', '赖朝辉', '93500000', '赖振元', '30590000', '148580000', '兴发新价值2号', '定价', '122500000', '11000000', '兴发新价值4号', '56810000', '兴发龙元定增1号', '34000000', '兴发新价值1号', '赖晔鋆', '408595000', '535325000', '兴发龙元定增2号', '11500000', '13000000', '兴发新价值3号', '36'}",1894719,7,"{'50255000', '56810000', '30590000', '148580000', '48070000', '408595000', '535325000'}",11,"{'兴发龙元定增1号', '兴发新价值2号', '兴发新价值1号', '定价', '兴发龙元定增2号', '赖晔鋆', '赖朝辉', '兴发新价值3号', '兴发新价值4号', '赖振元', '36'}",18,"{'兴发龙元定增1号', '11500000', '34000000', '兴发新价值2号', '兴发新价值1号', '13000000', '兴发龙元定增2号', '赖晔鋆', '7000000', '定价', '122500000', '11000000', '赖朝辉', '兴发新价值3号', '93500000', '兴发新价值4号', '赖振元', '36'}"
14,"{'12400000', '1000000', '世纪阳光控股集团有限公司', '定价', '23000000', '15000000', '深圳华强鼎信担保投资有限公司', '无锡市国联发展(集团)有限公司', '深圳市远致投资有限公司', '3000000', '深圳市福田投资发展公司', '深圳市江南丰投资有限公司', '10000000', '36'}",811824,0,set(),7,"{'世纪阳光控股集团有限公司', '定价', '深圳华强鼎信担保投资有限公司', '深圳市远致投资有限公司', '深圳市福田投资发展公司', '深圳市江南丰投资有限公司', '36'}",14,"{'12400000', '1000000', '世纪阳光控股集团有限公司', '定价', '23000000', '15000000', '深圳华强鼎信担保投资有限公司', '无锡市国联发展(集团)有限公司', '深圳市远致投资有限公司', '3000000', '深圳市福田投资发展公司', '深圳市江南丰投资有限公司', '10000000', '36'}"
15,"{'金鹰基金管理有限公司', '现金', '宝盈基金管理有限公司', '70000000', '张家港市直属公有资产经营有限公司', '中新苏州工业园区城市投资运营有限公司', '苏州物资控股(集团)有限责任公司', '苏州历史文化名城发展集团有限公司', '青岛城投金融控股集团有限公司', '鹏华基金管理有限公司', '19000000', '31000000', '30000000', '12', '江苏省吴中经济技术发展总公司'}",1874799,2,"{'31000000', '19000000'}",5,"{'现金', '张家港市直属公有资产经营有限公司', '青岛城投金融控股集团有限公司', '12', '江苏省吴中经济技术发展总公司'}",13,"{'金鹰基金管理有限公司', '现金', '中新苏州工业园区城市投资运营有限公司', '70000000', '张家港市直属公有资产经营有限公司', '苏州物资控股(集团)有限责任公司', '苏州历史文化名城发展集团有限公司', '青岛城投金融控股集团有限公司', '鹏华基金管理有限公司', '宝盈基金管理有限公司', '30000000', '12', '江苏省吴中经济技术发展总公司'}"
4,"{'中航工业', '竞价', '现金', '36'}",9872953,0,set(),4,"{'中航工业', '竞价', '现金', '36'}",4,"{'中航工业', '竞价', '现金', '36'}"
11,"{'5000000', '现金', '李汉朝', '41240462', '黑五类集团', '5250000', '11000000', '韦清文', '李玉琦', '36', '李汉荣'}",1157224,0,set(),7,"{'李汉朝', '现金', '黑五类集团', '韦清文', '李玉琦', '36', '李汉荣'}",11,"{'5000000', '现金', '李汉朝', '41240462', '黑五类集团', '5250000', '11000000', '韦清文', '李玉琦', '36', '李汉荣'}"
7,"{'现金', '17271157', '长安平安富贵千金净雅资产管理计划', '定价', '25906736', '株洲市国有资产投资控股集团有限公司', '36'}",75051,2,"{'25906736', '17271157'}",5,"{'现金', '株洲市国有资产投资控股集团有限公司', '定价', '长安平安富贵千金净雅资产管理计划', '36'}",5,"{'现金', '株洲市国有资产投资控股集团有限公司', '定价', '长安平安富贵千金净雅资产管理计划', '36'}"
7,"{'白云山', '现金', '5241090', '竞价', '41928721', '阮鸿献', '36'}",18838208,1,{'竞价'},4,"{'白云山', '现金', '36', '阮鸿献'}",6,"{'白云山', '现金', '5241090', '41928721', '阮鸿献', '36'}"
23,"{'21544640', '5815300', '55120000', '60479120', '5300000', '光大金控(上海)投资中心(有限合伙)', '工银瑞信基金管理有限公司', '6160000', '财通基金管理有限公司', '109999760', '5192300', '64064000', '太平资产管理有限公司', '10576900', '兵工财务有限责任公司', '上海证大投资管理有限公司', '62920000', '53999920', '汇添富基金管理有限公司', '金鹰基金管理有限公司', '6050000', '西藏瑞华投资发展有限公司', '2071600'}",1118370,0,set(),1,{'西藏瑞华投资发展有限公司'},23,"{'21544640', '5815300', '55120000', '60479120', '5300000', '光大金控(上海)投资中心(有限合伙)', '工银瑞信基金管理有限公司', '6160000', '财通基金管理有限公司', '109999760', '5192300', '64064000', '太平资产管理有限公司', '10576900', '兵工财务有限责任公司', '上海证大投资管理有限公司', '62920000', '53999920', '汇添富基金管理有限公司', '金鹰基金管理有限公司', '6050000', '西藏瑞华投资发展有限公司', '2071600'}"
5,"{'现金', '101668267', '竞价', '富安公司', '36'}",1260417,2,"{'竞价', '101668267'}",3,"{'现金', '富安公司', '36'}",3,"{'现金', '富安公司', '36'}"
9,"{'71646525', '现金', '长港燃气', '525700000', '定价', '79410876', '474300000', '吉能集团', '36'}",14663932,0,set(),5,"{'现金', '长港燃气', '定价', '吉能集团', '36'}",9,"{'71646525', '现金', '长港燃气', '525700000', '定价', '79410876', '474300000', '吉能集团', '36'}"
4,"{'内蒙古博源控股集团有限公司', '现金', '竞价', '36'}",1808904,0,set(),4,"{'内蒙古博源控股集团有限公司', '现金', '竞价', '36'}",4,"{'内蒙古博源控股集团有限公司', '现金', '竞价', '36'}"
9,"{'国家电网公司', 'DEUTSCHEBANKAKTIENGESELLSCHAFT德意志银行股份有限公司', '现金', '253520393', '定价', '269634462', '267373461', '36', '首钢总公司'}",1393024,0,set(),5,"{'国家电网公司', '现金', '定价', '36', '首钢总公司'}",9,"{'国家电网公司', 'DEUTSCHEBANKAKTIENGESELLSCHAFT德意志银行股份有限公司', '253520393', '现金', '定价', '269634462', '267373461', '36', '首钢总公司'}"
18,"{'云南省工业投资控股集团有限责任公司', '20000000', '现金', '1999999998', '121200000', '云南国鼎投资有限公司', '陈亮', '302600003.6', '定价', '山东中瑞现代物流有限公司', '云南禾溪投资有限公司', '49933994', '181800000', '云南省滇中产业发展集团有限责任公司', '30000000', '36', '云南九天工贸有限公司', '330033003'}",1685106,1,{'山东中瑞现代物流有限公司'},2,"{'现金', '36'}",17,"{'云南省工业投资控股集团有限责任公司', '20000000', '121200000', '1999999998', '陈亮', '云南国鼎投资有限公司', '现金', '302600003.6', '定价', '云南禾溪投资有限公司', '49933994', '181800000', '云南省滇中产业发展集团有限责任公司', '30000000', '36', '云南九天工贸有限公司', '330033003'}"
15,"{'20000000', '12600000', '现金', '中国银河金融控股有限责任公司', '航天科工财务有限责任公司', '中国人保资产管理股份有限公司', '9770000', '浙江天银投资有限公司', '华宝信托有限责任公司', '31600000', '22000000', '中新融创资本管理有限公司', '中国人寿资产管理有限公司', '12700000', '12'}",1505906,2,"{'20000000', '9770000'}",2,"{'现金', '12'}",13,"{'12600000', '现金', '中国银河金融控股有限责任公司', '航天科工财务有限责任公司', '中国人保资产管理股份有限公司', '浙江天银投资有限公司', '华宝信托有限责任公司', '22000000', '31600000', '中新融创资本管理有限公司', '中国人寿资产管理有限公司', '12700000', '12'}"
21,"{'799999993.2', '申万菱信基金管理有限公司', '泰达宏利基金管理有限公司', '166304347', '1529999992', '财通基金管理有限公司', '天安财产保险股份有限公司', '53260869', '竞价', '489999994.8', '北信瑞丰基金管理有限公司', '589000017.2', '博时基金管理有限公司', '64021741', '86956521', '499999999.2', '54347826', '490999998', '53369565', '中信信诚资产管理有限公司', '12'}",1863660,1,{'竞价'},1,{'12'},20,"{'499999999.2', '799999993.2', '北信瑞丰基金管理有限公司', '489999994.8', '589000017.2', '54347826', '博时基金管理有限公司', '泰达宏利基金管理有限公司', '财通基金管理有限公司', '86956521', '天安财产保险股份有限公司', '53260869', '64021741', '490999998', '申万菱信基金管理有限公司', '166304347', '1529999992', '53369565', '中信信诚资产管理有限公司', '12'}"
24,"{'昆明盈鑫壹柒投资中心(有限合伙)', '昆明盈鑫壹捌投资中心(有限合伙)', '昆明盈鑫伍捌投资中心(有限合伙)', '356310000', '424255000', '现金', '定价', '74400000', '74700000', '79100000', '460635000', '昆明盈鑫伍陆投资中心(有限合伙)', '399645000', '66600000', '514135000', '79300000', '423185000', '汇添富基金管理有限公司', '86100000', '398040000', '昆明盈鑫伍叁投资中心(有限合伙)', '96100000', '12', '昆明盈鑫伍肆投资中心(有限合伙)'}",1110890,7,"{'424255000', '514135000', '398040000', '460635000', '423185000', '399645000', '356310000'}",4,"{'现金', '定价', '12', '汇添富基金管理有限公司'}",17,"{'昆明盈鑫壹柒投资中心(有限合伙)', '现金', '昆明盈鑫壹捌投资中心(有限合伙)', '86100000', '定价', '74400000', '74700000', '昆明盈鑫伍捌投资中心(有限合伙)', '昆明盈鑫伍肆投资中心(有限合伙)', '79100000', '昆明盈鑫伍叁投资中心(有限合伙)', '96100000', '79300000', '昆明盈鑫伍陆投资中心(有限合伙)', '12', '汇添富基金管理有限公司', '66600000'}"
30,"{'4724678', '通化吉发智盈投资管理中心', '李一奎', '22629998.08', '787446', '520489993.2', '王鹏', '姚景江', '现金', '定价', '石光', '通化吉祥创赢投资管理中心', '13577987.64', '189865686.9', '5330406', '1211456', '程建秋', '10164116', '726873', '10183495.4', '27863490', '刘殿军', '88256985.04', '81694290.08', '4373356', '99571984.08', '14709491.28', '东宝实业集团', '545155', '36'}",10808670,1,{'189865686.9'},12,"{'姚景江', '现金', '通化吉发智盈投资管理中心', '李一奎', '定价', '程建秋', '石光', '通化吉祥创赢投资管理中心', '东宝实业集团', '刘殿军', '王鹏', '36'}",29,"{'4724678', '通化吉发智盈投资管理中心', '李一奎', '22629998.08', '787446', '520489993.2', '王鹏', '姚景江', '现金', '定价', '石光', '通化吉祥创赢投资管理中心', '13577987.64', '5330406', '1211456', '程建秋', '10164116', '726873', '10183495.4', '27863490', '刘殿军', '88256985.04', '81694290.08', '4373356', '99571984.08', '14709491.28', '东宝实业集团', '545155', '36'}"
8,"{'现金', '中通汽车工业集团有限责任公司', '41390728', '500000000', '山东省国有资产投资控股有限公司', '200000000', '16556291', '36'}",1789247,3,"{'200000000', '山东省国有资产投资控股有限公司', '500000000'}",3,"{'现金', '中通汽车工业集团有限责任公司', '36'}",5,"{'现金', '中通汽车工业集团有限责任公司', '41390728', '16556291', '36'}"
5,"{'现金', '云南冶金集团股份有限公司', '竞价', '516451200', '36'}",1180883,1,{'516451200'},4,"{'36', '竞价', '现金', '云南冶金集团股份有限公司'}",4,"{'36', '竞价', '现金', '云南冶金集团股份有限公司'}"
15,"{'13333333', '现金', '长城资本管理有限公司', '16000000', '正海集团有限公司', '240000000', '18666666', '279999990', '中国长城资产管理公司', '199999995', '240000015', '上海汽车集团股权投资有限公司(上汽投资-颀瑞1号)', '山东省国有资产投资控股有限公司', '16000001', '36'}",2219002,1,{'山东省国有资产投资控股有限公司'},5,"{'长城资本管理有限公司', '现金', '正海集团有限公司', '中国长城资产管理公司', '36'}",14,"{'13333333', '现金', '长城资本管理有限公司', '16000000', '正海集团有限公司', '240000000', '18666666', '279999990', '中国长城资产管理公司', '199999995', '240000015', '上海汽车集团股权投资有限公司(上汽投资-颀瑞1号)', '16000001', '36'}"
6,"{'现金', '中色科金', '百善仁和', '23740913', '94963653', '36'}",117557,2,"{'94963653', '23740913'}",4,"{'百善仁和', '现金', '中色科金', '36'}",4,"{'百善仁和', '现金', '中色科金', '36'}"
26,"{'建信基金管理的建信昆仑资产管理计划', '民生证券', '200000000', '财通资产拟设立的资产管理计划', '现金', '11469158', '泓信资本', '37251655', '竞价', '300000000', '41390728', '124172185', '西证渝富成长', '450000000', '力扬实业', '1511452560', '1500000000', '138547440', '国联证券拟设立的资产管理计划', '16556291', '125120245', '陈卫', '500000000', '24834437', '36', '力帆控股'}",1826339,4,"{'450000000', '竞价', '300000000', '1511452560'}",11,"{'建信基金管理的建信昆仑资产管理计划', '现金', '西证渝富成长', '泓信资本', '陈卫', '力扬实业', '民生证券', '国联证券拟设立的资产管理计划', '36', '财通资产拟设立的资产管理计划', '力帆控股'}",22,"{'建信基金管理的建信昆仑资产管理计划', '民生证券', '200000000', '财通资产拟设立的资产管理计划', '现金', '11469158', '泓信资本', '37251655', '41390728', '124172185', '西证渝富成长', '力扬实业', '1500000000', '国联证券拟设立的资产管理计划', '16556291', '138547440', '125120245', '陈卫', '500000000', '24834437', '36', '力帆控股'}"
17,"{'2222222', '211999968', '泰康人寿保险有限责任公司投连行业配置型投资账户', '现金', '泰康人寿保险有限责任公司-万能-个险万能产品(乙)', '安大略退休金管理委员会', '1277780', '泰康人寿保险有限责任公司-分红-个人分红产品', '46000080', '79999992', '新华基金管理股份有限公司', '华能贵诚信托有限公司', '竞价', '诺远资产管理有限公司', '5888888', '12', '泰康人寿保险有限责任公司投连创新动力型投资账户'}",17964116,0,set(),9,"{'泰康人寿保险有限责任公司投连行业配置型投资账户', '现金', '安大略退休金管理委员会', '新华基金管理股份有限公司', '华能贵诚信托有限公司', '竞价', '诺远资产管理有限公司', '12', '泰康人寿保险有限责任公司投连创新动力型投资账户'}",17,"{'2222222', '211999968', '泰康人寿保险有限责任公司投连行业配置型投资账户', '现金', '泰康人寿保险有限责任公司-万能-个险万能产品(乙)', '安大略退休金管理委员会', '1277780', '泰康人寿保险有限责任公司-分红-个人分红产品', '46000080', '79999992', '新华基金管理股份有限公司', '华能贵诚信托有限公司', '竞价', '诺远资产管理有限公司', '5888888', '12', '泰康人寿保险有限责任公司投连创新动力型投资账户'}"
12,"{'现金', '合肥瀚和', '7500000000', '4500000000', '中电彩虹', '1000000000', '咸阳城投承诺', '竞价', '咸阳金控', '2500000000', '36', '陕西电子'}",15524495,4,"{'4500000000', '2500000000', '1000000000', '7500000000'}",8,"{'36', '现金', '合肥瀚和', '咸阳城投承诺', '竞价', '咸阳金控', '中电彩虹', '陕西电子'}",8,"{'36', '现金', '合肥瀚和', '咸阳城投承诺', '竞价', '咸阳金控', '中电彩虹', '陕西电子'}"
18,"{'现金', '江苏瑞华投资发展有限公司', '78246000', '上海力利投资管理合伙企业(有限合伙)', '定价', '129150000', '18000000', '189000000', '鹰潭宏岭投资管理有限合伙企业', '博弘数君(天津)股权投资基金合伙企业(有限合伙)', '天津凯石益金股权投资基金合伙企业(有限合伙)', '113400000', '周雪钦', '12420000', '20500000', '卜波', '30000000', '12'}",504702,4,"{'113400000', '129150000', '189000000', '78246000'}",7,"{'现金', '江苏瑞华投资发展有限公司', '定价', '鹰潭宏岭投资管理有限合伙企业', '周雪钦', '卜波', '12'}",14,"{'现金', '江苏瑞华投资发展有限公司', '上海力利投资管理合伙企业(有限合伙)', '18000000', '定价', '博弘数君(天津)股权投资基金合伙企业(有限合伙)', '鹰潭宏岭投资管理有限合伙企业', '周雪钦', '天津凯石益金股权投资基金合伙企业(有限合伙)', '12420000', '20500000', '卜波', '30000000', '12'}"
3,"{'36', '278000000', '华菱集团'}",204093,0,set(),2,"{'36', '华菱集团'}",3,"{'36', '278000000', '华菱集团'}"
12,"{'金花集团', '现金', '宏达实业', '100000000', '科瑞集团', '新华联控股', '百步亭集团', '濠吉集团', '300000000', '科甲投资', '200000000', '36'}",408910,1,{'300000000'},9,"{'金花集团', '现金', '宏达实业', '科瑞集团', '新华联控股', '百步亭集团', '濠吉集团', '科甲投资', '36'}",11,"{'金花集团', '现金', '宏达实业', '100000000', '科瑞集团', '新华联控股', '百步亭集团', '濠吉集团', '科甲投资', '200000000', '36'}"
4,"{'36', '现金', '云溪投资', '286671000'}",348466,1,{'286671000'},3,"{'36', '现金', '云溪投资'}",3,"{'36', '现金', '云溪投资'}"
4,"{'36', '定价', '菱石投资', '134752300'}",577386,0,set(),3,"{'定价', '菱石投资', '36'}",4,"{'36', '定价', '菱石投资', '134752300'}"
21,"{'中车金证投资有限公司', '长城基金管理有限公司', '522000037.2', '易方达基金管理有限公司', '前海开源基金管理有限公司', '易方达资产管理有限公司', '现金', '12', '定价', '21197183', '青岛城投金融控股集团有限公司', '406999988.2', '38732394', '36760566', '华融证券股份有限公司', '28661971', '安信基金管理有限责任公司', '21126760', '299999992', '300999998.6', '549999994.8'}",14669851,0,set(),3,"{'定价', '现金', '12'}",21,"{'中车金证投资有限公司', '长城基金管理有限公司', '522000037.2', '易方达基金管理有限公司', '前海开源基金管理有限公司', '易方达资产管理有限公司', '现金', '12', '定价', '21197183', '青岛城投金融控股集团有限公司', '406999988.2', '38732394', '36760566', '华融证券股份有限公司', '28661971', '安信基金管理有限责任公司', '21126760', '299999992', '300999998.6', '549999994.8'}"
13,"{'华能国际电力开发公司', '167000000', '现金', '5000000', '泰康人寿保险股份有限公司', '333000000', '12', '35000000', '60000000', '中国人寿资产管理有限公司', '博时基金管理有限公司—全国社保基金五零一组合', '河北省建设投资公司', '36'}",1375019,0,set(),8,"{'华能国际电力开发公司', '现金', '泰康人寿保险股份有限公司', '12', '中国人寿资产管理有限公司', '博时基金管理有限公司—全国社保基金五零一组合', '河北省建设投资公司', '36'}",13,"{'华能国际电力开发公司', '167000000', '现金', '5000000', '333000000', '12', '35000000', '60000000', '中国人寿资产管理有限公司', '泰康人寿保险股份有限公司', '博时基金管理有限公司—全国社保基金五零一组合', '河北省建设投资公司', '36'}"
11,"{'15455950', '杜宣', '民生加银基金管理有限公司', '创金合信基金管理有限公司', '定价', '23183925', '5873263', '15069551', '中铁宝盈资产管理有限公司', '华融证券股份有限公司', '12'}",14044375,0,set(),7,"{'杜宣', '民生加银基金管理有限公司', '创金合信基金管理有限公司', '定价', '中铁宝盈资产管理有限公司', '华融证券股份有限公司', '12'}",11,"{'15455950', '杜宣', '民生加银基金管理有限公司', '创金合信基金管理有限公司', '定价', '23183925', '5873263', '15069551', '中铁宝盈资产管理有限公司', '华融证券股份有限公司', '12'}"
8,"{'现金', '7772600', '1999112', '董建华', '浙信安享(天津)投资管理中心(有限合伙)', '淄博矿业集团有限责任公司', '36', '4688528'}",1328936,3,"{'1999112', '7772600', '4688528'}",5,"{'36', '现金', '董建华', '淄博矿业集团有限责任公司', '浙信安享(天津)投资管理中心(有限合伙)'}",5,"{'36', '现金', '董建华', '淄博矿业集团有限责任公司', '浙信安享(天津)投资管理中心(有限合伙)'}"
14,"{'25252525', '12626262', '599999994', '199999998', '福建省能源集团有限责任公司', '平安资产管理有限责任公司', '福建省投资开发集团有限责任公司', '福建省汽车工业集团有限公司', '75757575', '25252527', '99999995.04', '200000013.8', '福建省交通运输集团有限责任公司', '36'}",1632564,0,set(),6,"{'福建省能源集团有限责任公司', '平安资产管理有限责任公司', '福建省投资开发集团有限责任公司', '福建省汽车工业集团有限公司', '福建省交通运输集团有限责任公司', '36'}",14,"{'25252525', '12626262', '599999994', '199999998', '福建省能源集团有限责任公司', '平安资产管理有限责任公司', '福建省投资开发集团有限责任公司', '福建省汽车工业集团有限公司', '75757575', '25252527', '99999995.04', '200000013.8', '福建省交通运输集团有限责任公司', '36'}"
5,"{'现金', '定价', '253846153', '上海国之杰投资发展有限公司', '36'}",1685311,0,set(),4,"{'36', '定价', '现金', '上海国之杰投资发展有限公司'}",5,"{'现金', '定价', '253846153', '上海国之杰投资发展有限公司', '36'}"
6,"{'现金', '定价', '150852271', '芯电半导体', '2654999970', '36'}",16299333,1,{'2654999970'},4,"{'定价', '现金', '36', '芯电半导体'}",5,"{'现金', '定价', '150852271', '芯电半导体', '36'}"
9,"{'12', '6827757', '18888643', '24360000', '金元顺安基金管理有限公司', '竞价', '中盛集团有限公司', '泰达宏利基金管理有限公司', '36'}",16870434,1,{'竞价'},5,"{'12', '金元顺安基金管理有限公司', '中盛集团有限公司', '泰达宏利基金管理有限公司', '36'}",8,"{'12', '6827757', '18888643', '24360000', '金元顺安基金管理有限公司', '中盛集团有限公司', '泰达宏利基金管理有限公司', '36'}"
7,"{'现金', '四川恒康', '国艺投资', '阳红彬', '728992200', '海莲投资', '36'}",723480,1,{'728992200'},6,"{'现金', '四川恒康', '国艺投资', '阳红彬', '海莲投资', '36'}",6,"{'现金', '四川恒康', '国艺投资', '阳红彬', '海莲投资', '36'}"
7,"{'现金', '15275040', '华伍员工资管计划', '49977814', '竞价', '聂璐璐', '36'}",2382051,1,{'竞价'},4,"{'华伍员工资管计划', '聂璐璐', '现金', '36'}",6,"{'现金', '15275040', '华伍员工资管计划', '49977814', '聂璐璐', '36'}"
21,"{'12000000', '栗萍', '2550000', '纳爱斯浙江投资有限公司', '5000000', '现金', '谭惠轩', '定价', '凌俊', '11000000', '林纳新', '10000000', '陈昌兰', '3500000', '余岳华', '15000000', '5100000', '山西证券股份有限公司', '贾放平', '白敏莉', '12'}",1198031,3,"{'山西证券股份有限公司', '2550000', '3500000'}",3,"{'定价', '现金', '12'}",18,"{'12000000', '纳爱斯浙江投资有限公司', '陈昌兰', '5100000', '5000000', '现金', '谭惠轩', '余岳华', '凌俊', '15000000', '定价', '11000000', '贾放平', '栗萍', '林纳新', '白敏莉', '10000000', '12'}"
5,"{'定价', '镇江新区经济开发总公司', '880060000', '158000000', '36'}",1593910,1,{'880060000'},3,"{'36', '定价', '镇江新区经济开发总公司'}",4,"{'158000000', '36', '定价', '镇江新区经济开发总公司'}"
12,"{'37886185', '现金', '1408789', '定价', '员工持股计划', '亿阳集团', '2216862', '1100000000', '24076212', '方略亿阳2号基金', '36', '64365125'}",1728821,0,set(),5,"{'现金', '定价', '员工持股计划', '亿阳集团', '36'}",12,"{'37886185', '现金', '1408789', '定价', '员工持股计划', '亿阳集团', '2216862', '1100000000', '24076212', '方略亿阳2号基金', '36', '64365125'}"
4,"{'12', '定价', '唐山晶源科技有限公司', '16880000'}",1459034,2,"{'定价', '唐山晶源科技有限公司'}",1,{'12'},2,"{'12', '16880000'}"
8,"{'529999983.9', '国寿安保基金管理有限公司', '定价', '689999990.5', '37520391', '28820010', '建信基金管理有限责任公司', '12'}",19242533,1,{'689999990.5'},2,"{'定价', '12'}",7,"{'529999983.9', '国寿安保基金管理有限公司', '定价', '37520391', '28820010', '建信基金管理有限责任公司', '12'}"
24,"{'申万菱信(上海)资产管理有限公司', '83160000', '国联安基金管理有限公司', '53000003.7', '易方达基金管理有限公司', '泰达宏利基金管理有限公司', '187740000', '8412699', '13200000', '云南云内动力集团有限公司', '12', '14000000', '财通基金管理有限公司', '竞价', '25400000', '36', '96649994.7', '160020000', '金鹰基金管理有限公司', '76230000', '15341269', '12100000', '29800000', '88200000'}",310424,2,"{'竞价', '8412699'}",3,"{'36', '12', '云南云内动力集团有限公司'}",22,"{'申万菱信(上海)资产管理有限公司', '83160000', '国联安基金管理有限公司', '53000003.7', '易方达基金管理有限公司', '泰达宏利基金管理有限公司', '187740000', '13200000', '云南云内动力集团有限公司', '12', '14000000', '财通基金管理有限公司', '25400000', '36', '96649994.7', '160020000', '金鹰基金管理有限公司', '76230000', '15341269', '12100000', '29800000', '88200000'}"
16,"{'皇庭投资', '现金', '霍孝谦', '1200000000', '600000000', '和瑞九鼎', '59820538', '定价', '119641076', '109409222', '9970089', '100000000', '陈巧玲', '皇庭金融控股', '1097374500', '36'}",360726,3,"{'100000000', '1097374500', '600000000'}",8,"{'皇庭投资', '现金', '霍孝谦', '和瑞九鼎', '定价', '陈巧玲', '皇庭金融控股', '36'}",13,"{'皇庭投资', '现金', '霍孝谦', '1200000000', '和瑞九鼎', '59820538', '定价', '119641076', '109409222', '9970089', '陈巧玲', '皇庭金融控股', '36'}"
12,"{'20000000', '上海国际资管', '现金', '华安资管', '锦江酒店集团', '定价', '15000000', '长城资管', '10000000', '75958260', '弘毅投资基金', '36'}",1878542,0,set(),9,"{'上海国际资管', '现金', '华安资管', '锦江酒店集团', '定价', '长城资管', '10000000', '弘毅投资基金', '36'}",12,"{'20000000', '上海国际资管', '现金', '华安资管', '锦江酒店集团', '定价', '15000000', '长城资管', '10000000', '75958260', '弘毅投资基金', '36'}"
10,"{'31685393', '现金', '282000000', '7921348', '定价', '铁路基金', '70500000', '淮矿集团', '皖投工投', '36'}",10790056,2,"{'7921348', '31685393'}",6,"{'现金', '定价', '铁路基金', '淮矿集团', '皖投工投', '36'}",8,"{'现金', '282000000', '定价', '铁路基金', '70500000', '淮矿集团', '皖投工投', '36'}"
12,"{'长沙合众鑫越股权投资企业(有限合伙)', '现金', '长沙合众鑫荣股权投资企业(有限合伙)', '381791989.9', '5660110', '3786980', '天弘基金管理有限公司', '竞价', '27341995.6', '52879777', '40865994.2', '36'}",1741144,1,{'竞价'},3,"{'天弘基金管理有限公司', '现金', '36'}",11,"{'长沙合众鑫越股权投资企业(有限合伙)', '现金', '长沙合众鑫荣股权投资企业(有限合伙)', '381791989.9', '5660110', '3786980', '天弘基金管理有限公司', '27341995.6', '52879777', '40865994.2', '36'}"
12,"{'现金', '中航证券有限公司北京资产管理分公司', '嘉实基金管理有限公司', '2000000', '易方达基金管理有限公司', '10800000', '上海国泰君安证券资产管理有限公司', '广发基金管理有限公司', '泰康资产管理有限责任公司', '10000000', '12', '7500000'}",1193738,3,"{'10800000', '7500000', '2000000'}",8,"{'现金', '中航证券有限公司北京资产管理分公司', '嘉实基金管理有限公司', '易方达基金管理有限公司', '上海国泰君安证券资产管理有限公司', '广发基金管理有限公司', '泰康资产管理有限责任公司', '12'}",9,"{'现金', '中航证券有限公司北京资产管理分公司', '嘉实基金管理有限公司', '易方达基金管理有限公司', '上海国泰君安证券资产管理有限公司', '广发基金管理有限公司', '泰康资产管理有限责任公司', '10000000', '12'}"
18,"{'599999988', '现金', '600000043.2', '600000098.4', '财通基金管理有限公司', '东方基金管理有限责任公司', '易方达基金管理有限公司', '珠海植通投资中心(有限合伙)', '竞价', '沈阳恒信投资管理有限公司', '10869565', '12994706', '717307771.2', '8744422', '10869567', '482692094.4', '12', '10869566'}",1815834,1,{'竞价'},6,"{'现金', '财通基金管理有限公司', '东方基金管理有限责任公司', '易方达基金管理有限公司', '沈阳恒信投资管理有限公司', '12'}",17,"{'599999988', '现金', '600000043.2', '600000098.4', '财通基金管理有限公司', '东方基金管理有限责任公司', '易方达基金管理有限公司', '珠海植通投资中心(有限合伙)', '12994706', '沈阳恒信投资管理有限公司', '10869565', '8744422', '717307771.2', '10869567', '482692094.4', '12', '10869566'}"
18,"{'36', '现金', '银华基金管理有限公司', '福建三安集团有限公司', '华夏基金管理有限公司', '15147706', '16033055', '27123853', '15137614', '广发基金管理有限公司', '易方达基金管理有限公司', '15151376', '富国基金管理有限公司', '南方基金管理有限公司', '32496305', '中国人寿资产管理有限公司', '15148623', '12'}",993139,5,"{'27123853', '16033055', '15147706', '15151376', '32496305'}",10,"{'现金', '福建三安集团有限公司', '银华基金管理有限公司', '华夏基金管理有限公司', '12', '广发基金管理有限公司', '易方达基金管理有限公司', '富国基金管理有限公司', '中国人寿资产管理有限公司', '36'}",13,"{'36', '现金', '银华基金管理有限公司', '福建三安集团有限公司', '华夏基金管理有限公司', '15137614', '广发基金管理有限公司', '易方达基金管理有限公司', '富国基金管理有限公司', '南方基金管理有限公司', '中国人寿资产管理有限公司', '15148623', '12'}"
23,"{'蚌埠市城市投资控股有限公司', '兵器财务有限责任公司', '179515000', '390250000', '现金', '中航证券有限公司北京资产管理分公司', '11000000', '竞价', '天津锦耀程股权投资基金合伙企业(有限合伙)', '156100000', '10000000', '2500000', '上海瑞艾林投资管理合伙企业(有限合伙)', '234150000', '博时基金管理有限公司', '15000000', '鹰潭丰和投资管理有限合伙企业', '171710000', '25000000', '天津硅谷天堂盈通股权投资基金合伙企业(有限合伙', '11500000', '39025000', '12'}",1413732,7,"{'390250000', '179515000', '234150000', '171710000', '竞价', '39025000', '156100000'}",7,"{'蚌埠市城市投资控股有限公司', '现金', '兵器财务有限责任公司', '中航证券有限公司北京资产管理分公司', '博时基金管理有限公司', '鹰潭丰和投资管理有限合伙企业', '12'}",16,"{'蚌埠市城市投资控股有限公司', '现金', '兵器财务有限责任公司', '11500000', '上海瑞艾林投资管理合伙企业(有限合伙)', '中航证券有限公司北京资产管理分公司', '博时基金管理有限公司', '15000000', '鹰潭丰和投资管理有限合伙企业', '11000000', '25000000', '天津锦耀程股权投资基金合伙企业(有限合伙)', '10000000', '12', '天津硅谷天堂盈通股权投资基金合伙企业(有限合伙', '2500000'}"
6,"{'1992239723', '现金', 'CLH12(HK) Limited', '竞价', '36', '339972649'}",1835978,3,"{'1992239723', '竞价', 'CLH12(HK) Limited'}",2,"{'现金', '36'}",3,"{'现金', '36', '339972649'}"
14,"{'海淀科技', '现金', '23352037', '定价', '京泽永兴', '40856275', '699867990.8', '5834746', '刘雷', '林科', '99949198.98', '海淀国投', '400020393.8', '36'}",1769316,1,{'699867990.8'},8,"{'海淀科技', '现金', '定价', '京泽永兴', '刘雷', '林科', '海淀国投', '36'}",13,"{'海淀科技', '现金', '23352037', '定价', '京泽永兴', '40856275', '5834746', '刘雷', '林科', '99949198.98', '海淀国投', '400020393.8', '36'}"
14,"{'131999908.6', '现金', '浙江浙商证券资产管理有限公司', '深圳天风天成资产管理有限公司', '九泰基金管理有限公司', '5062274', '国寿安保基金管理有限公司', '信诚基金管理有限公司', '定价', '5303331', '125999999.9', '120000091.1', '4821217', '12'}",16165453,2,"{'131999908.6', '125999999.9'}",8,"{'现金', '浙江浙商证券资产管理有限公司', '深圳天风天成资产管理有限公司', '九泰基金管理有限公司', '信诚基金管理有限公司', '国寿安保基金管理有限公司', '定价', '12'}",12,"{'现金', '浙江浙商证券资产管理有限公司', '深圳天风天成资产管理有限公司', '九泰基金管理有限公司', '5062274', '国寿安保基金管理有限公司', '5303331', '信诚基金管理有限公司', '定价', '120000091.1', '4821217', '12'}"
18,"{'苏州高新区经济发展集团总公司', '浙江善上投资管理有限公司', '1840000', '现金', '7310000', '瑞士银行(UBS AG)', '华夏优势增长股票型基金', '12', '12920000', '浙江华表实业有限公司', '1280000', '1860000', '2000000', '3220000', '上海国寿投资管理有限公司', '兴华证券投资基金', '苏州信托有限公司', '36'}",1376727,6,"{'1840000', '瑞士银行(UBS AG)', '12920000', '1280000', '1860000', '3220000'}",9,"{'苏州高新区经济发展集团总公司', '36', '浙江善上投资管理有限公司', '现金', '浙江华表实业有限公司', '上海国寿投资管理有限公司', '兴华证券投资基金', '苏州信托有限公司', '12'}",12,"{'苏州高新区经济发展集团总公司', '浙江善上投资管理有限公司', '现金', '7310000', '华夏优势增长股票型基金', '12', '浙江华表实业有限公司', '上海国寿投资管理有限公司', '2000000', '兴华证券投资基金', '苏州信托有限公司', '36'}"
15,"{'25252525', '福能集团', '12626262', '现金', '599999994', '平安资管公司', '199999998', '福汽集团', '福建投资集团', '25252527', '75757575', '99999995.04', '200000013.8', '福建交通运输集团', '36'}",296140,8,"{'25252525', '12626262', '599999994', '199999998', '75757575', '25252527', '99999995.04', '200000013.8'}",7,"{'福能集团', '36', '现金', '平安资管公司', '福建投资集团', '福建交通运输集团', '福汽集团'}",7,"{'福能集团', '现金', '平安资管公司', '福汽集团', '福建投资集团', '福建交通运输集团', '36'}"
18,"{'中国泛海控股集团有限公司', '光大证券股份有限公司', '现金', '定价', '357000000', '上海健特生命科技有限公司', '中国平安人寿保险股份有限公司', '四川南方希望实业有限公司', '309400000', '新希望投资有限公司', '714000000', '26', '13', '130900000', '中国人寿保险股份有限公司', '119000000', '12', '35700000'}",1379597,5,"{'357000000', '309400000', '130900000', '119000000', '35700000'}",12,"{'中国泛海控股集团有限公司', '光大证券股份有限公司', '现金', '定价', '上海健特生命科技有限公司', '中国平安人寿保险股份有限公司', '四川南方希望实业有限公司', '新希望投资有限公司', '26', '13', '中国人寿保险股份有限公司', '12'}",13,"{'中国泛海控股集团有限公司', '光大证券股份有限公司', '现金', '定价', '上海健特生命科技有限公司', '中国平安人寿保险股份有限公司', '四川南方希望实业有限公司', '新希望投资有限公司', '714000000', '26', '13', '中国人寿保险股份有限公司', '12'}"
4,"{'36', '竞价', '现金', '大西洋集团'}",1225162,0,set(),4,"{'36', '竞价', '现金', '大西洋集团'}",4,"{'36', '竞价', '现金', '大西洋集团'}"
11,"{'现金', '江苏瑞华投资发展有限公司', '4000000', '定价', '7000000', '雅戈尔投资有限公司', '广发基金管理有限公司', '6000000', '上海安正投资发展有限公司', '17332084', '12'}",1245630,0,set(),7,"{'现金', '江苏瑞华投资发展有限公司', '定价', '雅戈尔投资有限公司', '广发基金管理有限公司', '上海安正投资发展有限公司', '12'}",11,"{'现金', '江苏瑞华投资发展有限公司', '4000000', '定价', '7000000', '雅戈尔投资有限公司', '广发基金管理有限公司', '6000000', '上海安正投资发展有限公司', '17332084', '12'}"
17,"{'13500000', '现金', '10160000', '兴业全球基金管理有限公司', '19100000', '新华资产管理股份有限公司', '国华人寿保险股份有限公司', '13800000', '平安资产管理有限责任公司', '13600000', '竞价', '富国基金管理有限公司', '西藏瑞华投资发展有限公司', '南方基金管理有限公司', '14600000', '汇添富基金管理股份有限公司', '12'}",909209,4,"{'19100000', '10160000', '14600000', '竞价'}",3,"{'现金', '12', '国华人寿保险股份有限公司'}",13,"{'13500000', '现金', '兴业全球基金管理有限公司', '新华资产管理股份有限公司', '国华人寿保险股份有限公司', '13800000', '平安资产管理有限责任公司', '13600000', '富国基金管理有限公司', '西藏瑞华投资发展有限公司', '南方基金管理有限公司', '汇添富基金管理股份有限公司', '12'}"
6,"{'北京合纵科技股份有限公司第一期员工持股计划', '现金', '定价', '9318466', '105485035.1', '36'}",14663621,1,{'105485035.1'},4,"{'北京合纵科技股份有限公司第一期员工持股计划', '定价', '现金', '36'}",5,"{'北京合纵科技股份有限公司第一期员工持股计划', '现金', '定价', '9318466', '36'}"
4,"{'中国远洋海运集团有限公司', '竞价', '现金', '36'}",16836080,0,set(),4,"{'中国远洋海运集团有限公司', '竞价', '现金', '36'}",4,"{'中国远洋海运集团有限公司', '竞价', '现金', '36'}"
3,"{'巨人投资有限公司', '65000000', '36'}",448436,0,set(),2,"{'巨人投资有限公司', '36'}",3,"{'巨人投资有限公司', '65000000', '36'}"
17,"{'平安大华基金管理有限公司', '现金', '15811176', '兴证证券资产管理有限公司', '工银瑞信基金管理有限公司', '286214858', '12', '定价', '平安资产管理有限责任公司', '70735873', '泰达宏利基金管理有限公司', '31746031', '泰康资产管理有限责任公司', '63492063', '上海汽车集团股份有限公司', '36', '38095238'}",1871734,0,set(),10,"{'平安大华基金管理有限公司', '现金', '兴证证券资产管理有限公司', '工银瑞信基金管理有限公司', '12', '定价', '平安资产管理有限责任公司', '泰康资产管理有限责任公司', '上海汽车集团股份有限公司', '36'}",17,"{'平安大华基金管理有限公司', '15811176', '现金', '兴证证券资产管理有限公司', '工银瑞信基金管理有限公司', '286214858', '12', '定价', '平安资产管理有限责任公司', '70735873', '泰达宏利基金管理有限公司', '31746031', '泰康资产管理有限责任公司', '63492063', '上海汽车集团股份有限公司', '36', '38095238'}"
14,"{'9405568', '249999997.4', '99999993.66', '现金', '邓亲华', '长城国融', '天风证券', '东海瑞京—瑞龙11号', '定价', '199999987.3', '光大资本', '3762227', '7524454', '36'}",1629056,0,set(),7,"{'现金', '长城国融', '邓亲华', '天风证券', '定价', '光大资本', '36'}",14,"{'9405568', '249999997.4', '99999993.66', '现金', '邓亲华', '长城国融', '天风证券', '东海瑞京—瑞龙11号', '定价', '199999987.3', '光大资本', '3762227', '7524454', '36'}"
12,"{'现金', '662900', '定价', '1501600', '1035300', '华泰硅宝1号定向资产管理计划', '杨丽玫', '郭弟民', '王跃林', '1720300', '王有治', '36'}",1706924,5,"{'662900', '1501600', '1035300', '华泰硅宝1号定向资产管理计划', '1720300'}",7,"{'现金', '定价', '杨丽玫', '郭弟民', '王跃林', '王有治', '36'}",7,"{'现金', '定价', '杨丽玫', '郭弟民', '王跃林', '王有治', '36'}"
21,"{'600000000', '现金', '浙江海鹏投资咨询有限公司', '深圳安鹏汽车后市场产业基金(有限合伙)', '516000000', '竞价', '300000000', '财通资产-金固股份高管定增特定多个客户专项资产管理计划', '9000000', '18007202', '84000000', '900000000', '15486194', '孙锋峰', '海通定增1号定向资产管理计划', '299880000', '2521008', '27010804', '杭州信息产业投资有限公司', '36', '9003601'}",1674996,7,"{'900000000', '299880000', '600000000', '516000000', '竞价', '300000000', '84000000'}",7,"{'现金', '浙江海鹏投资咨询有限公司', '孙锋峰', '杭州信息产业投资有限公司', '海通定增1号定向资产管理计划', '财通资产-金固股份高管定增特定多个客户专项资产管理计划', '36'}",14,"{'现金', '15486194', '18007202', '2521008', '浙江海鹏投资咨询有限公司', '深圳安鹏汽车后市场产业基金(有限合伙)', '孙锋峰', '27010804', '杭州信息产业投资有限公司', '海通定增1号定向资产管理计划', '财通资产-金固股份高管定增特定多个客户专项资产管理计划', '9000000', '36', '9003601'}"
17,"{'现金', '40000000', '22400000', '11300000', '华夏基金管理有限公司', '大成基金管理有限公司', '12', '融通基金管理有限公司', '嘉实基金管理有限公司', '广发基金管理有限公司', '27000000', '中国海洋石油总公司', '泰康资产管理有限责任公司', '海富通基金管理有限公司', '30000000', '36', '78000000'}",1342501,0,set(),11,"{'36', '现金', '华夏基金管理有限公司', '大成基金管理有限公司', '融通基金管理有限公司', '嘉实基金管理有限公司', '广发基金管理有限公司', '中国海洋石油总公司', '泰康资产管理有限责任公司', '12', '海富通基金管理有限公司'}",17,"{'现金', '40000000', '22400000', '11300000', '华夏基金管理有限公司', '大成基金管理有限公司', '12', '融通基金管理有限公司', '嘉实基金管理有限公司', '广发基金管理有限公司', '27000000', '中国海洋石油总公司', '泰康资产管理有限责任公司', '海富通基金管理有限公司', '30000000', '36', '78000000'}"
6,"{'现金', '大成创新资本-国能资产管理计划1号', '12292292', '定价', '大成创新资本-兴森资产管理计划1号', '36'}",444550,1,{'12292292'},5,"{'大成创新资本-国能资产管理计划1号', '现金', '定价', '大成创新资本-兴森资产管理计划1号', '36'}",5,"{'大成创新资本-国能资产管理计划1号', '现金', '定价', '大成创新资本-兴森资产管理计划1号', '36'}"
5,"{'7241131', '18102824', 'IDG资本管理(香港)有限公司', '36', '华住酒店管理有限公司'}",446097,0,set(),2,"{'36', '华住酒店管理有限公司'}",5,"{'7241131', '18102824', 'IDG资本管理(香港)有限公司', '36', '华住酒店管理有限公司'}"
17,"{'2195100', '现金', '376307569.9', '149999993.8', '71077338', '定价', '376307537.5', '张斌', '11621605', '张为结', '周新宇', '4632489', '招证资管-达安基因员工持股计划', '程钢', '36', '何蕴韶', '11621604'}",1782077,3,"{'11621605', '2195100', '11621604'}",9,"{'现金', '定价', '张斌', '张为结', '周新宇', '招证资管-达安基因员工持股计划', '程钢', '36', '何蕴韶'}",14,"{'36', '现金', '376307569.9', '149999993.8', '71077338', '定价', '376307537.5', '张斌', '张为结', '周新宇', '招证资管-达安基因员工持股计划', '程钢', '4632489', '何蕴韶'}"
23,"{'6069802', '279999999.2', '7587253', '5058168', '14162873', '14466363', '曹永贵', '现金', '12645422', '竞价', '119999985.5', '36', '北信瑞丰基金管理有限公司', '农银汇理(上海)资产管理有限公司', '149999991.8', '285999996.5', '金鹰基金管理有限公司', '九泰基金管理有限公司', '天弘基金管理有限公司', '99999981.36', '安信基金管理有限责任公司', '12', '249999992.9'}",16043480,3,"{'285999996.5', '竞价', '14466363'}",9,"{'曹永贵', '36', '金鹰基金管理有限公司', '现金', '北信瑞丰基金管理有限公司', '九泰基金管理有限公司', '天弘基金管理有限公司', '安信基金管理有限责任公司', '12'}",20,"{'119999985.5', '金鹰基金管理有限公司', '曹永贵', '6069802', '现金', '九泰基金管理有限公司', '北信瑞丰基金管理有限公司', '农银汇理(上海)资产管理有限公司', '36', '279999999.2', '12645422', '7587253', '149999991.8', '5058168', '天弘基金管理有限公司', '99999981.36', '安信基金管理有限责任公司', '14162873', '12', '249999992.9'}"
19,"{'安粮控股', '张辉', '广东辉瑞投资', '现金', '5000000', '3125000', '吴桂昌', '栖霞建设', '华兴润福', '定价', '赖国传', '25000000', '6250000', '12500000', '张春燕', '10000000', '达德厚鑫', '36', '7500000'}",1559878,4,"{'3125000', '6250000', '12500000', '7500000'}",12,"{'安粮控股', '张辉', '广东辉瑞投资', '现金', '栖霞建设', '吴桂昌', '华兴润福', '定价', '赖国传', '张春燕', '达德厚鑫', '36'}",15,"{'安粮控股', '张辉', '广东辉瑞投资', '现金', '5000000', '吴桂昌', '栖霞建设', '华兴润福', '定价', '赖国传', '25000000', '张春燕', '10000000', '达德厚鑫', '36'}"
13,"{'23487096', '6000000', '93000000', '融通基金管理有限公司', '4300000', '财通基金管理有限公司', '东海基金管理有限责任公司', '西藏自治区投资有限公司', '竞价', '364049988', '国投瑞银基金管理有限公司', '12', '66650000'}",581944,5,"{'23487096', '93000000', '竞价', '364049988', '66650000'}",1,{'12'},8,"{'6000000', '融通基金管理有限公司', '4300000', '财通基金管理有限公司', '东海基金管理有限责任公司', '西藏自治区投资有限公司', '国投瑞银基金管理有限公司', '12'}"
4,"{'东北车集团', '竞价', '36', '4500000000'}",505502,1,{'4500000000'},3,"{'东北车集团', '竞价', '36'}",3,"{'东北车集团', '竞价', '36'}"
4,"{'太安堂集团', '45413200', '现金', '36'}",1849462,1,{'45413200'},3,"{'太安堂集团', '现金', '36'}",3,"{'太安堂集团', '现金', '36'}"
4,"{'现金', '竞价', '鹏欣集团', '36'}",308686,0,set(),4,"{'36', '竞价', '鹏欣集团', '现金'}",4,"{'现金', '竞价', '鹏欣集团', '36'}"
11,"{'华安基金管理有限公司', '兴业全球基金管理有限公司', '7000000', '中国长城资产管理公司', '太平资产管理有限公司', '4413200', '中国对外经济贸易信托有限公司', '12500000', '高翔', '12', '7500000'}",405725,1,{'4413200'},5,"{'兴业全球基金管理有限公司', '中国长城资产管理公司', '高翔', '12', '太平资产管理有限公司'}",10,"{'华安基金管理有限公司', '兴业全球基金管理有限公司', '7000000', '中国长城资产管理公司', '太平资产管理有限公司', '中国对外经济贸易信托有限公司', '12500000', '高翔', '12', '7500000'}"
9,"{'33500000', '现金', '新疆生产建设兵团国有资产经营公司', '定价', '5500000', '北京睿富投资管理有限公司', '22300000', '中新建招商股权投资有限公司', '36'}",1359834,2,"{'22300000', '33500000'}",6,"{'现金', '新疆生产建设兵团国有资产经营公司', '定价', '北京睿富投资管理有限公司', '中新建招商股权投资有限公司', '36'}",7,"{'现金', '新疆生产建设兵团国有资产经营公司', '定价', '5500000', '北京睿富投资管理有限公司', '中新建招商股权投资有限公司', '36'}"
5,"{'现金', '中电熊猫', '竞价', '200000000', '36'}",1129381,1,{'200000000'},4,"{'竞价', '现金', '中电熊猫', '36'}",4,"{'竞价', '现金', '中电熊猫', '36'}"
6,"{'238800000', '现金', '定价', '中航投资控股有限公司', '30000000', '36'}",1259486,2,"{'238800000', '30000000'}",4,"{'中航投资控股有限公司', '定价', '现金', '36'}",4,"{'中航投资控股有限公司', '定价', '现金', '36'}"
5,"{'311330000', '现金', '城投公司', '定价', '36'}",824480,0,set(),4,"{'36', '定价', '现金', '城投公司'}",5,"{'311330000', '现金', '城投公司', '定价', '36'}"
19,"{'12000000', '周波', '现金', '3200000', '阮兴祥', '何旭斌', '4000000', '王勇', '金瑞浩', '阮伟祥', '5500000', '项志峰', '陈国江', '罗斌', '姚建芳', '22500000', '6000000', '30000000', '36'}",287194,0,set(),12,"{'周波', '现金', '阮兴祥', '何旭斌', '金瑞浩', '阮伟祥', '项志峰', '陈国江', '罗斌', '姚建芳', '王勇', '36'}",19,"{'12000000', '周波', '现金', '3200000', '阮兴祥', '何旭斌', '4000000', '王勇', '金瑞浩', '阮伟祥', '5500000', '项志峰', '陈国江', '罗斌', '姚建芳', '22500000', '6000000', '30000000', '36'}"
12,"{'7117437', '现金', '600000000', '100000000', '定价', '6150071', '华夏人寿', '上汽投资', '42704626', '医控公司', '股权', '36'}",4940776,1,{'100000000'},7,"{'现金', '定价', '华夏人寿', '上汽投资', '医控公司', '股权', '36'}",11,"{'7117437', '现金', '600000000', '定价', '6150071', '华夏人寿', '上汽投资', '42704626', '医控公司', '股权', '36'}"
6,"{'10248500', '现金', '32669900', '华林证券-华伍股份第1期员工持股定向资产管理计划系由华伍股份第1期员工持股计划', '聂璐璐', '36'}",1631470,3,"{'10248500', '32669900', '华林证券-华伍股份第1期员工持股定向资产管理计划系由华伍股份第1期员工持股计划'}",3,"{'聂璐璐', '现金', '36'}",3,"{'聂璐璐', '现金', '36'}"
13,"{'中国纸业投资总公司', '14400000', '现金', '中国高新投资集团公司', '宏源证券股份有限公司', '12', '中债信用增进投资股份有限公司', '定价', '17500000', '上海宸乾投资有限公司', '10000000', '30000000', '36'}",559850,1,{'17500000'},9,"{'中国纸业投资总公司', '现金', '中国高新投资集团公司', '宏源证券股份有限公司', '12', '中债信用增进投资股份有限公司', '定价', '上海宸乾投资有限公司', '36'}",12,"{'中国纸业投资总公司', '14400000', '现金', '中国高新投资集团公司', '宏源证券股份有限公司', '12', '中债信用增进投资股份有限公司', '定价', '上海宸乾投资有限公司', '10000000', '30000000', '36'}"
6,"{'现金', '15000000', '姚尧土', '366750000', '李凯', '36'}",14211736,2,"{'15000000', '366750000'}",4,"{'姚尧土', '李凯', '现金', '36'}",4,"{'姚尧土', '李凯', '现金', '36'}"
11,"{'江苏京东邦能投资管理有限公司', '现金', '牛奶有限公司', '张轩松', '478523104', '定价', '286934440', '478523106', '江苏圆周电子商务有限公司', '36', '191409242'}",12031693,0,set(),7,"{'江苏京东邦能投资管理有限公司', '现金', '牛奶有限公司', '张轩松', '定价', '江苏圆周电子商务有限公司', '36'}",11,"{'江苏京东邦能投资管理有限公司', '牛奶有限公司', '现金', '张轩松', '478523104', '286934440', '定价', '478523106', '江苏圆周电子商务有限公司', '36', '191409242'}"
18,"{'128140703', '现金', '申万菱信基金-工商银行-创盈定增63号资产管理计划', '103977391', '123115577', '150753768', '定价', '351758793', '北信瑞丰基金-工商银行-北信瑞丰基金丰庆80号资产管理计划', '泰达宏利基金-工商银行-泰达宏利新毅3号资产管理计划', '华安未来资产-工商银行-杭州余杭金控控股股份有限公司', '西藏兆能新能源开发有限公司', '兴业财富资产-兴业银行-兴隆65号特定多客户资产管理计划', '124917085', '125376884', '嘉兴民安投资合伙企业(有限合伙)', '12', '天治基金-工商银行-工正定增2号资产管理计划'}",4929710,0,set(),3,"{'定价', '现金', '12'}",18,"{'128140703', '103977391', '申万菱信基金-工商银行-创盈定增63号资产管理计划', '现金', '123115577', '150753768', '351758793', '定价', '北信瑞丰基金-工商银行-北信瑞丰基金丰庆80号资产管理计划', '泰达宏利基金-工商银行-泰达宏利新毅3号资产管理计划', '华安未来资产-工商银行-杭州余杭金控控股股份有限公司', '西藏兆能新能源开发有限公司', '兴业财富资产-兴业银行-兴隆65号特定多客户资产管理计划', '124917085', '125376884', '嘉兴民安投资合伙企业(有限合伙)', '12', '天治基金-工商银行-工正定增2号资产管理计划'}"
3,"{'深圳市集盛投资发展有限公司', '竞价', '现金'}",1101612,0,set(),3,"{'深圳市集盛投资发展有限公司', '竞价', '现金'}",3,"{'深圳市集盛投资发展有限公司', '竞价', '现金'}"
5,"{'现金', '172000000', '象屿集团', '竞价', '36'}",1030387,2,"{'竞价', '172000000'}",3,"{'现金', '36', '象屿集团'}",3,"{'现金', '36', '象屿集团'}"
8,"{'150000000', '现金', '重庆市江北嘴中央商务区投资集团有限公司', '重庆市城市建设投资(集团)有限公司', '重庆市水务资产经营有限公司', '50000000', '重庆高速公路集团有限公司', '36'}",1214445,1,{'150000000'},6,"{'现金', '重庆市江北嘴中央商务区投资集团有限公司', '重庆市城市建设投资(集团)有限公司', '重庆市水务资产经营有限公司', '重庆高速公路集团有限公司', '36'}",7,"{'现金', '重庆市江北嘴中央商务区投资集团有限公司', '重庆市城市建设投资(集团)有限公司', '重庆市水务资产经营有限公司', '50000000', '重庆高速公路集团有限公司', '36'}"
21,"{'44999979.3', '1851851', '78200097.3', '国投瑞银基金管理有限公司', '现金', '3218111', '上银瑞金资本管理有限公司', '胡智雄', '12', '竞价', '2049382', '汇添富基金管理股份有限公司', '51999983.1', '华福基金管理有限责任公司', '黄幼凤', '2139917', '金鹰基金管理有限公司', '胡智彪', '49799982.6', '渤海证券股份有限公司', '36'}",1675368,0,set(),7,"{'金鹰基金管理有限公司', '现金', '胡智彪', '胡智雄', '12', '竞价', '36'}",21,"{'44999979.3', '1851851', '78200097.3', '国投瑞银基金管理有限公司', '现金', '3218111', '上银瑞金资本管理有限公司', '胡智雄', '12', '竞价', '2049382', '汇添富基金管理股份有限公司', '51999983.1', '华福基金管理有限责任公司', '黄幼凤', '2139917', '金鹰基金管理有限公司', '胡智彪', '49799982.6', '渤海证券股份有限公司', '36'}"
17,"{'28016529', '28264462', '56198347', '江信基金管理有限公司', '兴业全球基金管理有限公司', '国金证券股份有限公司', '安徽省铁路建设投资基金有限公司', '12', '20578515', '28099173', '上海证大投资管理有限公司', '62809917', '安徽省能源集团有限公司', '安徽省皖投融资担保有限责任公司', '竞价', '36', '红塔红土基金管理有限公司'}",718953,1,{'竞价'},3,"{'安徽省能源集团有限公司', '12', '36'}",16,"{'28016529', '28264462', '56198347', '江信基金管理有限公司', '兴业全球基金管理有限公司', '国金证券股份有限公司', '安徽省铁路建设投资基金有限公司', '12', '20578515', '28099173', '上海证大投资管理有限公司', '62809917', '安徽省能源集团有限公司', '安徽省皖投融资担保有限责任公司', '36', '红塔红土基金管理有限公司'}"
4,"{'竞价', '现金', '36', '煤化集团'}",230470,0,set(),4,"{'竞价', '现金', '36', '煤化集团'}",4,"{'竞价', '现金', '36', '煤化集团'}"
10,"{'永城煤电控股集团上海有限公司', '现金', '江苏瑞华投资发展有限公司', '81749049', '27300380', '定价', '15000000', '12', '36', '漯河市发展投资有限责任公司'}",129254,0,set(),7,"{'36', '现金', '江苏瑞华投资发展有限公司', '12', '定价', '永城煤电控股集团上海有限公司', '漯河市发展投资有限责任公司'}",10,"{'36', '现金', '江苏瑞华投资发展有限公司', '81749049', '27300380', '12', '15000000', '定价', '永城煤电控股集团上海有限公司', '漯河市发展投资有限责任公司'}"
6,"{'46772684', '现金', '定价', '拉萨昆吾', '1500000000', '36'}",14737830,2,"{'46772684', '1500000000'}",4,"{'36', '定价', '拉萨昆吾', '现金'}",4,"{'定价', '拉萨昆吾', '现金', '36'}"
3,"{'西藏知合', '现金', '36'}",16369356,0,set(),3,"{'西藏知合', '现金', '36'}",3,"{'西藏知合', '现金', '36'}"
13,"{'现金', '北方水泥有限公司', '129477298', '唐山冀东水泥股份有限公司', '定价', '华安基金管理有限公司(以华安-世融资产管理计划认购)', '吉林金塔投资股份有限公司', '吉林敖东药业集团股份有限公司', '109722935', '长春市城市发展投资控股(集团)有限公司', '108482368', '98576482', '36'}",1628893,1,{'唐山冀东水泥股份有限公司'},4,"{'定价', '现金', '36', '吉林金塔投资股份有限公司'}",12,"{'现金', '北方水泥有限公司', '129477298', '华安基金管理有限公司(以华安-世融资产管理计划认购)', '定价', '吉林金塔投资股份有限公司', '吉林敖东药业集团股份有限公司', '109722935', '长春市城市发展投资控股(集团)有限公司', '108482368', '98576482', '36'}"
4,"{'广东南海控股投资有限公司', '36', '91319726', '599970600'}",162656,1,{'599970600'},2,"{'广东南海控股投资有限公司', '36'}",3,"{'广东南海控股投资有限公司', '36', '91319726'}"
9,"{'西藏泰能股权投资管理有限公司', '山东诺德资产管理有限公司', '2538071063', '761421320', '南京汇恒投资有限公司', '507614214', '永泰控股集团有限公司', '襄垣县襄银投资合伙企业', '36'}",86444,0,set(),5,"{'西藏泰能股权投资管理有限公司', '山东诺德资产管理有限公司', '南京汇恒投资有限公司', '永泰控股集团有限公司', '36'}",9,"{'西藏泰能股权投资管理有限公司', '山东诺德资产管理有限公司', '2538071063', '761421320', '南京汇恒投资有限公司', '507614214', '永泰控股集团有限公司', '襄垣县襄银投资合伙企业', '36'}"
11,"{'116999995.5', '华安基金管理有限公司', '113104005.6', '20526315', '40350877', '19842808', '定价', '融通基金管理有限公司', '英大基金管理有限公司', '229999998.9', '12'}",1055116,0,set(),2,"{'定价', '12'}",11,"{'116999995.5', '华安基金管理有限公司', '113104005.6', '20526315', '40350877', '19842808', '定价', '融通基金管理有限公司', '英大基金管理有限公司', '229999998.9', '12'}"
30,"{'3961965', '上海淮茂', '150000', '25240000', '8000000', '200000000', '7923930', '马可', '162475600', '现金', '白一骢', '200000', '平安资管', '林楠', '3786000', '150000000', '5048000', '11610400', '杭州银之盛', '王玫', '460000', '广州恒晟', '201920000', '王姬', '周淑华', '100000000', '6437228', '5942947', '1000000', '36'}",1803333,4,"{'100000000', '150000000', '162475600', '200000000'}",12,"{'王姬', '马可', '现金', '周淑华', '上海淮茂', '白一骢', '杭州银之盛', '平安资管', '林楠', '王玫', '广州恒晟', '36'}",26,"{'3961965', '上海淮茂', '150000', '25240000', '8000000', '7923930', '马可', '现金', '白一骢', '200000', '平安资管', '林楠', '3786000', '5048000', '11610400', '杭州银之盛', '王玫', '460000', '广州恒晟', '201920000', '王姬', '周淑华', '6437228', '5942947', '1000000', '36'}"
5,"{'现金', '3680000000', '定价', '银河天成集团有限公司', '36'}",1820453,1,{'3680000000'},4,"{'银河天成集团有限公司', '现金', '定价', '36'}",4,"{'银河天成集团有限公司', '定价', '现金', '36'}"
12,"{'现金', '10874717', '赵东日', '50162734.16', '潍坊至真至信投资合伙企业(有限合伙)', '冀延松', '定价', '25981982', '66988256.72', '8143301', '36', '160049009.1'}",1781476,2,"{'66988256.72', '50162734.16'}",5,"{'现金', '赵东日', '冀延松', '定价', '36'}",10,"{'现金', '10874717', '赵东日', '潍坊至真至信投资合伙企业(有限合伙)', '冀延松', '定价', '25981982', '8143301', '36', '160049009.1'}"
8,"{'3090000', '现金', '谭颂斌', '600000', '8124000', '林登灿', '41838600', '36'}",301673,3,"{'8124000', '41838600', '36'}",3,"{'现金', '林登灿', '谭颂斌'}",5,"{'3090000', '现金', '谭颂斌', '600000', '林登灿'}"
21,"{'11249977.5', '武汉创时新一投资发展有限公司', '2800000', '3000000', '现金', '63000000', '国投瑞银基金管理股份有限公司', '武汉当代科技产业集团股份有限公司', '42000007.5', '财通基金管理有限公司', '竞价', '101250000', '67500000', '36', '499999', '邢云庆', '4500000', '1866667', '上海东方证券资产管理有限公司', '西藏瑞华投资发展有限公司', '12'}",322113,1,{'竞价'},10,"{'邢云庆', '现金', '12', '国投瑞银基金管理股份有限公司', '武汉创时新一投资发展有限公司', '武汉当代科技产业集团股份有限公司', '财通基金管理有限公司', '上海东方证券资产管理有限公司', '西藏瑞华投资发展有限公司', '36'}",20,"{'邢云庆', '11249977.5', '现金', '4500000', '63000000', '1866667', '12', '国投瑞银基金管理股份有限公司', '499999', '武汉当代科技产业集团股份有限公司', '武汉创时新一投资发展有限公司', '42000007.5', '2800000', '财通基金管理有限公司', '101250000', '3000000', '上海东方证券资产管理有限公司', '西藏瑞华投资发展有限公司', '67500000', '36'}"
4,"{'定价', '拉萨昆吾', '现金', '36'}",15663761,0,set(),4,"{'现金', '定价', '拉萨昆吾', '36'}",4,"{'定价', '拉萨昆吾', '现金', '36'}"
11,"{'216450216', '72085288', '华安基金管理有限公司', '81745000', '12', '天弘基金管理有限公司', '竞价', '泰达宏利基金管理有限公司', '134770000', '36', '海航资本控股有限公司'}",784719,2,"{'216450216', '竞价'}",6,"{'36', '华安基金管理有限公司', '天弘基金管理有限公司', '泰达宏利基金管理有限公司', '12', '海航资本控股有限公司'}",9,"{'36', '72085288', '华安基金管理有限公司', '81745000', '天弘基金管理有限公司', '泰达宏利基金管理有限公司', '134770000', '12', '海航资本控股有限公司'}"
4,"{'郑钟南', '竞价', '现金', '36'}",592145,0,set(),4,"{'郑钟南', '竞价', '现金', '36'}",4,"{'郑钟南', '竞价', '现金', '36'}"
4,"{'竞价', '现金', '36', '露笑集团'}",1735213,0,set(),4,"{'竞价', '现金', '36', '露笑集团'}",4,"{'竞价', '现金', '36', '露笑集团'}"
4,"{'湖南湘投高科技创业投资有限公司', '现金', '36', '中南大学粉末冶金工程研究中心有限公司'}",717825,0,set(),4,"{'湖南湘投高科技创业投资有限公司', '现金', '36', '中南大学粉末冶金工程研究中心有限公司'}",4,"{'湖南湘投高科技创业投资有限公司', '现金', '36', '中南大学粉末冶金工程研究中心有限公司'}"
24,"{'华安基金管理有限公司', '259836000', '周雪钦', '33000000', '50000000', '183500000', '110100000', '财通基金管理有限公司', '竞价', '30000000', '南京瑞森投资管理合伙企业(有限合伙)', '36', '2330000', '东海基金管理有限责任公司', '瞿柏寅', '121110000', '宁波开发投资集团有限公司', '50800000', '8551100', '70800000', '魏胜平', '民生通惠资产管理有限公司', '186436000', '12'}",476933,1,{'竞价'},10,"{'宁波开发投资集团有限公司', '华安基金管理有限公司', '12', '东海基金管理有限责任公司', '财通基金管理有限公司', '瞿柏寅', '周雪钦', '魏胜平', '民生通惠资产管理有限公司', '36'}",23,"{'华安基金管理有限公司', '259836000', '周雪钦', '33000000', '50000000', '183500000', '110100000', '财通基金管理有限公司', '30000000', '南京瑞森投资管理合伙企业(有限合伙)', '36', '2330000', '东海基金管理有限责任公司', '瞿柏寅', '121110000', '宁波开发投资集团有限公司', '50800000', '8551100', '70800000', '魏胜平', '民生通惠资产管理有限公司', '186436000', '12'}"
21,"{'117000000', '20000000', '136500000', '中海基金管理有限公司-中海能源策略混合型证券投资基金', '现金', '工银瑞信基金管理有限公司', '国机财务有限责任公司', '定价', '18000000', '金小红', '130000000', '富国基金管理有限公司-汉盛证券投资基金', '30000000', '97500000', '15000000', '雅戈尔投资有限公司', '江苏瑞华投资发展有限公司', '中国人保资产管理股份有限公司', '195000000', '21000000', '12'}",1159938,4,"{'117000000', '195000000', '97500000', '136500000'}",9,"{'现金', '江苏瑞华投资发展有限公司', '工银瑞信基金管理有限公司', '国机财务有限责任公司', '中国人保资产管理股份有限公司', '定价', '金小红', '雅戈尔投资有限公司', '12'}",17,"{'20000000', '现金', '江苏瑞华投资发展有限公司', '工银瑞信基金管理有限公司', '国机财务有限责任公司', '中国人保资产管理股份有限公司', '18000000', '15000000', '金小红', '定价', '21000000', '雅戈尔投资有限公司', '130000000', '富国基金管理有限公司-汉盛证券投资基金', '中海基金管理有限公司-中海能源策略混合型证券投资基金', '30000000', '12'}"
17,"{'现金', '石河子城市建设投资经营有限公司', '金石期货有限公司', '100000000', '843000000', '石河子市天信投资发展有限公司', '定价', '八师石河子现代农业投资有限公司', '14306151', '石河子天富智盛股权投资有限公司', '300000000', '7153075', '50000000', '120600858', '深圳信时投资合伙企业(有限合伙)', '42918454', '36'}",16373188,3,"{'100000000', '843000000', '300000000'}",8,"{'36', '现金', '石河子城市建设投资经营有限公司', '金石期货有限公司', '石河子市天信投资发展有限公司', '定价', '八师石河子现代农业投资有限公司', '石河子天富智盛股权投资有限公司'}",14,"{'现金', '石河子城市建设投资经营有限公司', '金石期货有限公司', '石河子市天信投资发展有限公司', '定价', '八师石河子现代农业投资有限公司', '14306151', '石河子天富智盛股权投资有限公司', '7153075', '50000000', '120600858', '深圳信时投资合伙企业(有限合伙)', '42918454', '36'}"
13,"{'广发证券资产管理(广东)有限公司', '韬蕴(北京)投资控股有限公司', '现金', '10938924', '上海中植鑫荞投资管理有限公司', '124999990.6', '5697356', '5469462', '长江证券(上海)资产管理有限公司', '239999992.6', '115000001.9', '119999996.3', '5241568'}",1811476,2,"{'119999996.3', '239999992.6'}",4,"{'上海中植鑫荞投资管理有限公司', '韬蕴(北京)投资控股有限公司', '现金', '长江证券(上海)资产管理有限公司'}",11,"{'广发证券资产管理(广东)有限公司', '韬蕴(北京)投资控股有限公司', '现金', '10938924', '上海中植鑫荞投资管理有限公司', '124999990.6', '5697356', '5469462', '长江证券(上海)资产管理有限公司', '115000001.9', '5241568'}"
14,"{'阿里创投', '62005519', '定价', '1533396485', '平安资管', '1279999996', '腾讯计算机', '51758997', '106603512.1', '中信建投', '27496967', '679999993.9', '36', '4310696'}",1736081,3,"{'1279999996', '106603512.1', '1533396485'}",6,"{'阿里创投', '定价', '平安资管', '腾讯计算机', '中信建投', '36'}",11,"{'阿里创投', '62005519', '定价', '平安资管', '腾讯计算机', '51758997', '中信建投', '27496967', '679999993.9', '36', '4310696'}"
6,"{'49999989.42', '现金', '新疆生产建设兵团建设工程(集团)有限责任公司', '4051863', '竞价', '36'}",16937419,1,{'竞价'},2,"{'现金', '36'}",5,"{'49999989.42', '现金', '新疆生产建设兵团建设工程(集团)有限责任公司', '4051863', '36'}"
19,"{'1911764', '天津六禾碧云股权投资基金合伙企业(有限合伙)', '8600000', '景隆融尊(天津)股权投资基金合伙企业(有限合伙)', '徐立勋', '博弘数君(天津)股权投资基金合伙企业(有限合伙)', '西藏自治区投资有限公司', '竞价', '10100000', '江西新拓投资股份有限公司', '9800000', '王宏涛', '文登金滩投资管理有限公司', '天津武科创盈联股权投资基金合伙企业(有限合伙)', '7900000', '9000000', '7800000', '上海凯思依投资管理合伙企业(有限合伙)', '12'}",209570,2,"{'1911764', '竞价'}",6,"{'徐立勋', '西藏自治区投资有限公司', '王宏涛', '江西新拓投资股份有限公司', '文登金滩投资管理有限公司', '12'}",17,"{'天津六禾碧云股权投资基金合伙企业(有限合伙)', '8600000', '景隆融尊(天津)股权投资基金合伙企业(有限合伙)', '徐立勋', '博弘数君(天津)股权投资基金合伙企业(有限合伙)', '西藏自治区投资有限公司', '10100000', '9800000', '江西新拓投资股份有限公司', '王宏涛', '文登金滩投资管理有限公司', '天津武科创盈联股权投资基金合伙企业(有限合伙)', '7900000', '7800000', '9000000', '上海凯思依投资管理合伙企业(有限合伙)', '12'}"
4,"{'竞价', '现金', '36', '杭州澜华投资管理有限公司'}",1105312,0,set(),4,"{'竞价', '现金', '36', '杭州澜华投资管理有限公司'}",4,"{'竞价', '现金', '36', '杭州澜华投资管理有限公司'}"
27,"{'博时资本管理有限公司', '安徽省铁路建设投资基金有限公司', '302999978.6', '11863758', '泰达宏利基金管理有限公司', '现金', '352999994.9', '13509376', '12246460', '11595866', '财通基金管理有限公司', '309999996.5', '22962112', '竞价', '319999999.8', '599999986.6', '712999981.6', '农银汇理(上海)资产管理有限公司', '国华人寿保险股份有限公司', '章小格', '27286643', '299999993.3', '3865291', '101000053.8', '中广核资本控股有限公司', '11481056', '12'}",1720856,6,"{'712999981.6', '352999994.9', '302999978.6', '299999993.3', '309999996.5', '599999986.6'}",9,"{'现金', '博时资本管理有限公司', '安徽省铁路建设投资基金有限公司', '国华人寿保险股份有限公司', '章小格', '财通基金管理有限公司', '竞价', '中广核资本控股有限公司', '12'}",21,"{'博时资本管理有限公司', '安徽省铁路建设投资基金有限公司', '11863758', '泰达宏利基金管理有限公司', '现金', '13509376', '12246460', '11595866', '财通基金管理有限公司', '22962112', '竞价', '319999999.8', '农银汇理(上海)资产管理有限公司', '国华人寿保险股份有限公司', '章小格', '27286643', '3865291', '101000053.8', '中广核资本控股有限公司', '11481056', '12'}"
5,"{'现金', '竞价', '2500000000', '国第二重型机械集团公司', '36'}",498294,1,{'2500000000'},4,"{'现金', '竞价', '国第二重型机械集团公司', '36'}",4,"{'现金', '竞价', '国第二重型机械集团公司', '36'}"
11,"{'63759007.4', '236999905.8', '34999940', '申万菱信(上海)资产管理有限公司', '财通基金管理有限公司', '528700', '竞价', '963127', '3580059', '12', '泓德基金管理有限公司'}",9892141,1,{'竞价'},1,{'12'},10,"{'63759007.4', '236999905.8', '34999940', '申万菱信(上海)资产管理有限公司', '财通基金管理有限公司', '528700', '963127', '3580059', '12', '泓德基金管理有限公司'}"
13,"{'现金', '华安基金管理有限公司', '34000000', '定价', '18000000', '15000000', '国泰君安员工持股1号-宜宾五粮液第1期员工持股计划定向资产管理计划', '22000000', '11000000', '泰康资产管理有限责任公司', '凯联(北京)投资基金管理有限公司拟筹建和管理的私募投资基金', '国泰君安君享五粮液1号集合资产管理计划', '36'}",6549521,6,"{'34000000', '18000000', '15000000', '22000000', '11000000', '凯联(北京)投资基金管理有限公司拟筹建和管理的私募投资基金'}",5,"{'现金', '华安基金管理有限公司', '定价', '泰康资产管理有限责任公司', '36'}",7,"{'现金', '华安基金管理有限公司', '定价', '国泰君安员工持股1号-宜宾五粮液第1期员工持股计划定向资产管理计划', '泰康资产管理有限责任公司', '国泰君安君享五粮液1号集合资产管理计划', '36'}"
10,"{'黄祥飞', '田南律', '王少华', '饶琦', '任卫峰', '琚克刚', '吴如舟', '2600000', '3600000', '8200000'}",1593907,1,{'2600000'},7,"{'黄祥飞', '田南律', '王少华', '饶琦', '任卫峰', '琚克刚', '吴如舟'}",9,"{'黄祥飞', '田南律', '王少华', '饶琦', '任卫峰', '琚克刚', '吴如舟', '3600000', '8200000'}"
6,"{'现金', '德润天清', '李云春', '高新资本', '润泰投资', '36'}",398440,0,set(),6,"{'现金', '德润天清', '李云春', '高新资本', '润泰投资', '36'}",6,"{'现金', '德润天清', '李云春', '高新资本', '润泰投资', '36'}"
14,"{'109999986.5', '4829270', '现金', '第一创业证券股份有限公司', '99000035', '博时基金管理有限公司', '中广核财务有限责任公司', '5365853', '财通基金管理有限公司', '竞价', '120999999.5', '5902439', '襄垣县永利科技有限公司', '12'}",2260458,1,{'竞价'},7,"{'现金', '第一创业证券股份有限公司', '博时基金管理有限公司', '中广核财务有限责任公司', '财通基金管理有限公司', '襄垣县永利科技有限公司', '12'}",13,"{'109999986.5', '4829270', '现金', '第一创业证券股份有限公司', '99000035', '博时基金管理有限公司', '中广核财务有限责任公司', '5365853', '财通基金管理有限公司', '120999999.5', '5902439', '襄垣县永利科技有限公司', '12'}"
5,"{'郑康定', '5700000', '6300000', '36', '任伟达'}",1166329,0,set(),3,"{'郑康定', '36', '任伟达'}",5,"{'郑康定', '5700000', '6300000', '36', '任伟达'}"
15,"{'现金', '55848280', '1119758014', '许锦光', '95204537.8', '周镇科', '76163634.25', '陈少达', '4748356', '8547041', '黄永建', '3798685', '171368172.1', '陈乐强', '36'}",1785208,1,{'171368172.1'},7,"{'现金', '许锦光', '周镇科', '陈少达', '黄永建', '陈乐强', '36'}",14,"{'现金', '55848280', '1119758014', '许锦光', '95204537.8', '周镇科', '76163634.25', '陈少达', '4748356', '8547041', '黄永建', '3798685', '陈乐强', '36'}"
11,"{'122310000', '中兵投资管理有限责任公司', '兵工财务有限责任公司', '18000000', '汇添富-光电制导1号资产管理计划', '244620000', '汇添富-光电制导2号资产管理计划', '9000000', '611550000', '36', '45000000'}",1861631,1,{'45000000'},3,"{'兵工财务有限责任公司', '中兵投资管理有限责任公司', '36'}",10,"{'122310000', '中兵投资管理有限责任公司', '兵工财务有限责任公司', '18000000', '汇添富-光电制导1号资产管理计划', '244620000', '汇添富-光电制导2号资产管理计划', '9000000', '611550000', '36'}"
27,"{'20000000', '563520000', '上海丰澳投资合伙企业(有限合伙)', '48000000', '黄小刚', '杨竞忠', '深圳国金创业投资企业(有限合伙)', '现金', '谭军', '293500000', '江苏五友投资发展有限公司', '7155000', '599999900', '180000000', '51107300', '嘉兴厚泽股权投资合伙企业(有限合伙)', '25000000', '128056200', '上海跻迈投资管理有限公司', '28610100', '83999900', '1503379900', '335999900', '15332200', '36', '234800000', '青岛龙力生物技术有限公司'}",90342,13,"{'51107300', '128056200', '293500000', '563520000', '28610100', '83999900', '1503379900', '335999900', '7155000', '599999900', '180000000', '15332200', '234800000'}",8,"{'现金', '谭军', '上海跻迈投资管理有限公司', '江苏五友投资发展有限公司', '黄小刚', '36', '杨竞忠', '青岛龙力生物技术有限公司'}",14,"{'20000000', '深圳国金创业投资企业(有限合伙)', '现金', '谭军', '青岛龙力生物技术有限公司', '上海跻迈投资管理有限公司', '江苏五友投资发展有限公司', '上海丰澳投资合伙企业(有限合伙)', '25000000', '48000000', '黄小刚', '36', '杨竞忠', '嘉兴厚泽股权投资合伙企业(有限合伙)'}"
18,"{'23453125', '现金', '48187500', '蒋小三', '唐笑波', '定价', '李先桃', '6250000', '1234375', '12500000', '25000000', '秦本军', '吴军凡', '天堂硅谷合行', '股权', '36', '37500000', '天堂硅谷奕新'}",4942658,7,"{'23453125', '48187500', '6250000', '1234375', '12500000', '25000000', '37500000'}",11,"{'现金', '蒋小三', '唐笑波', '定价', '李先桃', '秦本军', '吴军凡', '天堂硅谷合行', '股权', '36', '天堂硅谷奕新'}",11,"{'现金', '蒋小三', '股权', '唐笑波', '定价', '李先桃', '秦本军', '天堂硅谷合行', '吴军凡', '36', '天堂硅谷奕新'}"
27,"{'上海再行物资有限公司', '113720060', '9130000', '9059050', '168000800', '建信基金管理有限责任公司', '260902800', '现金', '定价', '5686003', '财通基金管理有限公司', '10005000', '宝盈基金管理有限公司', '216000000', '13045140', '国华人寿保险股份有限公司', '181181000', '333900000', '182600000', '中国长城资产管理公司', '16695000', '8400040', '10800000', '宁波市星通投资管理有限公司', '华宝信托有限责任公司', '200100000', '12'}",1755110,0,set(),11,"{'上海再行物资有限公司', '现金', '12', '国华人寿保险股份有限公司', '定价', '财通基金管理有限公司', '华宝信托有限责任公司', '中国长城资产管理公司', '宝盈基金管理有限公司', '建信基金管理有限责任公司', '宁波市星通投资管理有限公司'}",27,"{'上海再行物资有限公司', '113720060', '9130000', '9059050', '168000800', '建信基金管理有限责任公司', '260902800', '现金', '定价', '5686003', '财通基金管理有限公司', '10005000', '宝盈基金管理有限公司', '216000000', '13045140', '国华人寿保险股份有限公司', '181181000', '333900000', '182600000', '中国长城资产管理公司', '16695000', '8400040', '10800000', '宁波市星通投资管理有限公司', '华宝信托有限责任公司', '200100000', '12'}"
6,"{'现金', '法国巴黎银行', '南京高科股份有限公司', '南京紫金投资集团有限责任公司', '竞价', '36'}",443685,0,set(),6,"{'现金', '法国巴黎银行', '南京高科股份有限公司', '南京紫金投资集团有限责任公司', '竞价', '36'}",6,"{'现金', '法国巴黎银行', '南京高科股份有限公司', '南京紫金投资集团有限责任公司', '竞价', '36'}"
21,"{'北京弘高慧目投资有限公司', '6056935', '850000000', '12113870', '金鹰基金管理有限公司拟设立的资产管理计划', '200000000', '18170805', '现金', '400000000', '三亚新沃豪泰投资管理中心(有限合伙)', '9085402', '24227740', '300000000', '150000000', '北京普临投资集团有限公司', '宁波厚扬方泰股权投资中心(有限合伙)', '51483949', '深圳前海宝盛伟业投资管理有限公司', '100000000', '朱登营', '36'}",1796074,10,"{'51483949', '150000000', '100000000', '6056935', '9085402', '24227740', '850000000', '12113870', '300000000', '18170805'}",8,"{'深圳前海宝盛伟业投资管理有限公司', '现金', '北京弘高慧目投资有限公司', '北京普临投资集团有限公司', '金鹰基金管理有限公司拟设立的资产管理计划', '朱登营', '200000000', '36'}",11,"{'深圳前海宝盛伟业投资管理有限公司', '现金', '400000000', '北京弘高慧目投资有限公司', '三亚新沃豪泰投资管理中心(有限合伙)', '北京普临投资集团有限公司', '宁波厚扬方泰股权投资中心(有限合伙)', '金鹰基金管理有限公司拟设立的资产管理计划', '朱登营', '200000000', '36'}"
6,"{'中国大唐集团有限公司', '现金', '定价', '8333999998', '2401729106', '36'}",20199509,1,{'8333999998'},3,"{'定价', '现金', '36'}",5,"{'中国大唐集团有限公司', '现金', '定价', '2401729106', '36'}"
5,"{'中盛集团', '现金', '100000000', '竞价', '36'}",6344076,1,{'100000000'},4,"{'中盛集团', '现金', '竞价', '36'}",4,"{'中盛集团', '现金', '竞价', '36'}"
4,"{'张仁华', '竞价', '现金', '36'}",1778547,1,{'竞价'},3,"{'张仁华', '现金', '36'}",3,"{'张仁华', '现金', '36'}"
14,"{'9700000', '108252000', '23990000', '定价', '267728400', '东海基金管理有限责任公司', '财通基金管理有限公司', '7000000', '国联安基金管理有限公司', '78120000', '宝盈基金管理有限公司', '12', '6800000', '75888000'}",1570240,6,"{'9700000', '108252000', '267728400', '78120000', '6800000', '75888000'}",2,"{'定价', '12'}",8,"{'定价', '东海基金管理有限责任公司', '7000000', '财通基金管理有限公司', '国联安基金管理有限公司', '宝盈基金管理有限公司', '12', '23990000'}"
20,"{'陈宏', '张传义', '2200000', '浙江商裕开盛创业投资合伙企业(有限合伙)', '朱加林', '深圳秀水投资有限公司', '2000000', '1800000', '竞价', '山西信托有限责任公司', '3400000', '浙江宝兴股权投资合伙企业(有限合伙)', '2100000', '陈学东', '沈汉标', '2700000', '778873', '12', '2300000', '蔡丹'}",1219108,10,"{'2200000', '2000000', '1800000', '竞价', '山西信托有限责任公司', '3400000', '778873', '2100000', '2700000', '2300000'}",1,{'12'},10,"{'陈宏', '张传义', '浙江商裕开盛创业投资合伙企业(有限合伙)', '朱加林', '深圳秀水投资有限公司', '沈汉标', '浙江宝兴股权投资合伙企业(有限合伙)', '陈学东', '12', '蔡丹'}"
4,"{'现金', '中国国电', '626400000', '36'}",1124623,1,{'626400000'},3,"{'现金', '中国国电', '36'}",3,"{'现金', '中国国电', '36'}"
4,"{'通产集团有限公司', '竞价', '现金', '36'}",1355457,0,set(),4,"{'通产集团有限公司', '竞价', '现金', '36'}",4,"{'通产集团有限公司', '竞价', '现金', '36'}"
29,"{'283464566', '2159999993', '318897637', '215999994.7', '53149606', '李玲', '404999997.7', '674999998.7', '范先国', '28346456', '539999994.4', '竞价', '248031496', '王泽龙', '许刚', '42519685', '187795275', '魏兆琪', '和奔流', '1890000000', '谭瑞清', '王涛', '中国长城资产管理公司', '323999999.7', '1430999996', '2429999994', '88582677', '70866141', '36'}",14756071,5,"{'2159999993', '1890000000', '竞价', '1430999996', '2429999994'}",10,"{'范先国', '魏兆琪', '和奔流', '谭瑞清', '王涛', '中国长城资产管理公司', '王泽龙', '许刚', '36', '李玲'}",24,"{'283464566', '318897637', '215999994.7', '53149606', '李玲', '404999997.7', '674999998.7', '范先国', '28346456', '539999994.4', '248031496', '王泽龙', '许刚', '42519685', '187795275', '魏兆琪', '和奔流', '谭瑞清', '王涛', '中国长城资产管理公司', '323999999.7', '88582677', '70866141', '36'}"
3,"{'现金', '36', '深圳前海易德资本投资管理有限公司'}",724997,0,set(),3,"{'现金', '36', '深圳前海易德资本投资管理有限公司'}",3,"{'现金', '36', '深圳前海易德资本投资管理有限公司'}"
10,"{'8437035', '现金', '华夏基金管理有限公司', '12', '6896551', '武汉当代科技产业集团股份有限公司', '财通基金管理有限公司', '嘉实基金管理有限公司', '10000000', '36'}",1105892,0,set(),7,"{'现金', '华夏基金管理有限公司', '12', '武汉当代科技产业集团股份有限公司', '财通基金管理有限公司', '嘉实基金管理有限公司', '36'}",10,"{'8437035', '现金', '华夏基金管理有限公司', '12', '6896551', '武汉当代科技产业集团股份有限公司', '财通基金管理有限公司', '嘉实基金管理有限公司', '10000000', '36'}"
6,"{'中国信达资产管理股份有限公司', '现金', '1899999998', '定价', '36', '353159851'}",15702238,0,set(),4,"{'定价', '现金', '36', '中国信达资产管理股份有限公司'}",6,"{'中国信达资产管理股份有限公司', '现金', '1899999998', '定价', '36', '353159851'}"
5,"{'现金', '18002646', '竞价', '36', '虞兔良'}",1787409,1,{'18002646'},4,"{'竞价', '现金', '36', '虞兔良'}",4,"{'竞价', '现金', '36', '虞兔良'}"
4,"{'贺国英', '现金', '竞价', '36'}",2098367,0,set(),4,"{'贺国英', '现金', '竞价', '36'}",4,"{'贺国英', '现金', '竞价', '36'}"
4,"{'王冠一', '竞价', '现金', '36'}",1877970,0,set(),4,"{'王冠一', '竞价', '现金', '36'}",4,"{'王冠一', '竞价', '现金', '36'}"
17,"{'濮文', '5000000', '现金', '江苏瑞华投资发展有限公司', '1000000', '大成基金管理有限公司', '12', '万向财务有限公司', '定价', '重庆国龙实业有限公司', '2000000', '浙江实欣贸易有限公司', '易方达基金管理有限公司', '3000000', '左宗申', '10000000', '36'}",820092,0,set(),12,"{'濮文', '36', '现金', '江苏瑞华投资发展有限公司', '大成基金管理有限公司', '万向财务有限公司', '定价', '重庆国龙实业有限公司', '浙江实欣贸易有限公司', '易方达基金管理有限公司', '左宗申', '12'}",17,"{'濮文', '5000000', '现金', '江苏瑞华投资发展有限公司', '1000000', '大成基金管理有限公司', '12', '万向财务有限公司', '定价', '重庆国龙实业有限公司', '2000000', '浙江实欣贸易有限公司', '易方达基金管理有限公司', '3000000', '左宗申', '10000000', '36'}"
9,"{'48910154', '山东高速股份有限公司', '福建天宝矿业集团股份有限公司', '竞价', '中信证券股份有限公司', '42530568', '119989367', '12', '福建新联合投资有限责任公司'}",15033470,2,"{'竞价', '山东高速股份有限公司'}",4,"{'中信证券股份有限公司', '12', '福建天宝矿业集团股份有限公司', '福建新联合投资有限责任公司'}",7,"{'48910154', '福建天宝矿业集团股份有限公司', '中信证券股份有限公司', '42530568', '119989367', '12', '福建新联合投资有限责任公司'}"
20,"{'深圳海汇亚太投资基金管理有限公司', '现金', '84694000', '180200000', '9400000', '8600000', '4700000', '兴业全球基金管理有限公司', '2184000', '西南证券股份有限公司', '国联安基金管理有限公司', '财通基金管理有限公司', '融通基金管理有限公司', '39355680', '竞价', '宝盈基金管理有限公司', '154972000', '10000000', '12', '169388000'}",927065,7,"{'84694000', '39355680', '2184000', '180200000', '竞价', '154972000', '169388000'}",2,"{'现金', '12'}",13,"{'深圳海汇亚太投资基金管理有限公司', '现金', '兴业全球基金管理有限公司', '9400000', '8600000', '4700000', '西南证券股份有限公司', '国联安基金管理有限公司', '财通基金管理有限公司', '融通基金管理有限公司', '宝盈基金管理有限公司', '10000000', '12'}"
4,"{'东方新能源', '现金', '竞价', '12'}",1252674,0,set(),4,"{'东方新能源', '现金', '竞价', '12'}",4,"{'东方新能源', '现金', '竞价', '12'}"
5,"{'现金', '定价', '250000000', '冀中能源集团有限责任公司', '36'}",1133762,1,{'250000000'},4,"{'定价', '冀中能源集团有限责任公司', '现金', '36'}",4,"{'定价', '冀中能源集团有限责任公司', '现金', '36'}"
17,"{'招商财富资产管理有限公司', '双星集团有限责任公司', '20000000', '现金', '兴业全球基金管理有限公司', '12', '王敏', '18000000', '泰达宏利基金管理有限公司', '283439996', '120200000', '竞价', '108180000', '47161397', '46589018', '36', '279999998.2'}",315373,3,"{'283439996', '竞价', '279999998.2'}",7,"{'招商财富资产管理有限公司', '双星集团有限责任公司', '36', '现金', '兴业全球基金管理有限公司', '泰达宏利基金管理有限公司', '12'}",14,"{'招商财富资产管理有限公司', '双星集团有限责任公司', '20000000', '现金', '兴业全球基金管理有限公司', '12', '王敏', '18000000', '泰达宏利基金管理有限公司', '120200000', '108180000', '47161397', '46589018', '36'}"
6,"{'现金', '159396000', '竞价', '赣州市熠石股权投资中心(有限合伙)', '12', '14800000'}",16725580,0,set(),3,"{'竞价', '现金', '12'}",6,"{'现金', '159396000', '竞价', '赣州市熠石股权投资中心(有限合伙)', '12', '14800000'}"
5,"{'现金', '宁波和首股权投资合伙企业', '成都巨星博润投资有限公司', '辽宁辽鞍投资集团有限公司', '36'}",922322,0,set(),4,"{'成都巨星博润投资有限公司', '辽宁辽鞍投资集团有限公司', '现金', '宁波和首股权投资合伙企业'}",5,"{'现金', '宁波和首股权投资合伙企业', '成都巨星博润投资有限公司', '辽宁辽鞍投资集团有限公司', '36'}"
19,"{'15041387', '深圳前海宝盛伟业投资管理有限公司', '现金', '186250000', '北京弘高慧目投资有限公司', '124166700', '7520696', '三亚新沃豪泰投资管理中心(有限合伙)', '527708400', '定价', '5640520', '93125000', '朱登营', '北京普临投资集团有限公司', '金鹰穗通定增61号资产管理计划', '31962955', '36', '11281041', '248333300'}",4947724,10,"{'15041387', '186250000', '124166700', '7520696', '527708400', '93125000', '5640520', '31962955', '11281041', '248333300'}",7,"{'深圳前海宝盛伟业投资管理有限公司', '现金', '北京弘高慧目投资有限公司', '定价', '北京普临投资集团有限公司', '朱登营', '36'}",9,"{'深圳前海宝盛伟业投资管理有限公司', '现金', '北京弘高慧目投资有限公司', '三亚新沃豪泰投资管理中心(有限合伙)', '定价', '北京普临投资集团有限公司', '金鹰穗通定增61号资产管理计划', '朱登营', '36'}"
3,"{'高新地产', '竞价', '36'}",14759629,0,set(),3,"{'高新地产', '竞价', '36'}",3,"{'高新地产', '竞价', '36'}"
4,"{'高速集团', '竞价', '现金', '36'}",198409,0,set(),4,"{'高速集团', '竞价', '现金', '36'}",4,"{'高速集团', '竞价', '现金', '36'}"
22,"{'11655012', '13986013', '深圳天风天成资产管理有限公司', '浙报传媒控股集团有限公司', '199999988.8', '泰达宏利基金管理有限公司', '11655011', '现金', '鹏华资产管理有限公司', '17540792', '23834502', '239999983.1', '竞价', '409000054.3', '广东省铁路发展基金有限责任公司', '36', '北信瑞丰基金管理有限公司', '200000005.9', '金元顺安基金管理有限公司', '300999990.7', '安信基金管理有限责任公司', '12'}",15561860,3,"{'239999983.1', '竞价', '199999988.8'}",11,"{'现金', '北信瑞丰基金管理有限公司', '鹏华资产管理有限公司', '深圳天风天成资产管理有限公司', '12', '浙报传媒控股集团有限公司', '金元顺安基金管理有限公司', '安信基金管理有限责任公司', '泰达宏利基金管理有限公司', '广东省铁路发展基金有限责任公司', '36'}",19,"{'11655012', '11655011', '现金', '北信瑞丰基金管理有限公司', '鹏华资产管理有限公司', '13986013', '深圳天风天成资产管理有限公司', '17540792', '12', '23834502', '浙报传媒控股集团有限公司', '金元顺安基金管理有限公司', '300999990.7', '安信基金管理有限责任公司', '409000054.3', '泰达宏利基金管理有限公司', '广东省铁路发展基金有限责任公司', '36', '200000005.9'}"
5,"{'吴镇发', '现金', '1894410', '299998768', '36'}",96412,1,{'299998768'},3,"{'吴镇发', '现金', '36'}",4,"{'吴镇发', '现金', '36', '1894410'}"
9,"{'1305293', '现金', '第一创业证券股份有限公司', '89999952.35', '358754296.6', '财通基金管理有限公司', '竞价', '5203108', '12'}",12056486,2,"{'竞价', '5203108'}",2,"{'现金', '12'}",7,"{'1305293', '现金', '第一创业证券股份有限公司', '89999952.35', '358754296.6', '财通基金管理有限公司', '12'}"
9,"{'99999992.33', '60638874', '现金', '定价', '7218913', '华易投资', '喜临门家具股份有限公司2015年度第一期员工持股计划', '840000002.1', '36'}",14944804,2,"{'99999992.33', '840000002.1'}",4,"{'36', '定价', '现金', '华易投资'}",7,"{'60638874', '现金', '定价', '7218913', '华易投资', '喜临门家具股份有限公司2015年度第一期员工持股计划', '36'}"
22,"{'12000000', '20000000', '132800000', '169320000', '9277532', '8000000', '现金', '亨通集团有限公司', '工银瑞信基金管理有限公司', '199200000', '定价', '财通基金管理有限公司', '154007047.8', '36', '9277533', '博时基金管理有限公司', '东海基金管理有限责任公司', '10200000', '332000000', '融通基金管理有限公司', '154007031.2', '12'}",925664,0,set(),10,"{'36', '现金', '亨通集团有限公司', '工银瑞信基金管理有限公司', '博时基金管理有限公司', '融通基金管理有限公司', '东海基金管理有限责任公司', '财通基金管理有限公司', '定价', '12'}",22,"{'12000000', '20000000', '132800000', '169320000', '9277532', '8000000', '现金', '亨通集团有限公司', '工银瑞信基金管理有限公司', '199200000', '定价', '财通基金管理有限公司', '154007047.8', '36', '9277533', '博时基金管理有限公司', '东海基金管理有限责任公司', '10200000', '332000000', '融通基金管理有限公司', '154007031.2', '12'}"
18,"{'20000000', '现金', '青岛海湾集团有限公司', '12', '13000000', '定价', '15000000', '诺安基金管理有限公司', '易方达基金管理有限公司', '海通证券股份有限公司', '昊华海通投资管理有限公司', '裘凯平', '6000000', '10000000', '20660000', '青岛华通国有资本运营(集团)有限责任公司', '36', '青岛国信发展(集团)有限责任公司'}",1209919,5,"{'20000000', '13000000', '15000000', '10000000', '20660000'}",9,"{'现金', '青岛海湾集团有限公司', '诺安基金管理有限公司', '定价', '易方达基金管理有限公司', '海通证券股份有限公司', '昊华海通投资管理有限公司', '裘凯平', '12'}",13,"{'36', '现金', '青岛海湾集团有限公司', '诺安基金管理有限公司', '定价', '易方达基金管理有限公司', '海通证券股份有限公司', '昊华海通投资管理有限公司', '6000000', '裘凯平', '青岛华通国有资本运营(集团)有限责任公司', '12', '青岛国信发展(集团)有限责任公司'}"
27,"{'37499932', '7340395', '450003600', '899998368', '申万菱信基金管理有限公司', '176169480', '四川产业振兴发展投资基金有限公司', '现金', '890787888', '22916666', '18750150', '财通基金管理有限公司', '18929508', '竞价', '454308192', '平安大华基金管理有限公司', '549999984', '450000000', '国泰基金管理有限公司', '37116162', '628732488', '18750000', '广东宝丽华新能源股份有限公司', '渤海证券股份有限公司', '26197187', '创金合信基金管理有限公司', '12'}",1653037,1,{'竞价'},10,"{'平安大华基金管理有限公司', '四川产业振兴发展投资基金有限公司', '现金', '广东宝丽华新能源股份有限公司', '财通基金管理有限公司', '国泰基金管理有限公司', '渤海证券股份有限公司', '申万菱信基金管理有限公司', '创金合信基金管理有限公司', '12'}",26,"{'37499932', '7340395', '450003600', '899998368', '申万菱信基金管理有限公司', '176169480', '四川产业振兴发展投资基金有限公司', '现金', '890787888', '22916666', '18750150', '财通基金管理有限公司', '18929508', '454308192', '平安大华基金管理有限公司', '549999984', '450000000', '国泰基金管理有限公司', '37116162', '628732488', '18750000', '广东宝丽华新能源股份有限公司', '渤海证券股份有限公司', '26197187', '创金合信基金管理有限公司', '12'}"
20,"{'30000000000', '现金', '齐鲁证券有限公司', '大成基金管理有限公司', '12', '4000000', '定价', '中国银河投资管理有限公司', '4300000', '50000000000', '32000000000', '天津瑞通股权投资基金合伙企业(有限合伙)', '盛世金泉(天津)股权投资基金管理有限公司', '40000000000', '8221520000', '西安长迪投资管理有限合伙企业', '西安长国投资管理有限合伙企业', '深圳市南方同正投资有限公司', '36', '10423830'}",1323269,2,"{'8221520000', '32000000000'}",10,"{'36', '现金', '齐鲁证券有限公司', '大成基金管理有限公司', '12', '定价', '中国银河投资管理有限公司', '西安长迪投资管理有限合伙企业', '西安长国投资管理有限合伙企业', '深圳市南方同正投资有限公司'}",18,"{'30000000000', '现金', '齐鲁证券有限公司', '大成基金管理有限公司', '12', '4000000', '50000000000', '中国银河投资管理有限公司', '4300000', '定价', '天津瑞通股权投资基金合伙企业(有限合伙)', '盛世金泉(天津)股权投资基金管理有限公司', '40000000000', '西安长迪投资管理有限合伙企业', '西安长国投资管理有限合伙企业', '深圳市南方同正投资有限公司', '36', '10423830'}"
5,"{'现金', '定价', '苏州鑫德诚股权投资合伙企业', '上海六禾芳甸投资中心', '36'}",576538,0,set(),4,"{'上海六禾芳甸投资中心', '定价', '现金', '苏州鑫德诚股权投资合伙企业'}",5,"{'现金', '定价', '苏州鑫德诚股权投资合伙企业', '上海六禾芳甸投资中心', '36'}"
18,"{'12000000', '5000000', '现金', '16000000', '华源投资有限公司', '15000000', '招商基金管理有限公司', '长江证券有限责任公司', '国泰基金管理有限公司', '竞价', '兴业基金管理有限公司', '长江交通科技股份有限公司', '北京华天瑞海投资顾问有限公司', '诚泰集团有限公司', '大连正源企业有限公司', '9000000', '12', '中国国际金融有限公司'}",920870,7,"{'12000000', '5000000', '现金', '16000000', '15000000', '竞价', '9000000'}",1,{'12'},11,"{'华源投资有限公司', '招商基金管理有限公司', '长江证券有限责任公司', '国泰基金管理有限公司', '兴业基金管理有限公司', '长江交通科技股份有限公司', '北京华天瑞海投资顾问有限公司', '诚泰集团有限公司', '大连正源企业有限公司', '12', '中国国际金融有限公司'}"
4,"{'36', '金霞', '现金', '64000000'}",16377164,1,{'64000000'},3,"{'金霞', '现金', '36'}",3,"{'金霞', '现金', '36'}"
9,"{'20000000', '华安基金管理有限公司', '30300000', '绍兴万林股权投资基金合伙企业(有限合伙)', '中国北方工业公司', '19670000', '竞价', '广州金控资产管理有限公司', '30030000'}",15362596,1,{'30030000'},4,"{'广州金控资产管理有限公司', '竞价', '华安基金管理有限公司', '中国北方工业公司'}",8,"{'20000000', '华安基金管理有限公司', '30300000', '绍兴万林股权投资基金合伙企业(有限合伙)', '中国北方工业公司', '19670000', '竞价', '广州金控资产管理有限公司'}"
18,"{'太平洋资产管理有限责任公司', '现金', '华夏资本管理有限公司', '张观福', '孙飏', '3189700', '兴业全球基金管理有限公司', '窦啟玲', '12', '3508700', '广发基金管理有限公司', '竞价', '中银基金管理有限公司', '4753200', '4784600', '7017500', '36', '5741600'}",1024279,0,set(),11,"{'太平洋资产管理有限责任公司', '现金', '华夏资本管理有限公司', '张观福', '孙飏', '12', '窦啟玲', '广发基金管理有限公司', '竞价', '中银基金管理有限公司', '36'}",18,"{'太平洋资产管理有限责任公司', '华夏资本管理有限公司', '张观福', '孙飏', '兴业全球基金管理有限公司', '3189700', '4753200', '窦啟玲', '12', '3508700', '现金', '广发基金管理有限公司', '中银基金管理有限公司', '竞价', '4784600', '7017500', '36', '5741600'}"
17,"{'99999971.75', '第一创业证券股份有限公司', '信诚基金管理有限公司', '2281879', '2684563', '84999992.75', '154760042', '嘉实基金管理有限公司', '167999995.8', '财通基金管理有限公司', '竞价', '申万菱信基金管理有限公司', '329999985', '8859060', '4154632', '12', '4510067'}",14760381,4,"{'99999971.75', '竞价', '84999992.75', '167999995.8'}",6,"{'第一创业证券股份有限公司', '信诚基金管理有限公司', '嘉实基金管理有限公司', '财通基金管理有限公司', '申万菱信基金管理有限公司', '12'}",13,"{'第一创业证券股份有限公司', '信诚基金管理有限公司', '2281879', '2684563', '154760042', '嘉实基金管理有限公司', '财通基金管理有限公司', '申万菱信基金管理有限公司', '329999985', '8859060', '4154632', '12', '4510067'}"
4,"{'中化股份', '现金', '竞价', '36'}",142189,0,set(),4,"{'中化股份', '现金', '竞价', '36'}",4,"{'中化股份', '现金', '竞价', '36'}"
5,"{'现金', '600000000', '崔根良', '竞价', '36'}",15131555,0,set(),4,"{'崔根良', '现金', '竞价', '36'}",5,"{'现金', '600000000', '崔根良', '竞价', '36'}"
17,"{'金鹰基金管理有限公司', '52468451', '664986028.3', '华安基金管理有限公司', '52818928', '定价', '719921988.6', '715144987.1', '44015774', '中欧盛世资产管理(上海)有限公司', '22011151', '48788410', '300011988.1', '599934999.6', '前海开源基金管理有限公司', '鹏华资产管理(深圳)有限公司', '12'}",4942025,0,set(),5,"{'金鹰基金管理有限公司', '华安基金管理有限公司', '定价', '前海开源基金管理有限公司', '12'}",17,"{'金鹰基金管理有限公司', '52468451', '664986028.3', '华安基金管理有限公司', '52818928', '定价', '719921988.6', '715144987.1', '44015774', '中欧盛世资产管理(上海)有限公司', '22011151', '48788410', '300011988.1', '599934999.6', '前海开源基金管理有限公司', '鹏华资产管理(深圳)有限公司', '12'}"
15,"{'现金', '安徽省铁路发展基金股份有限公司', '210000025.6', '15169902', '249999985', '广东联塑科技实业有限公司', '12742720', '239999986.9', '14563106', '嘉实基金管理有限公司', '易方达基金管理有限公司', '竞价', '499999986.4', '30339805', '12'}",14781052,3,"{'249999985', '竞价', '239999986.9'}",6,"{'现金', '安徽省铁路发展基金股份有限公司', '广东联塑科技实业有限公司', '嘉实基金管理有限公司', '易方达基金管理有限公司', '12'}",12,"{'现金', '安徽省铁路发展基金股份有限公司', '210000025.6', '15169902', '广东联塑科技实业有限公司', '12742720', '14563106', '嘉实基金管理有限公司', '易方达基金管理有限公司', '499999986.4', '30339805', '12'}"
9,"{'牧原集团', '现金', '牧原食品股份有限公司第二期员工持股计划', '定价', '86614200', '2136774300', '1000000000', '40535100', '36'}",12020353,4,"{'2136774300', '1000000000', '40535100', '86614200'}",4,"{'36', '牧原集团', '定价', '现金'}",5,"{'牧原集团', '现金', '牧原食品股份有限公司第二期员工持股计划', '定价', '36'}"
6,"{'现金', '西北院', '23500000', '西安航天', '1500000', '36'}",1358731,1,{'23500000'},4,"{'现金', '西北院', '36', '西安航天'}",5,"{'现金', '西北院', '西安航天', '1500000', '36'}"
15,"{'皇庭投资', '霍孝谦', '1200000000', '600000000', '和瑞九鼎', '59820538', '定价', '119641076', '109409222', '9970089', '100000000', '陈巧玲', '皇庭金融控股', '1097374500', '36'}",75990,3,"{'100000000', '1097374500', '600000000'}",7,"{'皇庭投资', '霍孝谦', '和瑞九鼎', '定价', '陈巧玲', '皇庭金融控股', '36'}",12,"{'皇庭投资', '霍孝谦', '1200000000', '和瑞九鼎', '59820538', '定价', '119641076', '109409222', '9970089', '陈巧玲', '皇庭金融控股', '36'}"
4,"{'嘉化集团', '竞价', '现金', '36'}",9878020,0,set(),4,"{'嘉化集团', '竞价', '现金', '36'}",4,"{'嘉化集团', '竞价', '现金', '36'}"
23,"{'16100000', '10774676', '申万菱信(上海)资产管理有限公司', '海通证券股份有限公司', '申万菱信基金管理有限公司', '12500000', '150850500', '256070600', '定价', '17060000', '184623000', '财通基金管理有限公司', '10050000', '241661000', '161727886.8', '东海基金管理有限责任公司', '12300000', '187625000', '广发证券资产管理(广东)有限公司', '14200000', '渤海证券股份有限公司', '213142000', '12'}",1642260,1,{'161727886.8'},6,"{'定价', '东海基金管理有限责任公司', '渤海证券股份有限公司', '海通证券股份有限公司', '申万菱信基金管理有限公司', '12'}",22,"{'16100000', '10774676', '申万菱信(上海)资产管理有限公司', '海通证券股份有限公司', '申万菱信基金管理有限公司', '12500000', '150850500', '256070600', '17060000', '184623000', '定价', '财通基金管理有限公司', '10050000', '241661000', '东海基金管理有限责任公司', '12300000', '187625000', '广发证券资产管理(广东)有限公司', '14200000', '渤海证券股份有限公司', '213142000', '12'}"
21,"{'会稽山第一期员工持股计划', '20000000', '上海大丰', '32000000', '412500000', '41250000', '3000000', '北京合聚天建', '5000000', '现金', '定价', '440000000', '68750000', '30000000', '275000000', '103125000', '7500000', '宁波信达风盛', '精功集团', '中汇同创', '36'}",1815423,7,"{'5000000', '412500000', '275000000', '41250000', '103125000', '440000000', '68750000'}",9,"{'会稽山第一期员工持股计划', '现金', '上海大丰', '宁波信达风盛', '精功集团', '中汇同创', '定价', '36', '北京合聚天建'}",14,"{'会稽山第一期员工持股计划', '20000000', '现金', '上海大丰', '宁波信达风盛', '精功集团', '中汇同创', '定价', '32000000', '3000000', '30000000', '36', '北京合聚天建', '7500000'}"
23,"{'2799999997', '2119999997', '17407800009', '9671000005', '财通基金', '2199999998', '现金', '1555555554', '1544399998', '华安资产', '招商财富', '1222222221', '1177777776', '2227799997', '包钢集团', '理家盈', '1237666665', '1499999998', '833333332', '国华人寿', '857999999', '36', '上海六禾'}",1651732,3,"{'2119999997', '2199999998', '1499999998'}",9,"{'现金', '华安资产', '包钢集团', '招商财富', '理家盈', '国华人寿', '36', '财通基金', '上海六禾'}",20,"{'857999999', '2799999997', '1555555554', '1237666665', '现金', '上海六禾', '2227799997', '1544399998', '17407800009', '包钢集团', '华安资产', '招商财富', '833333332', '理家盈', '国华人寿', '9671000005', '1222222221', '36', '财通基金', '1177777776'}"
24,"{'博时资本管理有限公司', '269373742.2', '海通证券股份有限公司', '200000000.5', '现金', '14496189', '定价', '17082787', '130000009.1', '财通基金管理有限公司', '170309996.4', '110315998.3', '35397338', '26281209', '14454664', '22379763', '田刚', '国华人寿保险股份有限公司', '谭久刚', '110000259.4', '杭州旭达贸易有限公司', '12', '109999993', '14454699'}",1755413,6,"{'110000259.4', '269373742.2', '定价', '130000009.1', '110315998.3', '200000000.5'}",9,"{'现金', '博时资本管理有限公司', '田刚', '国华人寿保险股份有限公司', '杭州旭达贸易有限公司', '财通基金管理有限公司', '海通证券股份有限公司', '谭久刚', '12'}",18,"{'22379763', '现金', '博时资本管理有限公司', '田刚', '14496189', '国华人寿保险股份有限公司', '杭州旭达贸易有限公司', '17082787', '财通基金管理有限公司', '170309996.4', '35397338', '海通证券股份有限公司', '26281209', '谭久刚', '14454664', '12', '109999993', '14454699'}"
11,"{'福建华映显示科技有限公司', '现金', '厦门建发集团有限公司', '华映视讯(吴江)有限公司', '15873015', '9523809', '47619047', '定价', '华映光电股份有限公司', '79365079', '36'}",152561,0,set(),6,"{'福建华映显示科技有限公司', '厦门建发集团有限公司', '现金', '定价', '华映光电股份有限公司', '36'}",11,"{'福建华映显示科技有限公司', '厦门建发集团有限公司', '现金', '华映视讯(吴江)有限公司', '15873015', '9523809', '47619047', '定价', '华映光电股份有限公司', '79365079', '36'}"
12,"{'王建强', '5000000', '现金', '盛小荣', '胡季强', '康恩贝集团有限公司', '赵军', '胡孙树', '8000000', '28000000', '36', '45000000'}",149287,3,"{'5000000', '28000000', '45000000'}",8,"{'王建强', '现金', '胡季强', '康恩贝集团有限公司', '赵军', '胡孙树', '盛小荣', '36'}",9,"{'王建强', '现金', '盛小荣', '胡季强', '康恩贝集团有限公司', '赵军', '胡孙树', '8000000', '36'}"
13,"{'18059130', '马佳圳', '现金', '27700000', '10829759', '马镇鑫', '马丹洁', '277930000', '陈庚达', '166670000', '竞价', '1799870', '36'}",1662547,1,{'竞价'},6,"{'马佳圳', '现金', '马镇鑫', '马丹洁', '陈庚达', '36'}",12,"{'18059130', '马佳圳', '现金', '27700000', '10829759', '马镇鑫', '马丹洁', '277930000', '陈庚达', '166670000', '1799870', '36'}"
10,"{'现金', '北信瑞丰基金管理有限公司', '31446540', '15723270', '定价', '民生证券股份有限公司', '299999991.6', '149999995.8', '12', '盛春林'}",16911182,0,set(),3,"{'定价', '现金', '12'}",10,"{'现金', '北信瑞丰基金管理有限公司', '31446540', '15723270', '定价', '民生证券股份有限公司', '299999991.6', '149999995.8', '12', '盛春林'}"
12,"{'现金', '1000000000', '21720243', '竞价', '43440486', '北京京国瑞国企改革发展基金(有限合伙)', '65160729', '1500000000', '500000000', '三胞集团南京投资管理有限公司', '上海懿兆实业投资有限公司', '36'}",2416791,3,"{'1000000000', '竞价', '1500000000'}",4,"{'三胞集团南京投资管理有限公司', '现金', '上海懿兆实业投资有限公司', '36'}",9,"{'现金', '21720243', '43440486', '北京京国瑞国企改革发展基金(有限合伙)', '65160729', '500000000', '三胞集团南京投资管理有限公司', '上海懿兆实业投资有限公司', '36'}"
5,"{'祺禧投资', '现金', '浙报控股', '竞价', '36'}",150049,0,set(),5,"{'祺禧投资', '现金', '浙报控股', '竞价', '36'}",5,"{'祺禧投资', '现金', '浙报控股', '竞价', '36'}"
13,"{'5000000', '现金', '8000000', '中天证券有限责任公司', '东方华夏创业投资有限公司', '诺安基金管理有限公司', '4000000', '中原证券股份有限公司', '中国平安人寿保险股份有限公司', '深圳市东方泓达投资有限公司', '东吴证券有限责任公司', '9000000', '12'}",533470,0,set(),7,"{'现金', '中天证券有限责任公司', '东方华夏创业投资有限公司', '中国平安人寿保险股份有限公司', '深圳市东方泓达投资有限公司', '东吴证券有限责任公司', '12'}",13,"{'5000000', '现金', '8000000', '中天证券有限责任公司', '东方华夏创业投资有限公司', '诺安基金管理有限公司', '4000000', '中原证券股份有限公司', '中国平安人寿保险股份有限公司', '深圳市东方泓达投资有限公司', '东吴证券有限责任公司', '9000000', '12'}"
7,"{'430000000', '现金', '港华投资有限公司', '12', '竞价', '深圳市国资局', '36'}",1196612,1,{'430000000'},6,"{'现金', '港华投资有限公司', '12', '竞价', '深圳市国资局', '36'}",6,"{'现金', '港华投资有限公司', '12', '竞价', '深圳市国资局', '36'}"
21,"{'11600000', '5000000', '5800000', '兴业全球基金管理有限公司', '招商基金管理有限公司', '11462000', '财通基金管理有限公司', '5400000', '28134000', '10000000', '平安大华基金管理有限公司', '广发证券股份有限公司', '30218000', '汇添富基金管理有限公司', '东海证券有限责任公司', '60436000', '2200000', '26050000', '52100000', '泰康资产管理有限责任公司', '12'}",1136608,7,"{'60436000', '2200000', '11600000', '11462000', '30218000', '52100000', '28134000'}",1,{'12'},14,"{'平安大华基金管理有限公司', '5000000', '5800000', '兴业全球基金管理有限公司', '广发证券股份有限公司', '招商基金管理有限公司', '财通基金管理有限公司', '5400000', '26050000', '泰康资产管理有限责任公司', '10000000', '12', '汇添富基金管理有限公司', '东海证券有限责任公司'}"
25,"{'800000000', '中兵投资驰宏锌锗计划', '202907700', '35885167', '徐晓雒', '239234449', '200000000', '现金', '191387559', '竞价', '金润中泽', '48542511', '300000000', '150000000', '334928229', '员工持股计划', '郑积华', '1400000000', '苏庭宝', '冶金集团', '71770334', '1000000000', '国华人寿', '47846889', '36'}",15716282,8,"{'800000000', '150000000', '202907700', '1000000000', '竞价', '300000000', '1400000000', '200000000'}",10,"{'中兵投资驰宏锌锗计划', '现金', '冶金集团', '员工持股计划', '金润中泽', '郑积华', '徐晓雒', '国华人寿', '苏庭宝', '36'}",17,"{'中兵投资驰宏锌锗计划', '现金', '35885167', '冶金集团', '191387559', '334928229', '71770334', '员工持股计划', '金润中泽', '48542511', '郑积华', '徐晓雒', '国华人寿', '239234449', '苏庭宝', '47846889', '36'}"
22,"{'红土创新基金管理有限公司', '叶小青', '229999991.2', '113499999.7', '113369474.5', '10992217', '现金', '225999991.8', '21984435', '财通基金管理有限公司', '117999997.7', '竞价', '11040856', '11028159', '11478599', '信诚基金管理有限公司', '富国基金管理有限公司', '112999990.8', '兴证证券资产管理有限公司', '22373540', '安信基金管理有限责任公司', '12'}",14756067,3,"{'112999990.8', '113499999.7', '竞价'}",9,"{'现金', '兴证证券资产管理有限公司', '红土创新基金管理有限公司', '信诚基金管理有限公司', '叶小青', '财通基金管理有限公司', '安信基金管理有限责任公司', '富国基金管理有限公司', '12'}",19,"{'10992217', '现金', '兴证证券资产管理有限公司', '红土创新基金管理有限公司', '信诚基金管理有限公司', '叶小青', '225999991.8', '21984435', '财通基金管理有限公司', '229999991.2', '22373540', '117999997.7', '安信基金管理有限责任公司', '富国基金管理有限公司', '113369474.5', '11040856', '12', '11028159', '11478599'}"
30,"{'59760000', '泰通投资', '200000040.3', '200000007.1', '90361268', '现金', '定价', '60240976', '18000000', '17180728', '亚祥投资', '苏州上达', '西域3号', '10000000', '259036148', '张宇', '弘晟投资', '鸿众投资', '999999995.8', '义乌上达', '860000011.4', '33200000', '金鹰穗通5号', '60240966', '96385548', '301204818', '长城一号', '57040016.96', '36', '320000019.4'}",1555548,3,"{'320000019.4', '860000011.4', '999999995.8'}",11,"{'现金', '张宇', '弘晟投资', '定价', '义乌上达', '鸿众投资', '亚祥投资', '泰通投资', '苏州上达', '长城一号', '36'}",27,"{'59760000', '泰通投资', '200000040.3', '200000007.1', '90361268', '现金', '定价', '60240976', '18000000', '17180728', '亚祥投资', '苏州上达', '西域3号', '10000000', '259036148', '张宇', '弘晟投资', '鸿众投资', '义乌上达', '33200000', '金鹰穗通5号', '60240966', '96385548', '301204818', '长城一号', '57040016.96', '36'}"
18,"{'宣通实业', '11500000', '现金', '德道汇', '3750000', '杉杉控股', '35000000', '定价', '青炜纺织', '1250000', '鹏欣集团', '张华伟', '6000000', '张春雷', '赛飞汽车', '36', '安企软件', '2500000'}",505112,6,"{'11500000', '3750000', '35000000', '1250000', '6000000', '2500000'}",12,"{'宣通实业', '现金', '德道汇', '杉杉控股', '定价', '青炜纺织', '鹏欣集团', '张华伟', '张春雷', '赛飞汽车', '36', '安企软件'}",12,"{'宣通实业', '现金', '德道汇', '杉杉控股', '定价', '青炜纺织', '鹏欣集团', '张华伟', '张春雷', '赛飞汽车', '36', '安企软件'}"
14,"{'49018186', '1989601.92', '3774656', '99480002.88', '570571694', '蒋亨福', '竞价', '吴美莉', '43936995.84', '8546392', '170928', '方德智联', '吴国仕', '36'}",12046994,2,"{'竞价', '570571694'}",5,"{'吴国仕', '蒋亨福', '吴美莉', '方德智联', '36'}",12,"{'49018186', '1989601.92', '3774656', '99480002.88', '蒋亨福', '吴美莉', '43936995.84', '8546392', '170928', '方德智联', '吴国仕', '36'}"
11,"{'慧达投资', '现金', '1000000', '聚星投资', '定价', '22396843', '1903157', '聚合投资', '郭松森', '1015789', '36'}",308279,4,"{'1015789', '1000000', '22396843', '1903157'}",7,"{'慧达投资', '现金', '聚星投资', '定价', '聚合投资', '郭松森', '36'}",7,"{'慧达投资', '现金', '聚星投资', '定价', '聚合投资', '郭松森', '36'}"
6,"{'20000000', '849978', '现金', '定价', '池驰', '36'}",17968289,0,set(),4,"{'池驰', '定价', '现金', '36'}",6,"{'20000000', '849978', '现金', '定价', '池驰', '36'}"
4,"{'竞价', '现金', '36', '中电投集团'}",1239814,1,{'36'},3,"{'竞价', '现金', '中电投集团'}",3,"{'竞价', '现金', '中电投集团'}"
20,"{'490000000', '10526315', '现金', '94736846', '12', '中国航空油料集团公司', '柯希平', '中泽嘉盟投资有限公司', '中国东方航空集团公司(“东航集团”)', '泰达(北京)投资有限公司', '421052632', '8421053', '陈郁凤', '210526315', '航天投资控股有限公司', '83157894', '中外运空运发展股份有限公司', '36', '东莞市财信发展有限公司', '航天科技财务有限责任公司'}",1111594,0,set(),11,"{'现金', '12', '中国航空油料集团公司', '中泽嘉盟投资有限公司', '陈郁凤', '航天科技财务有限责任公司', '航天投资控股有限公司', '中外运空运发展股份有限公司', '36', '东莞市财信发展有限公司', '柯希平'}",20,"{'490000000', '10526315', '94736846', '现金', '12', '中国航空油料集团公司', '柯希平', '中泽嘉盟投资有限公司', '中国东方航空集团公司(“东航集团”)', '泰达(北京)投资有限公司', '421052632', '8421053', '陈郁凤', '210526315', '航天投资控股有限公司', '83157894', '中外运空运发展股份有限公司', '36', '东莞市财信发展有限公司', '航天科技财务有限责任公司'}"
5,"{'224524100', '现金', '竞价', '华友投资', '36'}",9874957,1,{'224524100'},4,"{'竞价', '现金', '华友投资', '36'}",4,"{'竞价', '现金', '华友投资', '36'}"
17,"{'20000000', '华宝兴业基金管理有限公司', '张怀斌', '兴业全球基金管理有限公司', '国华人寿保险股份有限公司', '华基丰收(天津)股权投资合伙企业', '上海国泰君安证券资产管理有限公司', '竞价', '西安长顿投资管理有限合伙企业', '17500000', '17000000', '深圳市平安创新资本投资有限公司', '浙江天堂硅谷久和股权投资合伙企业', '4941175', '中海基金管理有限公司', '12', '19000000'}",576579,1,{'竞价'},1,{'12'},16,"{'20000000', '华宝兴业基金管理有限公司', '张怀斌', '兴业全球基金管理有限公司', '国华人寿保险股份有限公司', '华基丰收(天津)股权投资合伙企业', '上海国泰君安证券资产管理有限公司', '17500000', '西安长顿投资管理有限合伙企业', '17000000', '深圳市平安创新资本投资有限公司', '浙江天堂硅谷久和股权投资合伙企业', '4941175', '中海基金管理有限公司', '12', '19000000'}"
12,"{'上海兴富创业投资管理中心(有限合伙)', '35460775', '现金', '黄文乐', '定价', '黄文喜', '24930748', '4155125', '256026800', '180000000', '30000000', '36'}",1811749,7,"{'上海兴富创业投资管理中心(有限合伙)', '35460775', '4155125', '24930748', '256026800', '180000000', '30000000'}",5,"{'现金', '黄文乐', '定价', '黄文喜', '36'}",5,"{'现金', '黄文乐', '定价', '黄文喜', '36'}"
3,"{'金达威投资', '竞价', '36'}",2129618,0,set(),3,"{'金达威投资', '竞价', '36'}",3,"{'金达威投资', '竞价', '36'}"
15,"{'泰宇德鸿', '汇添富资管计划', '现金', '127600000', '147700000', '鹏华增发1号', '6263783', '汇添富定增37号', '8693808', '5411366', '航天基金', '5937235', '140000000', '205000000', '36'}",306322,4,"{'127600000', '205000000', '140000000', '147700000'}",5,"{'泰宇德鸿', '汇添富资管计划', '现金', '航天基金', '36'}",11,"{'泰宇德鸿', '汇添富资管计划', '现金', '鹏华增发1号', '6263783', '汇添富定增37号', '8693808', '5411366', '航天基金', '5937235', '36'}"
8,"{'现金', '3500000', '23745070', '102655000', '平安资管', '696442903.1', '36', '新余元保'}",343179,0,set(),4,"{'新余元保', '现金', '36', '平安资管'}",8,"{'现金', '3500000', '23745070', '102655000', '平安资管', '696442903.1', '36', '新余元保'}"
5,"{'现金', '特变电工股份有限公司', '竞价', '11000000', '36'}",546272,2,"{'11000000', '竞价'}",2,"{'特变电工股份有限公司', '现金'}",3,"{'特变电工股份有限公司', '现金', '36'}"
11,"{'225000000', '太平洋资产管理有限责任公司', '现金', '南京长江油运公司', '12', '定价', '1266750000', '140750000', '25000000', '华泰证券股份有限公司', '36'}",421884,2,"{'140750000', '1266750000'}",7,"{'太平洋资产管理有限责任公司', '现金', '南京长江油运公司', '12', '定价', '华泰证券股份有限公司', '36'}",9,"{'225000000', '太平洋资产管理有限责任公司', '现金', '南京长江油运公司', '12', '定价', '25000000', '华泰证券股份有限公司', '36'}"
13,"{'20000000', '5000000', '现金', '1000000', '海利集团', '湘江投资', '天心实业', '轻盐创投', '华达集团', '合力化学', '10000000', '30000000', '36'}",1076925,0,set(),8,"{'现金', '海利集团', '湘江投资', '天心实业', '轻盐创投', '华达集团', '合力化学', '36'}",13,"{'20000000', '5000000', '现金', '1000000', '海利集团', '湘江投资', '天心实业', '轻盐创投', '华达集团', '合力化学', '10000000', '30000000', '36'}"
14,"{'16347828', '210999999', '149999974', '上银基金管理有限公司', '9173913', '8695652', '定价', '华安未来资产管理(上海)有限公司', '财通基金管理有限公司', '199999996', '376000044', '云南惠潮投资合伙企业(有限合伙)', '12', '6521738'}",1726146,5,"{'210999999', '376000044', '149999974', '199999996', '9173913'}",4,"{'定价', '12', '财通基金管理有限公司', '上银基金管理有限公司'}",9,"{'16347828', '上银基金管理有限公司', '8695652', '定价', '华安未来资产管理(上海)有限公司', '财通基金管理有限公司', '云南惠潮投资合伙企业(有限合伙)', '12', '6521738'}"
17,"{'华安基金管理有限公司', '4032258', '149999979', '深圳菁英时代资本管理有限公司', '中国华融资产管理股份有限公司', '4838709', '124999998', '竞价', '安信基金管理有限责任公司', '申万菱信基金管理有限公司', '249999996', '方正富邦基金管理有限公司', '3225807', '8064516', '富荣基金管理有限公司', '100000017', '12'}",14761800,1,{'竞价'},8,"{'华安基金管理有限公司', '深圳菁英时代资本管理有限公司', '中国华融资产管理股份有限公司', '安信基金管理有限责任公司', '申万菱信基金管理有限公司', '方正富邦基金管理有限公司', '富荣基金管理有限公司', '12'}",16,"{'华安基金管理有限公司', '4032258', '149999979', '深圳菁英时代资本管理有限公司', '中国华融资产管理股份有限公司', '4838709', '124999998', '安信基金管理有限责任公司', '申万菱信基金管理有限公司', '249999996', '方正富邦基金管理有限公司', '3225807', '8064516', '富荣基金管理有限公司', '100000017', '12'}"
13,"{'现金', '重庆交通运输控股(集团)有限公司', '12', '定价', '200000000', '重庆市能源投资集团有限公司', '212020000', '重庆市水务资产经营有限公司', '147150000', '建信基金管理有限公司', '深圳市平安创新资本投资有限公司', '129880000', '17663780'}",1085848,1,{'定价'},6,"{'现金', '12', '重庆市能源投资集团有限公司', '重庆市水务资产经营有限公司', '建信基金管理有限公司', '深圳市平安创新资本投资有限公司'}",12,"{'现金', '重庆交通运输控股(集团)有限公司', '200000000', '重庆市能源投资集团有限公司', '212020000', '重庆市水务资产经营有限公司', '147150000', '建信基金管理有限公司', '深圳市平安创新资本投资有限公司', '129880000', '12', '17663780'}"
5,"{'现金', '浙报传媒控股集团有限公司', '竞价', '200000000', '36'}",2043127,0,set(),4,"{'36', '竞价', '浙报传媒控股集团有限公司', '现金'}",5,"{'现金', '浙报传媒控股集团有限公司', '竞价', '200000000', '36'}"
4,"{'荣盛控股', '现金', '36', '600000000'}",16364764,1,{'600000000'},3,"{'荣盛控股', '现金', '36'}",3,"{'荣盛控股', '现金', '36'}"
7,"{'20000000', '现金', '贵航集团', '通飞公司', '竞价', '10000000', '36'}",596886,3,"{'20000000', '竞价', '10000000'}",4,"{'通飞公司', '现金', '贵航集团', '36'}",4,"{'通飞公司', '现金', '贵航集团', '36'}"
5,"{'36', '现金', '其余投资者', '新理益集团有限公司', '12'}",966050,0,set(),3,"{'现金', '新理益集团有限公司', '其余投资者'}",5,"{'36', '现金', '其余投资者', '新理益集团有限公司', '12'}"
12,"{'现金', '定价', '鑫元基金管理有限公司', '东海基金管理有限责任公司', '财通基金管理有限公司', '22000000', '1352680000', '1062820000', '10000000', '28000000', '483100000', '36'}",1646126,4,"{'22000000', '1352680000', '1062820000', '483100000'}",6,"{'现金', '定价', '鑫元基金管理有限公司', '东海基金管理有限责任公司', '财通基金管理有限公司', '36'}",8,"{'现金', '定价', '鑫元基金管理有限公司', '东海基金管理有限责任公司', '财通基金管理有限公司', '10000000', '28000000', '36'}"
16,"{'24000000', '中国华电集团资本控股有限公司', '江苏荣华资产管理有限公司', '现金', '8000000', '36', '永泰投资控股有限公司', '华宝信托有限责任公司', '江苏宗申三轮摩托车制造有限公司', '竞价', '8800000', '海通证券股份有限公司', '济南北安投资有限公司', '10000000', '12', '13200000'}",501716,0,set(),6,"{'现金', '12', '永泰投资控股有限公司', '华宝信托有限责任公司', '竞价', '36'}",16,"{'24000000', '中国华电集团资本控股有限公司', '江苏荣华资产管理有限公司', '8000000', '36', '现金', '永泰投资控股有限公司', '华宝信托有限责任公司', '江苏宗申三轮摩托车制造有限公司', '竞价', '8800000', '海通证券股份有限公司', '济南北安投资有限公司', '10000000', '12', '13200000'}"
15,"{'现金', '永清集团', '24169179.5', '定价', '金阳投资', '517239', '1880870', '241691820.7', '940435', '永旺置业', '津杉华融', '13293042.3', '48338359', '36', '9404351'}",1725910,6,"{'24169179.5', '517239', '241691820.7', '13293042.3', '48338359', '9404351'}",7,"{'现金', '永清集团', '金阳投资', '定价', '永旺置业', '津杉华融', '36'}",9,"{'36', '现金', '永清集团', '定价', '金阳投资', '1880870', '940435', '津杉华融', '永旺置业'}"
20,"{'中车金证投资有限公司', '198880355.4', '金鹰基金管理有限公司', '现金', '红塔红土基金管理有限公司', '13383605', '198880370.3', '36', '596641096', '庄敏', '定价', '华龙证券股份有限公司', '197760773.3', '199999997', '40150814', '13458950', '13308262', '12', '13383604', '海富通基金管理有限公司'}",10789827,0,set(),4,"{'定价', '庄敏', '现金', '36'}",20,"{'中车金证投资有限公司', '198880355.4', '金鹰基金管理有限公司', '红塔红土基金管理有限公司', '13383605', '198880370.3', '36', '现金', '596641096', '庄敏', '199999997', '华龙证券股份有限公司', '197760773.3', '定价', '40150814', '13458950', '13308262', '12', '13383604', '海富通基金管理有限公司'}"
9,"{'现金', '中电熊猫', '1345000000', '1346000000', '南京新工', '南京机电', '竞价', '36', '3059000000'}",1022944,3,"{'1345000000', '1346000000', '3059000000'}",6,"{'现金', '中电熊猫', '南京新工', '南京机电', '竞价', '36'}",6,"{'现金', '中电熊猫', '南京新工', '南京机电', '竞价', '36'}"
8,"{'33500000', '现金', '睿富投资', '中新建', '5500000', '22300000', '36', '兵团国资公司'}",1318800,2,"{'22300000', '33500000'}",5,"{'现金', '睿富投资', '中新建', '36', '兵团国资公司'}",6,"{'现金', '睿富投资', '中新建', '5500000', '36', '兵团国资公司'}"
16,"{'现金', '41916167', '11616766', '叶强', '24999991.85', '河南羚锐集团有限公司', '2994011', '96999996.1', '999996', '李进', '119760', '熊伟', '吴希振', '民族—羚锐小羚羊资产管理计划', '36', '349999994.5'}",2367354,1,{'349999994.5'},7,"{'现金', '叶强', '熊伟', '李进', '吴希振', '民族—羚锐小羚羊资产管理计划', '36'}",15,"{'现金', '41916167', '11616766', '叶强', '24999991.85', '河南羚锐集团有限公司', '2994011', '96999996.1', '999996', '李进', '119760', '熊伟', '吴希振', '民族—羚锐小羚羊资产管理计划', '36'}"
16,"{'南京瑞森投资管理合伙企业(有限合伙)', '华夏人寿保险股份有限公司', '现金', '81930000', '兴业全球基金管理有限公司', '华夏基金管理有限公司', '东海基金管理有限责任公司', '财通基金管理有限公司', '16070000', '国泰基金管理有限公司', '中信证券股份有限公司', '海通证券股份有限公司', '49400000', '49300000', '汇添富基金管理股份有限公司', '12'}",355691,3,"{'49400000', '16070000', '81930000'}",2,"{'现金', '12'}",13,"{'南京瑞森投资管理合伙企业(有限合伙)', '华夏人寿保险股份有限公司', '现金', '兴业全球基金管理有限公司', '华夏基金管理有限公司', '东海基金管理有限责任公司', '财通基金管理有限公司', '国泰基金管理有限公司', '中信证券股份有限公司', '海通证券股份有限公司', '49300000', '汇添富基金管理股份有限公司', '12'}"
9,"{'24813895', '现金', '17121588', '湖南红翔投资合伙企业(有限合伙)', '100000000', '定价', '朱明楚', '69000000', '36'}",1854284,2,"{'100000000', '69000000'}",4,"{'朱明楚', '现金', '定价', '36'}",7,"{'24813895', '现金', '17121588', '湖南红翔投资合伙企业(有限合伙)', '定价', '朱明楚', '36'}"
5,"{'中国物资开发投资总公司', '现金', '定价', '60000000', '36'}",1454806,0,set(),4,"{'定价', '中国物资开发投资总公司', '现金', '36'}",5,"{'中国物资开发投资总公司', '现金', '定价', '60000000', '36'}"
11,"{'现金', '全睿众定增3号', '李建林', '三川集团', '东方证券股份有限公司', '1500000', '三川股份第1期员工持股计划', '8000000', '3600000', '11400000', '36'}",343600,4,"{'1500000', '8000000', '11400000', '3600000'}",5,"{'现金', '李建林', '三川集团', '东方证券股份有限公司', '36'}",7,"{'现金', '全睿众定增3号', '李建林', '三川集团', '东方证券股份有限公司', '三川股份第1期员工持股计划', '36'}"
24,"{'37230568', '15676028', '31098461', '560882584.9', '兴业全球基金管理有限公司', '定价', '16982364', '财通基金管理有限公司', '569999996.1', '德邦基金管理有限公司', '21097322', '36', '上海市北高新(集团)有限公司', '诺安基金管理有限公司', '光大保德信基金管理有限公司', '银河基金管理有限公司', '322999999.8', '36635048', '239999988.7', '476117437.9', '269999994.9', '259999992.8', '17635532', '12'}",14253342,3,"{'239999988.7', '560882584.9', '569999996.1'}",9,"{'36', '兴业全球基金管理有限公司', '诺安基金管理有限公司', '定价', '财通基金管理有限公司', '光大保德信基金管理有限公司', '银河基金管理有限公司', '德邦基金管理有限公司', '12'}",21,"{'37230568', '15676028', '31098461', '兴业全球基金管理有限公司', '16982364', '定价', '财通基金管理有限公司', '德邦基金管理有限公司', '21097322', '36', '上海市北高新(集团)有限公司', '诺安基金管理有限公司', '光大保德信基金管理有限公司', '银河基金管理有限公司', '322999999.8', '36635048', '476117437.9', '269999994.9', '259999992.8', '17635532', '12'}"
6,"{'现金', '由广发证券资产管理(广东)有限公司', '99284153', '54644808', '袁志敏', '36'}",1908364,3,"{'54644808', '99284153', '由广发证券资产管理(广东)有限公司'}",3,"{'袁志敏', '现金', '36'}",3,"{'袁志敏', '现金', '36'}"
8,"{'12000000', '黄荣添', '现金', '15000000', '石磊', '10000000', '12', '杨宝林'}",1118371,0,set(),5,"{'黄荣添', '现金', '石磊', '12', '杨宝林'}",8,"{'12000000', '黄荣添', '现金', '15000000', '石磊', '10000000', '12', '杨宝林'}"
4,"{'定价', '50000000', '12', '武汉经济发展投资(集团)有限公司'}",1255758,0,set(),2,"{'定价', '12'}",4,"{'定价', '50000000', '12', '武汉经济发展投资(集团)有限公司'}"
9,"{'现金', '39662200', '190378500', '7615140000', '永冠贸易', '厚康实业', '竞价', '158648700', '36'}",14926652,3,"{'190378500', '7615140000', '竞价'}",4,"{'厚康实业', '现金', '永冠贸易', '36'}",6,"{'现金', '39662200', '永冠贸易', '厚康实业', '158648700', '36'}"
28,"{'北京数码视讯科技股份有限公司', '50000000', '中国电子投资控股有限公司', '现金', '19426906', '6131207', '兴业财富资产管理有限公司', '定价', '237639600', '湖北省楚天视讯网络有限公司', '300000000', '163100000', '鹏华基金管理有限公司', '10000000', '30656039', '116000000', '中信国安信息产业股份有限公司', '北京中融鼎新投资管理有限公司', '江阴中南重工集团有限公司', '14570179', '316852800', '7112201', '18393623', '100000000', '3065603', '北京捷成世纪科技股份有限公司', '500000000', '36'}",1817259,6,"{'116000000', '100000000', '237639600', '300000000', '163100000', '316852800'}",12,"{'现金', '中信国安信息产业股份有限公司', '北京数码视讯科技股份有限公司', '兴业财富资产管理有限公司', '定价', '湖北省楚天视讯网络有限公司', '北京中融鼎新投资管理有限公司', '北京捷成世纪科技股份有限公司', '鹏华基金管理有限公司', '中国电子投资控股有限公司', '江阴中南重工集团有限公司', '36'}",22,"{'北京数码视讯科技股份有限公司', '50000000', '中国电子投资控股有限公司', '现金', '19426906', '6131207', '兴业财富资产管理有限公司', '定价', '湖北省楚天视讯网络有限公司', '鹏华基金管理有限公司', '10000000', '30656039', '中信国安信息产业股份有限公司', '北京中融鼎新投资管理有限公司', '江阴中南重工集团有限公司', '14570179', '7112201', '18393623', '3065603', '北京捷成世纪科技股份有限公司', '500000000', '36'}"
9,"{'金花投资控股集团有限公司', '现金', '10099999.42', '定价', '1076759', '66897654', '金花1号定向资产管理计划', '627499994.5', '36'}",20214486,1,{'10099999.42'},5,"{'金花投资控股集团有限公司', '现金', '定价', '金花1号定向资产管理计划', '36'}",8,"{'金花投资控股集团有限公司', '现金', '定价', '1076759', '66897654', '金花1号定向资产管理计划', '627499994.5', '36'}"
23,"{'浙江元金投资有限公司', '33399988.8', '中钢投资有限公司', '3000000', '54900000', '80520000', '现金', '天津六禾碧云股权投资基金合伙企业(有限合伙)', '定价', '5400000', '98820000', '上海洛瑞尔投资管理合伙企业(有限合伙)', '36', '浙商证券-光大-浙商汇金大消费集合资产管理计划', '4400000', '国泰基金管理有限公司', '东方红-新睿1号集合资产管理计划', '90699997.2', '1825136', '47580000', '4956284', '2600000', '12'}",1254667,8,"{'33399988.8', '90699997.2', '1825136', '47580000', '98820000', '2600000', '54900000', '80520000'}",6,"{'浙江元金投资有限公司', '现金', '12', '定价', '国泰基金管理有限公司', '36'}",15,"{'36', '浙江元金投资有限公司', '现金', '天津六禾碧云股权投资基金合伙企业(有限合伙)', '浙商证券-光大-浙商汇金大消费集合资产管理计划', '4400000', '定价', '5400000', '国泰基金管理有限公司', '东方红-新睿1号集合资产管理计划', '3000000', '上海洛瑞尔投资管理合伙企业(有限合伙)', '中钢投资有限公司', '4956284', '12'}"
5,"{'893700000', '现金', '颐和黄金', '竞价', '36'}",1216414,1,{'893700000'},4,"{'36', '竞价', '颐和黄金', '现金'}",4,"{'现金', '竞价', '颐和黄金', '36'}"
16,"{'202040000', '150000000', '陈雁升', '现金', '97960000', '西安普润', '450000000', '13651351', '定价', '10135135', '互兴投资', '曹毅斌', '6618918', '股权', '36', '30405405'}",292745,4,"{'450000000', '202040000', '150000000', '97960000'}",8,"{'陈雁升', '现金', '西安普润', '定价', '互兴投资', '股权', '36', '曹毅斌'}",12,"{'陈雁升', '现金', '西安普润', '13651351', '定价', '10135135', '互兴投资', '曹毅斌', '6618918', '股权', '36', '30405405'}"
14,"{'广发证券资产管理(广东)有限公司', '现金', '嘉兴会凌贰号投资合伙企业(有限合伙)', '红土创新基金管理有限公司', '350000000', '12864494', '定价', '上海国药圣礼股权投资基金合伙企业(有限合伙', '26253860', '300000000', '612240000', '15008576', '上海智越投资管理有限公司', '36'}",1647625,3,"{'350000000', '300000000', '612240000'}",5,"{'现金', '红土创新基金管理有限公司', '定价', '上海智越投资管理有限公司', '36'}",11,"{'广发证券资产管理(广东)有限公司', '现金', '12864494', '红土创新基金管理有限公司', '上海国药圣礼股权投资基金合伙企业(有限合伙', '定价', '26253860', '嘉兴会凌贰号投资合伙企业(有限合伙)', '15008576', '上海智越投资管理有限公司', '36'}"
15,"{'149999998.5', '现金', '15252525', '150999997.5', '浙江浙商产融控股有限公司', '15151515', '财通基金管理有限公司', '申万宏源证券有限公司', '竞价', '144128803.5', '泰达宏利基金管理有限公司', '14558465', '36363636', '12', '359999996.4'}",19205580,1,{'竞价'},6,"{'现金', '浙江浙商产融控股有限公司', '财通基金管理有限公司', '申万宏源证券有限公司', '泰达宏利基金管理有限公司', '12'}",14,"{'149999998.5', '现金', '15252525', '150999997.5', '浙江浙商产融控股有限公司', '15151515', '财通基金管理有限公司', '申万宏源证券有限公司', '144128803.5', '泰达宏利基金管理有限公司', '14558465', '36363636', '12', '359999996.4'}"
6,"{'1370000000', '现金', '155505107', '定价', '深圳华侨城资本投资管理有限公司', '36'}",6417995,2,"{'1370000000', '155505107'}",4,"{'深圳华侨城资本投资管理有限公司', '36', '定价', '现金'}",4,"{'深圳华侨城资本投资管理有限公司', '定价', '现金', '36'}"
4,"{'现金', '竞价', '厦门金达威投资有限公司', '36'}",1851747,0,set(),4,"{'现金', '竞价', '厦门金达威投资有限公司', '36'}",4,"{'现金', '竞价', '厦门金达威投资有限公司', '36'}"
15,"{'33611111', '杭州商旅金融投资有限公司', '现金', '浙江广杰投资管理有限公司', '13283333', '26388888', '定价', '12', '23444444', '财通基金管理有限公司', '杭州市实业投资集团有限公司', '金元顺安基金管理有限公司', '杭州制氧机集团有限公司', '22816668', '36'}",16504168,0,set(),10,"{'杭州商旅金融投资有限公司', '现金', '浙江广杰投资管理有限公司', '12', '定价', '财通基金管理有限公司', '杭州市实业投资集团有限公司', '金元顺安基金管理有限公司', '杭州制氧机集团有限公司', '36'}",15,"{'33611111', '杭州商旅金融投资有限公司', '现金', '浙江广杰投资管理有限公司', '13283333', '26388888', '定价', '12', '23444444', '财通基金管理有限公司', '杭州市实业投资集团有限公司', '金元顺安基金管理有限公司', '杭州制氧机集团有限公司', '22816668', '36'}"
4,"{'36', '定价', '现金', '大洲控股'}",231036,0,set(),4,"{'定价', '36', '现金', '大洲控股'}",4,"{'36', '定价', '现金', '大洲控股'}"
33,"{'南方工业资产', '203303670', '200000000', '现金', '中信建投基金银河2号', '竞价', '300000000', '13449899', '8069939', '30000000', '19952678', '张家书', '36', '中信建投基金银河1号', '296696330', '20174848', '120000000', '15467383', '林增佛', '6724949', '林超', '北信瑞丰-南方资产-共进1号资产管理计划', '西藏瑞华投资', '2017484', '230000000', '100000000', '350000000', '杨晓玲', '13672069', '11432414', '170000000', '华安-中兵资产管理计划', '23537323'}",1785727,11,"{'230000000', '203303670', '296696330', '100000000', '350000000', '竞价', '300000000', '120000000', '170000000', '200000000', '30000000'}",10,"{'西藏瑞华投资', '南方工业资产', '36', '现金', '杨晓玲', '北信瑞丰-南方资产-共进1号资产管理计划', '林增佛', '华安-中兵资产管理计划', '林超', '张家书'}",22,"{'南方工业资产', '现金', '中信建投基金银河2号', '13449899', '8069939', '19952678', '张家书', '36', '中信建投基金银河1号', '20174848', '15467383', '林增佛', '6724949', '林超', '北信瑞丰-南方资产-共进1号资产管理计划', '西藏瑞华投资', '2017484', '杨晓玲', '13672069', '11432414', '华安-中兵资产管理计划', '23537323'}"
5,"{'现金', '汇理资产', '365750000', '95000000', '36'}",481575,2,"{'365750000', '95000000'}",3,"{'36', '汇理资产', '现金'}",3,"{'36', '汇理资产', '现金'}"
6,"{'现金', '定价', '中航集团', '1050740000', '188642729', '36'}",1230033,1,{'1050740000'},4,"{'36', '定价', '现金', '中航集团'}",5,"{'现金', '定价', '中航集团', '188642729', '36'}"
28,"{'海通证券股份有限公司', '118693265.6', '8099546', '5536651', '122144998.3', '现金', '5527201', '122151142.1', '上银瑞金资本管理有限公司', '184949993.8', '财通基金管理有限公司', '竞价', '36', '太平洋资产管理有限责任公司', '星星集团', '国华人寿保险股份有限公司', '11312217', '122359987.1', '财通证券股份有限公司', '5527178', '178999966.6', '8368778', '5370736', '5526923', '249999995.7', '创金合信基金管理有限公司', '12', '122150633.8'}",1719202,0,set(),5,"{'36', '现金', '星星集团', '竞价', '12'}",28,"{'海通证券股份有限公司', '118693265.6', '8099546', '5536651', '122144998.3', '现金', '5527201', '122151142.1', '上银瑞金资本管理有限公司', '184949993.8', '财通基金管理有限公司', '竞价', '36', '太平洋资产管理有限责任公司', '星星集团', '国华人寿保险股份有限公司', '11312217', '122359987.1', '财通证券股份有限公司', '5527178', '178999966.6', '8368778', '5370736', '5526923', '249999995.7', '创金合信基金管理有限公司', '12', '122150633.8'}"
17,"{'华宝兴业基金管理有限公司', '现金', '天平汽车保险股份有限公司', '兴业全球基金管理有限公司', '浙商证券有限责任公司', '4000000', '定价', '3700000', '易方达基金管理有限公司', '74000000', '鹏华基金管理有限公司', '安桂林', '长城证券有限责任公司', '80000000', '12', '汇添富基金管理有限公司', '太平资产管理有限公司'}",1229642,2,"{'74000000', '80000000'}",3,"{'定价', '现金', '12'}",15,"{'华宝兴业基金管理有限公司', '现金', '天平汽车保险股份有限公司', '兴业全球基金管理有限公司', '浙商证券有限责任公司', '4000000', '定价', '3700000', '易方达基金管理有限公司', '鹏华基金管理有限公司', '安桂林', '长城证券有限责任公司', '12', '汇添富基金管理有限公司', '太平资产管理有限公司'}"
8,"{'现金', '300343725', '462529336.5', '西藏海涵交通发展有限公司', '西藏天圣交通发展投资有限公司', '140160405', '991134292.5', '36'}",1085665,0,set(),4,"{'西藏海涵交通发展有限公司', '现金', '西藏天圣交通发展投资有限公司', '36'}",8,"{'现金', '300343725', '462529336.5', '西藏海涵交通发展有限公司', '西藏天圣交通发展投资有限公司', '140160405', '991134292.5', '36'}"
24,"{'99999999', '13466265', '299999997', '97999996.05', '19595959', '30707070', '中原期货股份有限公司', '现金', '19797979', '新沃基金管理有限公司', '60606060', '竞价', '深圳市融通资本管理股份有限公司', '151999996.5', '20202020', '66658011.75', '民生加银基金管理有限公司', '贾跃彩', '96999997.05', '31313131', '154999998.5', '华宝信托有限责任公司', '创金合信基金管理有限公司', '12'}",14904261,2,"{'竞价', '154999998.5'}",9,"{'现金', '民生加银基金管理有限公司', '新沃基金管理有限公司', '贾跃彩', '华宝信托有限责任公司', '深圳市融通资本管理股份有限公司', '创金合信基金管理有限公司', '12', '中原期货股份有限公司'}",22,"{'99999999', '13466265', '299999997', '97999996.05', '19595959', '30707070', '中原期货股份有限公司', '现金', '19797979', '新沃基金管理有限公司', '60606060', '深圳市融通资本管理股份有限公司', '151999996.5', '20202020', '66658011.75', '民生加银基金管理有限公司', '贾跃彩', '96999997.05', '31313131', '华宝信托有限责任公司', '创金合信基金管理有限公司', '12'}"
17,"{'内蒙蒙牛', '现金', '于航', '樊祥杰', '6361323', '久泰投', '100000000', '李伟', '马伯乐', '220000000', '50000000', '108214784', '850568200', '柴琇', '36', '12722646', '27989822'}",2303941,4,"{'850568200', '220000000', '50000000', '100000000'}",9,"{'内蒙蒙牛', '现金', '于航', '樊祥杰', '久泰投', '李伟', '马伯乐', '柴琇', '36'}",13,"{'内蒙蒙牛', '现金', '于航', '樊祥杰', '6361323', '久泰投', '李伟', '马伯乐', '108214784', '柴琇', '36', '12722646', '27989822'}"
8,"{'现金', '赵小强', '新余乐活投资管理中心(普通合伙)', '新余天游投资管理中心(普通合伙)', '1000000000', '78249600', '85500000', '36'}",14211189,3,"{'1000000000', '78249600', '85500000'}",3,"{'现金', '36', '赵小强'}",5,"{'现金', '赵小强', '新余乐活投资管理中心(普通合伙)', '新余天游投资管理中心(普通合伙)', '36'}"
5,"{'现金', '定价', '中材股份', '1135130000', '36'}",9887050,1,{'1135130000'},4,"{'定价', '现金', '中材股份', '36'}",4,"{'定价', '现金', '中材股份', '36'}"
15,"{'9056603', '189999991.5', '现金', '鹏华资产管理有限公司', '147999995.8', '定价', '新华基金管理股份有限公司', '11169811', '苏博', '119999989.8', '145030021.5', '邹月普', '10945662', '12', '14339622'}",16919208,2,"{'119999989.8', '147999995.8'}",7,"{'现金', '鹏华资产管理有限公司', '定价', '新华基金管理股份有限公司', '苏博', '邹月普', '12'}",13,"{'9056603', '189999991.5', '现金', '鹏华资产管理有限公司', '定价', '新华基金管理股份有限公司', '11169811', '苏博', '145030021.5', '邹月普', '10945662', '12', '14339622'}"
23,"{'申万菱信(上海)资产管理有限公司', '50000000', '446707810', '银河资本资产管理有限公司', '新华基金管理有限公司', '财通基金管理有限公司', '竞价', '500400000', '株洲市国有资产投资控股集团有限公司', '50000019', '55289200', '500000190', '44670781', '552892000', '招商财富资产管理有限公司', '兴证证券资产管理有限公司', '100000000', '50040000', '1000000000', '天弘基金管理有限公司', '500000000', '创金合信基金管理有限公司', '12'}",1709982,8,"{'552892000', '500000190', '55289200', '竞价', '500400000', '446707810', '44670781', '50000019'}",6,"{'招商财富资产管理有限公司', '兴证证券资产管理有限公司', '天弘基金管理有限公司', '株洲市国有资产投资控股集团有限公司', '12', '银河资本资产管理有限公司'}",15,"{'招商财富资产管理有限公司', '新华基金管理有限公司', '兴证证券资产管理有限公司', '100000000', '50040000', '申万菱信(上海)资产管理有限公司', '财通基金管理有限公司', '1000000000', '天弘基金管理有限公司', '50000000', '500000000', '创金合信基金管理有限公司', '株洲市国有资产投资控股集团有限公司', '12', '银河资本资产管理有限公司'}"
23,"{'35000000', '1250000', '张华伟', '6000000', '安企软件', '36000000', '德道汇', '杉杉控股', '定价', '18000000', '鹏欣集团', '2500000', '3750000', '86400000', '张春雷', '赛飞汽车', '宣通实业', '11500000', '165600000', '504000000', '54000000', '青炜纺织', '36'}",172378,7,"{'165600000', '36000000', '504000000', '54000000', '18000000', '86400000', '1250000'}",11,"{'宣通实业', '德道汇', '杉杉控股', '定价', '青炜纺织', '鹏欣集团', '张华伟', '张春雷', '赛飞汽车', '36', '安企软件'}",16,"{'宣通实业', '11500000', '德道汇', '3750000', '杉杉控股', '35000000', '定价', '青炜纺织', '鹏欣集团', '张华伟', '6000000', '张春雷', '赛飞汽车', '36', '安企软件', '2500000'}"
10,"{'1060000000', '三峡集团', '现金', '股权、现金', '陕煤化集团', '952380952', '竞价', '5000000000', '201904762', '36'}",1726392,3,"{'1060000000', '竞价', '股权、现金'}",4,"{'36', '三峡集团', '现金', '陕煤化集团'}",7,"{'36', '三峡集团', '现金', '952380952', '5000000000', '201904762', '陕煤化集团'}"
12,"{'招商财富资产管理有限公司', '现金', '22727272', '信诚基金管理有限公司', '瑞元资本管理有限公司', '竞价', '15909090', '3198183', '14181818', '华安未来资产管理(上海)有限公司', '12', '中原期货股份有限公司'}",14905020,1,{'竞价'},6,"{'招商财富资产管理有限公司', '现金', '信诚基金管理有限公司', '瑞元资本管理有限公司', '12', '中原期货股份有限公司'}",11,"{'招商财富资产管理有限公司', '现金', '22727272', '信诚基金管理有限公司', '瑞元资本管理有限公司', '15909090', '3198183', '14181818', '华安未来资产管理(上海)有限公司', '12', '中原期货股份有限公司'}"
31,"{'江苏彩浩投资有限公司', '16000000', '659785800', '229020000', '124711800', '6500000', '140639100', '现金', '达孜县恒隆股权投资合伙企业(有限合伙)', '216632100', '11980000', '竞价', '20790000', '南通琦艺投资有限公司', '759930000', '达孜县恒盛股权投资合伙企业(有限合伙)', '南通泓翔股权投资合伙企业(有限合伙)', '13510000', '67665000', '216423900', '商赢控股有限公司', '旭森国际控股(集团)有限公司', '20810000', '青岛盈和投资合伙企业(有限合伙)', '63380000', '江苏隆明投资有限公司', '22000000', '166560000', '73000000', '旭源投资有限公司', '36'}",1846201,18,"{'20790000', '759930000', '16000000', '659785800', '20810000', '216632100', '13510000', '63380000', '229020000', '11980000', '124711800', '竞价', '166560000', '6500000', '73000000', '140639100', '67665000', '216423900'}",7,"{'江苏彩浩投资有限公司', '现金', '南通琦艺投资有限公司', '商赢控股有限公司', '江苏隆明投资有限公司', '旭源投资有限公司', '36'}",13,"{'江苏彩浩投资有限公司', '现金', '南通琦艺投资有限公司', '达孜县恒盛股权投资合伙企业(有限合伙)', '旭森国际控股(集团)有限公司', '商赢控股有限公司', '达孜县恒隆股权投资合伙企业(有限合伙)', '南通泓翔股权投资合伙企业(有限合伙)', '青岛盈和投资合伙企业(有限合伙)', '江苏隆明投资有限公司', '22000000', '旭源投资有限公司', '36'}"
13,"{'现金', '269100000', '2315300000', '立厦投资', '竞价', '北京中天瑞恒', '50000000', '299000000', '北京博维时代', '睿康投资', '387173913', '36', '45000000'}",1869811,1,{'竞价'},6,"{'36', '现金', '立厦投资', '北京博维时代', '睿康投资', '北京中天瑞恒'}",12,"{'现金', '269100000', '2315300000', '立厦投资', '北京中天瑞恒', '50000000', '299000000', '北京博维时代', '睿康投资', '387173913', '36', '45000000'}"
24,"{'49999999', '长城国融', '99999997', '60000001', '6793478', '张风', '199999993', '13586956', '杭州润石', '489999993', '博时基金', '张大煦', '现金', '4076087', '定价', '江斌', '33288043', '1698370', '吴明娜', '3396739', '25000007', '陈洪福', '陈佳良', '36'}",1680978,4,"{'25000007', '199999993', '60000001', '489999993'}",12,"{'现金', '长城国融', '定价', '江斌', '陈洪福', '陈佳良', '吴明娜', '张风', '杭州润石', '36', '博时基金', '张大煦'}",20,"{'49999999', '现金', '4076087', '33288043', '长城国融', '1698370', '99999997', '江斌', '陈洪福', '定价', '6793478', '陈佳良', '吴明娜', '3396739', '张风', '13586956', '杭州润石', '36', '博时基金', '张大煦'}"
6,"{'380126582', '现金', '33699165', '竞价', '第三期员工持股计划', '36'}",16599933,3,"{'380126582', '竞价', '33699165'}",3,"{'现金', '36', '第三期员工持股计划'}",3,"{'现金', '36', '第三期员工持股计划'}"
11,"{'现金', '江西伟宸信息技术有限公司', '沈培今', '26041650', '新力达集团', '西藏博启彰驰投资有限公司', '竞价', '47500000', '82708250', '36', '104166600'}",2384794,1,{'竞价'},6,"{'现金', '江西伟宸信息技术有限公司', '新力达集团', '西藏博启彰驰投资有限公司', '36', '沈培今'}",10,"{'现金', '江西伟宸信息技术有限公司', '沈培今', '26041650', '新力达集团', '西藏博启彰驰投资有限公司', '47500000', '82708250', '36', '104166600'}"
10,"{'江苏圆周', '现金', '牛奶有限公司', '143467220', '张轩松', '95704621', '239261552', '239261553', '36', '京东邦能'}",1881776,4,"{'95704621', '239261553', '143467220', '239261552'}",6,"{'江苏圆周', '现金', '牛奶有限公司', '张轩松', '36', '京东邦能'}",6,"{'江苏圆周', '现金', '牛奶有限公司', '张轩松', '36', '京东邦能'}"
12,"{'36', '现金', '天平汽车保险股份有限公司', '1361100', '4000000', '吕晓义', '竞价', '1660500', '天津硅谷天堂鲲鹏股权投资基金合伙企业(有限合伙)', '信达澳银基金管理有限公司', '华商基金管理有限公司', '12'}",201746,0,set(),8,"{'36', '现金', '天平汽车保险股份有限公司', '吕晓义', '竞价', '信达澳银基金管理有限公司', '华商基金管理有限公司', '12'}",12,"{'36', '现金', '天平汽车保险股份有限公司', '1361100', '4000000', '吕晓义', '竞价', '1660500', '天津硅谷天堂鲲鹏股权投资基金合伙企业(有限合伙)', '信达澳银基金管理有限公司', '华商基金管理有限公司', '12'}"
26,"{'国泰金牛创新成长股票型证券投资基金', '华夏蓝筹核心混合型证券投资基金', '上海成丰鼎泰股权投资合伙企业(有限合伙)', '4000000', '7000000', '西藏自治区投资有限公司', '3000000', '5000000', '现金', '1375389', '国泰金鹰增长证券投资基金', '定价', '全国社保基金一零七组合', '1200000', '800000', '浙江宝兴股权投资合伙企业(有限合伙)', '华夏盛世精选股票型证券投资基金', '华夏收入股票型证券投资基金', '全国社保基金一一一组合', '1800000', '华夏成长证券投资基金', '1500000', '江苏瑞华投资发展有限公司', '铁岭新鑫铜业有限公司', '国泰中小盘成长股票型证券投资基金', '12'}",1550459,1,{'定价'},2,"{'现金', '12'}",25,"{'国泰金牛创新成长股票型证券投资基金', '华夏蓝筹核心混合型证券投资基金', '上海成丰鼎泰股权投资合伙企业(有限合伙)', '4000000', '7000000', '西藏自治区投资有限公司', '3000000', '5000000', '现金', '1375389', '国泰金鹰增长证券投资基金', '全国社保基金一零七组合', '1200000', '800000', '浙江宝兴股权投资合伙企业(有限合伙)', '华夏盛世精选股票型证券投资基金', '华夏收入股票型证券投资基金', '全国社保基金一一一组合', '1800000', '华夏成长证券投资基金', '1500000', '江苏瑞华投资发展有限公司', '铁岭新鑫铜业有限公司', '国泰中小盘成长股票型证券投资基金', '12'}"
27,"{'8220000', '安志钢', '50018700', '现金', '13180000', '160400600', '申威', '定价', '6085000', '王建', '12170000', '500000', '2880000', '朱明', '段佩璋', '35049600', '100037400', '4110000', '24340000', '郭文亮', '2000000', '诺安基金', '张新育', '唐朝霞', '1000000', '周卓和', '36'}",1580741,11,"{'35049600', '13180000', '160400600', '8220000', '100037400', '4110000', '24340000', '2880000', '12170000', '6085000', '50018700'}",13,"{'现金', '申威', '定价', '郭文亮', '朱明', '诺安基金', '张新育', '安志钢', '唐朝霞', '段佩璋', '王建', '周卓和', '36'}",16,"{'现金', '申威', '定价', '500000', '郭文亮', '2000000', '朱明', '诺安基金', '张新育', '安志钢', '唐朝霞', '段佩璋', '1000000', '王建', '周卓和', '36'}"
7,"{'250000008.8', '100000017.6', '17818960', '7127585', 'IDG资本管理(香港)有限公司', '36', '华住酒店管理有限公司'}",676280,2,"{'100000017.6', '36'}",1,{'华住酒店管理有限公司'},5,"{'250000008.8', '17818960', 'IDG资本管理(香港)有限公司', '7127585', '华住酒店管理有限公司'}"
10,"{'128100000', '现金', '鹏华资产管理有限公司', '249688000', '130000000', '竞价', '创金合信基金管理有限公司', '建信基金管理有限责任公司', '华安未来资产管理(上海)有限公司', '12'}",17974910,4,"{'130000000', '249688000', '128100000', '竞价'}",5,"{'现金', '鹏华资产管理有限公司', '创金合信基金管理有限公司', '建信基金管理有限责任公司', '12'}",6,"{'现金', '鹏华资产管理有限公司', '创金合信基金管理有限公司', '建信基金管理有限责任公司', '华安未来资产管理(上海)有限公司', '12'}"
28,"{'251828586.3', '13552941', '泰达宏利基金管理有限公司', '29999985', '13317647', '现金', '1176470', '财通基金管理有限公司', '竞价', '鹏华基金管理有限公司', '王季文', '36', '兴全基金管理有限公司', '中泰证券股份有限公司', '宁波峰梅实业有限公司', '282999998.8', '中欧基金管理有限公司', '1411764', '287999996.3', '124999980', '11850757', '嘉实基金管理有限公司', '250999985', '5882352', '24999987.5', '泰康资产管理有限责任公司', '11811764', '12'}",18838862,4,"{'竞价', '251828586.3', '282999998.8', '287999996.3'}",13,"{'中欧基金管理有限公司', '现金', '兴全基金管理有限公司', '中泰证券股份有限公司', '12', '宁波峰梅实业有限公司', '嘉实基金管理有限公司', '财通基金管理有限公司', '泰达宏利基金管理有限公司', '鹏华基金管理有限公司', '王季文', '泰康资产管理有限责任公司', '36'}",24,"{'13552941', '泰达宏利基金管理有限公司', '29999985', '13317647', '现金', '1176470', '财通基金管理有限公司', '鹏华基金管理有限公司', '王季文', '36', '兴全基金管理有限公司', '中泰证券股份有限公司', '宁波峰梅实业有限公司', '中欧基金管理有限公司', '1411764', '124999980', '11850757', '嘉实基金管理有限公司', '250999985', '5882352', '24999987.5', '泰康资产管理有限责任公司', '11811764', '12'}"
4,"{'范建刚', '竞价', '现金', '36'}",308490,0,set(),4,"{'范建刚', '竞价', '现金', '36'}",4,"{'范建刚', '竞价', '现金', '36'}"
5,"{'现金', '钜盛华发行', '定价', '36', '前海人寿'}",1841301,0,set(),5,"{'现金', '钜盛华发行', '定价', '36', '前海人寿'}",5,"{'现金', '钜盛华发行', '定价', '36', '前海人寿'}"
19,"{'528999946', '平安大华基金管理有限公司', '5627659', '5319148', '民生资本投资管理有限公司', '499999912', '10957446', '国寿安保基金管理有限公司', '1000999984', '华安未来资产管理(上海)有限公司', '1029999924', '440000464', '颐和银丰实业有限公司', '大成创新资本管理有限公司', '泰达宏利基金管理有限公司', '鹏华资产管理(深圳)有限公司', '12', '4680856', '10648936'}",4917638,3,"{'10957446', '5627659', '4680856'}",7,"{'平安大华基金管理有限公司', '民生资本投资管理有限公司', '国寿安保基金管理有限公司', '颐和银丰实业有限公司', '大成创新资本管理有限公司', '泰达宏利基金管理有限公司', '12'}",16,"{'528999946', '平安大华基金管理有限公司', '5319148', '民生资本投资管理有限公司', '499999912', '国寿安保基金管理有限公司', '1000999984', '华安未来资产管理(上海)有限公司', '1029999924', '440000464', '颐和银丰实业有限公司', '大成创新资本管理有限公司', '泰达宏利基金管理有限公司', '鹏华资产管理(深圳)有限公司', '12', '10648936'}"
4,"{'竞价', '现金', '36', '水利部综合开发管理中心'}",727944,0,set(),4,"{'竞价', '现金', '36', '水利部综合开发管理中心'}",4,"{'竞价', '现金', '36', '水利部综合开发管理中心'}"
19,"{'36', '现金', '新华基金管理有限公司', '748440000', '12', '1209686795', '60', '77000000', '65000000', '631800000', '65273684', '634460208.5', '国泰基金管理有限公司', '124453374', '河北港口', '815308642', '7924800000', '中远集团', '招融投资'}",12205,1,{'634460208.5'},9,"{'36', '现金', '新华基金管理有限公司', '12', '60', '国泰基金管理有限公司', '河北港口', '中远集团', '招融投资'}",18,"{'36', '新华基金管理有限公司', '现金', '748440000', '12', '1209686795', '60', '77000000', '65000000', '631800000', '65273684', '国泰基金管理有限公司', '124453374', '河北港口', '815308642', '7924800000', '中远集团', '招融投资'}"
9,"{'150000000', '现金', '3251500000', '350000000', '定价', '中国人寿保险(集团)公司', '中国人寿保险股份有限公司', '12', '1393500000'}",1490136,6,"{'150000000', '现金', '350000000', '定价', '3251500000', '1393500000'}",2,"{'中国人寿保险股份有限公司', '12'}",3,"{'中国人寿保险股份有限公司', '中国人寿保险(集团)公司', '12'}"
5,"{'1999999999', '现金', '招商局轮船', '定价', '36'}",1729358,1,{'1999999999'},4,"{'招商局轮船', '定价', '现金', '36'}",4,"{'招商局轮船', '定价', '现金', '36'}"
19,"{'金鹰基金管理有限公司', '224200000', '宝盈基金管理有限公司', '70000000', '定价', '张家港市直属公有资产经营有限公司', '中新苏州工业园区城市投资运营有限公司', '苏州物资控股(集团)有限责任公司', '365800000', '354000000', '苏州历史文化名城发展集团有限公司', '826000000', '鹏华基金管理有限公司', '青岛城投金融控股集团有限公司', '31000000', '19000000', '30000000', '12', '江苏省吴中经济技术发展总公司'}",1874809,6,"{'224200000', '365800000', '354000000', '826000000', '31000000', '19000000'}",3,"{'定价', '青岛城投金融控股集团有限公司', '12'}",13,"{'金鹰基金管理有限公司', '中新苏州工业园区城市投资运营有限公司', '70000000', '张家港市直属公有资产经营有限公司', '定价', '苏州物资控股(集团)有限责任公司', '苏州历史文化名城发展集团有限公司', '青岛城投金融控股集团有限公司', '鹏华基金管理有限公司', '宝盈基金管理有限公司', '30000000', '12', '江苏省吴中经济技术发展总公司'}"
6,"{'现金', '长城集团', '定价', '119999998.1', '21390374', '36'}",1832290,0,set(),4,"{'长城集团', '36', '定价', '现金'}",6,"{'现金', '长城集团', '定价', '119999998.1', '21390374', '36'}"
13,"{'12000000', '150000000', '现金', '顾玉兔', '38000000', '施建刚', '定价', '15000000', '120000000', '380000000', '华昌化工', '周一峰', '36'}",212740,6,"{'12000000', '150000000', '38000000', '15000000', '120000000', '380000000'}",7,"{'顾玉兔', '现金', '施建刚', '定价', '华昌化工', '周一峰', '36'}",7,"{'现金', '顾玉兔', '施建刚', '定价', '华昌化工', '周一峰', '36'}"
11,"{'现金', '55848280', '许锦光', '周镇科', '陈少达', '4748356', '8547041', '黄永建', '3798685', '陈乐强', '36'}",1863765,0,set(),7,"{'现金', '许锦光', '周镇科', '陈少达', '黄永建', '陈乐强', '36'}",11,"{'现金', '55848280', '许锦光', '周镇科', '陈少达', '4748356', '8547041', '黄永建', '3798685', '陈乐强', '36'}"
5,"{'现金', '竞价', '79000000', '36', '福建旗滨'}",380119,1,{'79000000'},4,"{'竞价', '现金', '36', '福建旗滨'}",4,"{'竞价', '现金', '36', '福建旗滨'}"
15,"{'31360000', '现金', '瑞士银行(UBS AG)', '172480000', '华夏基金管理有限公司', '4000000', '定价', '94080000', '2000000', '红塔证券股份有限公司', '11000000', '东吴证券有限责任公司', '6000000', '62720000', '12'}",1399486,5,"{'31360000', '172480000', '瑞士银行(UBS AG)', '94080000', '62720000'}",3,"{'定价', '现金', '12'}",10,"{'现金', '华夏基金管理有限公司', '4000000', '定价', '2000000', '红塔证券股份有限公司', '11000000', '东吴证券有限责任公司', '6000000', '12'}"
4,"{'许开华', '竞价', '现金', '36'}",15676237,1,{'竞价'},3,"{'许开华', '现金', '36'}",3,"{'许开华', '现金', '36'}"
4,"{'竞价', '现金', '黑龙江省建设集团有限公司', '36'}",1763632,0,set(),4,"{'竞价', '现金', '黑龙江省建设集团有限公司', '36'}",4,"{'竞价', '现金', '黑龙江省建设集团有限公司', '36'}"
6,"{'现金', '819999999.7', '竞价', '粤电集团', '138047138', '36'}",71117,1,{'竞价'},3,"{'粤电集团', '现金', '36'}",5,"{'现金', '819999999.7', '粤电集团', '138047138', '36'}"
12,"{'5000000', '现金', '陶雷', '定价', '18000000', '黄舒敏', '50000000', '高壹名', '北京古茂投资管理中心(有限合伙)', '黄宇', '36', '105571428'}",369615,3,"{'18000000', '50000000', '105571428'}",7,"{'现金', '陶雷', '定价', '黄舒敏', '高壹名', '黄宇', '36'}",9,"{'5000000', '现金', '陶雷', '定价', '黄舒敏', '高壹名', '北京古茂投资管理中心(有限合伙)', '黄宇', '36'}"
16,"{'4309392', '现金', '北信瑞丰基金管理有限公司', '116999992.8', '79999999.95', '西部证券股份有限公司', '753157', '定价', '2946593', '20448212.55', '申万菱信基金管理有限公司', '宝盈基金管理有限公司', '61999984.35', '2283609', '建信基金管理有限责任公司', '12'}",15526885,0,set(),8,"{'现金', '北信瑞丰基金管理有限公司', '西部证券股份有限公司', '定价', '申万菱信基金管理有限公司', '宝盈基金管理有限公司', '建信基金管理有限责任公司', '12'}",16,"{'4309392', '现金', '北信瑞丰基金管理有限公司', '116999992.8', '79999999.95', '西部证券股份有限公司', '753157', '定价', '2946593', '20448212.55', '申万菱信基金管理有限公司', '宝盈基金管理有限公司', '61999984.35', '2283609', '建信基金管理有限责任公司', '12'}"
9,"{'20000000', '现金', '631250000', '定价', '25000000', '曾鸿斌', '505000000', '前海开源基金管理有限公司', '36'}",1667143,3,"{'505000000', '631250000', '25000000'}",6,"{'20000000', '现金', '定价', '曾鸿斌', '前海开源基金管理有限公司', '36'}",6,"{'20000000', '现金', '定价', '曾鸿斌', '前海开源基金管理有限公司', '36'}"
25,"{'15390979', '199999986.9', '204700020.7', '7518797', '159999997.5', '现金', '杨伟平', '财通基金管理有限公司', '竞价', '100000000.1', '宜昌兴发集团有限责任公司', '36', '太平洋资产管理有限责任公司', '3759399', '15037593', '湖北鼎铭投资有限公司', '中信证券股份有限公司', '华融瑞通股权投资管理有限公司', '12030075', '华融(天津自贸区)投资股份有限公司', '50000006.7', '12428571', '165299994.3', '颐和银丰(天津)投资管理有限公司', '12'}",19304289,1,{'竞价'},4,"{'36', '现金', '12', '宜昌兴发集团有限责任公司'}",24,"{'15390979', '199999986.9', '204700020.7', '7518797', '159999997.5', '现金', '杨伟平', '财通基金管理有限公司', '100000000.1', '宜昌兴发集团有限责任公司', '36', '太平洋资产管理有限责任公司', '3759399', '15037593', '湖北鼎铭投资有限公司', '中信证券股份有限公司', '华融瑞通股权投资管理有限公司', '12030075', '华融(天津自贸区)投资股份有限公司', '50000006.7', '12428571', '165299994.3', '颐和银丰(天津)投资管理有限公司', '12'}"
13,"{'太阳雨控股集团有限公司', '现金', '北信瑞丰基金管理有限公司', '鹏华资产管理有限公司', '2946969', '1509199', '北京财智联合理财顾问有限公司', '11757575', '竞价', '3787878', '上海小村资产管理有限公司', '12', '8840909'}",15582833,0,set(),7,"{'太阳雨控股集团有限公司', '现金', '北信瑞丰基金管理有限公司', '鹏华资产管理有限公司', '竞价', '上海小村资产管理有限公司', '12'}",13,"{'太阳雨控股集团有限公司', '现金', '北信瑞丰基金管理有限公司', '鹏华资产管理有限公司', '2946969', '1509199', '北京财智联合理财顾问有限公司', '11757575', '竞价', '3787878', '上海小村资产管理有限公司', '12', '8840909'}"
13,"{'陈慕群', '天天向上龟龄集资管计划', '现金', '16000000', '涪商集团', '蒋仕波', '广誉远安宫清心资管计划', '7000000', '2000000', '竞价', '3000000', '平安富贵定坤丹资管计划', '36'}",90944,1,{'竞价'},8,"{'陈慕群', '天天向上龟龄集资管计划', '现金', '涪商集团', '蒋仕波', '广誉远安宫清心资管计划', '平安富贵定坤丹资管计划', '36'}",12,"{'陈慕群', '天天向上龟龄集资管计划', '现金', '16000000', '涪商集团', '蒋仕波', '广誉远安宫清心资管计划', '7000000', '2000000', '3000000', '平安富贵定坤丹资管计划', '36'}"
11,"{'慧达投资', '现金', '1022787', '聚星投资', '定价', '聚合投资', '1006889', '郭松森', '1916268', '36', '22551141'}",1772218,3,"{'1022787', '22551141', '1006889'}",6,"{'慧达投资', '现金', '聚星投资', '定价', '聚合投资', '郭松森'}",8,"{'慧达投资', '现金', '聚星投资', '定价', '聚合投资', '郭松森', '1916268', '36'}"
18,"{'无锡市文化发展集团有限公司', '中山证券有限责任公司', '1647902', '2920870', '2655337', '12', '559999982.1', '109999964.2', '杨志英', '99999991.42', '竞价', '62059989.32', '王玫', '99640037.14', '2645779', '于浩洋', '36', '14869888'}",18290794,5,"{'559999982.1', '99999991.42', '竞价', '62059989.32', '99640037.14'}",3,"{'36', '王玫', '12'}",13,"{'无锡市文化发展集团有限公司', '中山证券有限责任公司', '1647902', '2920870', '2655337', '12', '109999964.2', '杨志英', '王玫', '2645779', '于浩洋', '36', '14869888'}"
13,"{'39060606', '付驹', '铁岭经营公司', '三助嘉禾', '12', '定价', '11340175', '63000977', '罗德安', '12600195', '126001955', '京润蓝筹', '36'}",912242,0,set(),8,"{'付驹', '36', '铁岭经营公司', '三助嘉禾', '定价', '罗德安', '京润蓝筹', '12'}",13,"{'39060606', '付驹', '铁岭经营公司', '三助嘉禾', '12', '定价', '11340175', '63000977', '罗德安', '12600195', '126001955', '京润蓝筹', '36'}"
7,"{'现金', '鸿达兴业集团有限公司', '国华人寿保险股份有限公司', '52700922', '广东潮商会投资管理有限公司', '26350461', '36'}",372798,2,"{'26350461', '52700922'}",5,"{'现金', '鸿达兴业集团有限公司', '国华人寿保险股份有限公司', '广东潮商会投资管理有限公司', '36'}",5,"{'现金', '鸿达兴业集团有限公司', '国华人寿保险股份有限公司', '广东潮商会投资管理有限公司', '36'}"
28,"{'西藏金宝藏', '6380000', '新疆嘉梦', '西藏九达', '3000000', '423845400', '新疆愚公', '47410000', '38000000', '339720000', '37905700', '52698300', '西藏金桔', '北京北清', '石河子无极', '57037200', '生命人寿', '471122800', '1358880000', '宁波大有', '17880000', '279999900', '31319900', '152000000', '2000000', '338877000', '26820000', '36'}",340743,16,"{'47410000', '279999900', '6380000', '38000000', '31319900', '57037200', '339720000', '152000000', '471122800', '1358880000', '37905700', '338877000', '423845400', '17880000', '26820000', '52698300'}",10,"{'西藏金桔', '西藏金宝藏', '新疆嘉梦', '北京北清', '石河子无极', '西藏九达', '生命人寿', '宁波大有', '36', '新疆愚公'}",12,"{'西藏金桔', '西藏金宝藏', '新疆嘉梦', '北京北清', '石河子无极', '西藏九达', '生命人寿', '2000000', '3000000', '宁波大有', '36', '新疆愚公'}"
12,"{'129999989.4', '鹏华资产管理有限公司', '128099999.4', '248999987.4', '定价', '18349299', '9579955', '创金合信基金管理有限公司', '建信基金管理有限责任公司', '华安未来资产管理(上海)有限公司', '12', '9439941'}",17974947,2,"{'129999989.4', '128099999.4'}",5,"{'鹏华资产管理有限公司', '定价', '创金合信基金管理有限公司', '建信基金管理有限责任公司', '12'}",10,"{'鹏华资产管理有限公司', '248999987.4', '定价', '18349299', '9579955', '创金合信基金管理有限公司', '建信基金管理有限责任公司', '华安未来资产管理(上海)有限公司', '12', '9439941'}"
27,"{'161404041', '华泰资产管理有限公司', '173901450', '建信基金管理有限责任公司', '524286787', '161580310', '现金', '鹏华资产管理有限公司', '181345336', '定价', '深圳市平安置业投资有限公司', '699992997', '财通基金管理有限公司', '623019598.3', '95581914.44', '宏信证券有限责任公司', '623699996.6', '诺安基金管理有限公司', '671259597', '848262498.6', '643006396.5', '219757124', '2023746998', '166581968', '中国国有企业结构调整基金股份有限公司', '24762154', '12'}",15632201,4,"{'623019598.3', '2023746998', '643006396.5', '699992997'}",10,"{'宏信证券有限责任公司', '现金', '鹏华资产管理有限公司', '诺安基金管理有限公司', '定价', '深圳市平安置业投资有限公司', '财通基金管理有限公司', '华泰资产管理有限公司', '建信基金管理有限责任公司', '12'}",23,"{'161404041', '华泰资产管理有限公司', '173901450', '建信基金管理有限责任公司', '524286787', '161580310', '现金', '鹏华资产管理有限公司', '181345336', '定价', '深圳市平安置业投资有限公司', '财通基金管理有限公司', '95581914.44', '宏信证券有限责任公司', '623699996.6', '诺安基金管理有限公司', '671259597', '848262498.6', '219757124', '166581968', '中国国有企业结构调整基金股份有限公司', '24762154', '12'}"
28,"{'248074', '1954823.12', '安徽省铁路建设投资基金有限公司', '220022499.6', '219999994.3', '230999985.7', '215500002.1', '现金', '定价', '215500207', '安徽中安资本投资基金有限公司', '430999996.3', '宝盈基金管理有限公司', '54695431', '27921637', '50761420', '华泰柏瑞基金管理有限公司', '华夏人寿保险股份有限公司', '399999989.6', '27347716', '上海汽车集团股权投资有限公司', '29314719', '27918781', '泓德基金管理有限公司', '招商财富资产管理有限公司', '金鹰基金管理有限公司', '27347742', '12'}",1826284,6,"{'1954823.12', '220022499.6', '215500207', '219999994.3', '430999996.3', '215500002.1'}",12,"{'招商财富资产管理有限公司', '华夏人寿保险股份有限公司', '金鹰基金管理有限公司', '现金', '上海汽车集团股权投资有限公司', '安徽省铁路建设投资基金有限公司', '定价', '安徽中安资本投资基金有限公司', '宝盈基金管理有限公司', '华泰柏瑞基金管理有限公司', '12', '泓德基金管理有限公司'}",22,"{'248074', '安徽省铁路建设投资基金有限公司', '230999985.7', '现金', '定价', '安徽中安资本投资基金有限公司', '宝盈基金管理有限公司', '54695431', '27921637', '50761420', '华泰柏瑞基金管理有限公司', '华夏人寿保险股份有限公司', '399999989.6', '27347716', '上海汽车集团股权投资有限公司', '29314719', '27918781', '泓德基金管理有限公司', '招商财富资产管理有限公司', '金鹰基金管理有限公司', '27347742', '12'}"
6,"{'21505400', '现金', '100000000', '竞价', '黑龙江省建设集团有限公司', '36'}",2036031,2,"{'100000000', '21505400'}",4,"{'竞价', '现金', '黑龙江省建设集团有限公司', '36'}",4,"{'竞价', '现金', '黑龙江省建设集团有限公司', '36'}"
18,"{'巨人投资有限公司', '5000000', '现金', '新华人寿保险股份有限公司', '4000000', '定价', '北京浩成投资管理有限公司', '7000000', '海南智灵通网络信息有限公司', '北京汇鑫伟业投资有限公司', '上海远达软件有限公司', '西藏坤泰投资管理有限公司', '北京国仁天志投资顾问有限公司', '3000000', '北京信特盛石油科技有限公司', '6000000', '8000000', '12'}",546008,0,set(),12,"{'巨人投资有限公司', '现金', '新华人寿保险股份有限公司', '定价', '北京浩成投资管理有限公司', '海南智灵通网络信息有限公司', '北京汇鑫伟业投资有限公司', '上海远达软件有限公司', '西藏坤泰投资管理有限公司', '北京国仁天志投资顾问有限公司', '北京信特盛石油科技有限公司', '12'}",18,"{'巨人投资有限公司', '5000000', '现金', '新华人寿保险股份有限公司', '4000000', '定价', '北京浩成投资管理有限公司', '7000000', '海南智灵通网络信息有限公司', '北京汇鑫伟业投资有限公司', '上海远达软件有限公司', '西藏坤泰投资管理有限公司', '北京国仁天志投资顾问有限公司', '3000000', '北京信特盛石油科技有限公司', '6000000', '8000000', '12'}"
4,"{'中发控股集团有限公司', '竞价', '现金', '36'}",239294,0,set(),4,"{'中发控股集团有限公司', '竞价', '现金', '36'}",4,"{'中发控股集团有限公司', '竞价', '现金', '36'}"
26,"{'12000000', '270675000', '4000000', '金瑞浩', '阮伟祥', '陈国江', '罗斌', '6000000', '周波', '现金', '项志峰', '30000000', '72180000', '360900000', '5500000', '66165000', '144360000', '38496000', '22500000', '3200000', '阮兴祥', '何旭斌', '48120000', '姚建芳', '王勇', '36'}",106428,14,"{'12000000', '270675000', '3200000', '4000000', '360900000', '48120000', '5500000', '66165000', '144360000', '38496000', '22500000', '6000000', '30000000', '72180000'}",11,"{'周波', '现金', '阮兴祥', '何旭斌', '金瑞浩', '阮伟祥', '项志峰', '陈国江', '罗斌', '姚建芳', '王勇'}",12,"{'周波', '现金', '阮兴祥', '何旭斌', '金瑞浩', '阮伟祥', '项志峰', '陈国江', '罗斌', '姚建芳', '王勇', '36'}"
16,"{'平安大华基金管理有限公司', '36', '太平洋资产管理有限责任公司', '19800000', '6800000', '李广超', '青岛煜明投资中心(有限合伙)', '财通基金管理有限公司', '5500000', '宝盈基金管理有限公司', '6000000', '10000000', '10900000', '12', '张淑玲', '8400000'}",1034185,6,"{'5500000', '6000000', '10000000', '10900000', '6800000', '8400000'}",5,"{'太平洋资产管理有限责任公司', '12', '李广超', '宝盈基金管理有限公司', '36'}",10,"{'平安大华基金管理有限公司', '36', '太平洋资产管理有限责任公司', '19800000', '李广超', '青岛煜明投资中心(有限合伙)', '财通基金管理有限公司', '宝盈基金管理有限公司', '12', '张淑玲'}"
6,"{'现金', '定价', '1194115000', '67236204', '当代科技', '36'}",15760486,2,"{'67236204', '1194115000'}",4,"{'定价', '当代科技', '现金', '36'}",4,"{'现金', '当代科技', '定价', '36'}"
16,"{'南京瑞森投资管理合伙企业(有限合伙)', '16000000', '兴证证券资产管理有限公司', '兴业全球基金管理有限公司', '16700000', '国华人寿保险股份有限公司', '申万菱信(上海)资产管理有限公司', '东海基金管理有限责任公司', '15700000', '融通基金管理有限公司', '嘉实基金管理有限公司', '竞价', '东方国际(集团)有限公司', '21208700', '20500000', '12'}",314688,3,"{'16700000', '21208700', '20500000'}",3,"{'竞价', '国华人寿保险股份有限公司', '12'}",13,"{'南京瑞森投资管理合伙企业(有限合伙)', '16000000', '兴证证券资产管理有限公司', '兴业全球基金管理有限公司', '国华人寿保险股份有限公司', '申万菱信(上海)资产管理有限公司', '东海基金管理有限责任公司', '15700000', '融通基金管理有限公司', '嘉实基金管理有限公司', '东方国际(集团)有限公司', '竞价', '12'}"
28,"{'15809469', '启迪桑德第一期员工持股计划', '启迪绿源', '1620293358', '3261635', '嘉实基金', '西藏清控', '288773372.6', '现金', '启迪投资', '5266447', '15819598', '汇添富基金', '89336182.65', '定价', '10543022', '35143409', '433021355.9', '962577972.5', '59156384', '433298789.2', '金信灏海', '144247983.3', '桑德控股', '17277998', '邦信资产', '36', '473244365.2'}",16527833,2,"{'288773372.6', '1620293358'}",12,"{'现金', '启迪投资', '汇添富基金', '启迪桑德第一期员工持股计划', '定价', '启迪绿源', '金信灏海', '桑德控股', '嘉实基金', '西藏清控', '邦信资产', '36'}",26,"{'15809469', '启迪桑德第一期员工持股计划', '启迪绿源', '3261635', '嘉实基金', '西藏清控', '现金', '启迪投资', '5266447', '15819598', '汇添富基金', '89336182.65', '定价', '10543022', '35143409', '433021355.9', '962577972.5', '59156384', '433298789.2', '金信灏海', '144247983.3', '桑德控股', '17277998', '邦信资产', '36', '473244365.2'}"
16,"{'上海万融投资发展有限公司', '现金', '3200000', '4000000', '国华人寿保险股份有限公司', '900000', '华宝信托有限责任公司', '上海英博企业发展有限公司', '竞价', '3000000', '安康(天津)股权投资基金合伙企业(有限合伙)', '季坚义', '上海天臻实业有限公司', '9900000', '12', '上海混沌投资有限公司'}",496834,5,"{'3200000', '4000000', '900000', '3000000', '9900000'}",10,"{'上海万融投资发展有限公司', '现金', '国华人寿保险股份有限公司', '华宝信托有限责任公司', '上海英博企业发展有限公司', '竞价', '季坚义', '上海天臻实业有限公司', '12', '上海混沌投资有限公司'}",11,"{'上海万融投资发展有限公司', '现金', '国华人寿保险股份有限公司', '华宝信托有限责任公司', '上海英博企业发展有限公司', '竞价', '安康(天津)股权投资基金合伙企业(有限合伙)', '季坚义', '上海天臻实业有限公司', '12', '上海混沌投资有限公司'}"
16,"{'12000000', '8000000', '新华基金管理有限公司', '新华人寿保险股份有限公司', '百年化妆护理品有限公司', '华安证券有限责任公司', '定价', '章小格', '嘉实基金管理有限公司', '尤飞煌', '7000000', '中信证券股份有限公司', '10000000', '9000000', '12', '中国东方资产管理公司'}",499738,1,{'7000000'},11,"{'新华基金管理有限公司', '新华人寿保险股份有限公司', '百年化妆护理品有限公司', '华安证券有限责任公司', '定价', '章小格', '嘉实基金管理有限公司', '中信证券股份有限公司', '尤飞煌', '12', '中国东方资产管理公司'}",15,"{'12000000', '8000000', '新华基金管理有限公司', '新华人寿保险股份有限公司', '百年化妆护理品有限公司', '华安证券有限责任公司', '章小格', '定价', '嘉实基金管理有限公司', '尤飞煌', '中信证券股份有限公司', '10000000', '9000000', '12', '中国东方资产管理公司'}"
12,"{'天津联亿乾坤贸易有限公司', '现金', '1000000', '大连乾阳科技有限公司', '定价', '51230000', '115267500', '北京中京伟业投资管理有限责任公司', '北京隆达创展科贸有限公司', '荣继华', '2250000', '12'}",1879850,0,set(),8,"{'天津联亿乾坤贸易有限公司', '现金', '大连乾阳科技有限公司', '定价', '北京中京伟业投资管理有限责任公司', '北京隆达创展科贸有限公司', '荣继华', '12'}",12,"{'天津联亿乾坤贸易有限公司', '现金', '1000000', '大连乾阳科技有限公司', '定价', '51230000', '115267500', '北京中京伟业投资管理有限责任公司', '北京隆达创展科贸有限公司', '荣继华', '2250000', '12'}"
13,"{'4716661', '现金', '164705872', '西藏元泽', '海尔创投', '定价', '247058807.9', '28299978', '亚东复星', '41176450.53', '18866652', '东方创投', '36'}",9889849,2,"{'41176450.53', '164705872'}",7,"{'现金', '西藏元泽', '海尔创投', '定价', '亚东复星', '东方创投', '36'}",11,"{'4716661', '现金', '西藏元泽', '海尔创投', '定价', '247058807.9', '28299978', '亚东复星', '18866652', '东方创投', '36'}"
6,"{'现金', '定价', '31654182', '253550000', '横店集团控股有限公司', '36'}",16926592,1,{'253550000'},4,"{'36', '定价', '现金', '横店集团控股有限公司'}",5,"{'现金', '定价', '31654182', '横店集团控股有限公司', '36'}"
11,"{'11206328', '339999991.5', '169999995.8', '5603164', '嘉实基金管理有限公司', '竞价', '9190508', '上海中汇金锐投资管理有限公司', '前海开源基金管理有限公司', '12', '278840012.7'}",15960152,2,"{'竞价', '169999995.8'}",4,"{'上海中汇金锐投资管理有限公司', '前海开源基金管理有限公司', '12', '嘉实基金管理有限公司'}",9,"{'11206328', '339999991.5', '5603164', '12', '嘉实基金管理有限公司', '9190508', '前海开源基金管理有限公司', '上海中汇金锐投资管理有限公司', '278840012.7'}"
18,"{'68994306', '现金', '390000000', '7614213', '定价', '90000000', '32994923', '蒋元生', '中科创资产', '815512700', '袁永刚', '1400000000', '正能量资产', '6768189', '80000000', '36', '隆华汇管理的股权投资基金', '118443316'}",1875557,5,"{'390000000', '90000000', '815512700', '1400000000', '80000000'}",8,"{'36', '现金', '定价', '蒋元生', '中科创资产', '袁永刚', '正能量资产', '隆华汇管理的股权投资基金'}",13,"{'68994306', '现金', '7614213', '定价', '32994923', '蒋元生', '中科创资产', '袁永刚', '正能量资产', '6768189', '36', '隆华汇管理的股权投资基金', '118443316'}"
18,"{'20000000', '现金', '4790884', '梁昭平', '定价', '1340482', '上海道杰席胜投资中心(有限合伙)', '3351206', '5361930', '50000000', '71480000', '中信证券-瑞普生物投资1号定向资产管理计划', '梁武', '李守军', '7500000', '80000000', '36', '502680'}",12056824,7,"{'20000000', '3351206', '5361930', '71480000', '1340482', '502680', '7500000'}",6,"{'现金', '梁昭平', '定价', '梁武', '李守军', '36'}",11,"{'现金', '4790884', '梁昭平', '上海道杰席胜投资中心(有限合伙)', '定价', '50000000', '梁武', '中信证券-瑞普生物投资1号定向资产管理计划', '李守军', '80000000', '36'}"
15,"{'5000000', '北京硅谷天堂鲲诚创业投资有限公司', '4600000', '4000000', '雅戈尔投资有限公司', '5542500', '华宝信托有限责任公司', '上海天臻实业有限公司', '4200000', '7900000', '欧吉钦', '华宝投资有限公司', '10000000', '李学明', '12'}",1127900,0,set(),7,"{'北京硅谷天堂鲲诚创业投资有限公司', '12', '华宝信托有限责任公司', '欧吉钦', '华宝投资有限公司', '李学明', '上海天臻实业有限公司'}",15,"{'5000000', '北京硅谷天堂鲲诚创业投资有限公司', '4600000', '4000000', '雅戈尔投资有限公司', '5542500', '华宝信托有限责任公司', '上海天臻实业有限公司', '4200000', '7900000', '欧吉钦', '华宝投资有限公司', '10000000', '李学明', '12'}"
8,"{'大通燃气员工持股计划', '现金', '李可珍', '竞价', '陈蓉章', '大通集团', '36', '李朝波'}",1637792,0,set(),8,"{'大通燃气员工持股计划', '现金', '李可珍', '李朝波', '竞价', '大通集团', '36', '陈蓉章'}",8,"{'大通燃气员工持股计划', '现金', '李可珍', '竞价', '陈蓉章', '大通集团', '36', '李朝波'}"
4,"{'嘉化集团', '竞价', '现金', '36'}",1850619,0,set(),4,"{'嘉化集团', '竞价', '现金', '36'}",4,"{'嘉化集团', '竞价', '现金', '36'}"
13,"{'浙江富春江通信集团有限公司', '现金', '40000000', '吴斌', '8500000', '3250000', '67330200', '张忠梅', '46000000', '深圳潇湘君秀投资企业(有限合伙)', '张杰', '民生加银-西南证券鑫牛定向增发42号资产管理计划', '36'}",347622,5,"{'8500000', '40000000', '3250000', '67330200', '46000000'}",6,"{'36', '浙江富春江通信集团有限公司', '现金', '吴斌', '张忠梅', '张杰'}",8,"{'浙江富春江通信集团有限公司', '现金', '吴斌', '张忠梅', '深圳潇湘君秀投资企业(有限合伙)', '张杰', '民生加银-西南证券鑫牛定向增发42号资产管理计划', '36'}"
16,"{'67116816', '8327312', '现金', '刘辉', '8351122', '239826585.6', '润达惠员工持股1号', '定价', '九江昊诚', '12526683', '240512313.6', '朱文怡', '2330445', '360768470.4', '东营东创', '36'}",4926329,0,set(),8,"{'现金', '刘辉', '润达惠员工持股1号', '定价', '九江昊诚', '朱文怡', '东营东创', '36'}",16,"{'67116816', '8327312', '现金', '刘辉', '8351122', '239826585.6', '润达惠员工持股1号', '定价', '九江昊诚', '12526683', '240512313.6', '朱文怡', '2330445', '360768470.4', '东营东创', '36'}"
5,"{'141110066', '1500000002', '现金', '株洲所', '36'}",285370,2,"{'141110066', '1500000002'}",3,"{'现金', '株洲所', '36'}",3,"{'现金', '株洲所', '36'}"
6,"{'现金', '定价', '练卫', '727500000', '50000000', '36'}",572873,2,"{'727500000', '50000000'}",4,"{'36', '定价', '练卫', '现金'}",4,"{'36', '定价', '练卫', '现金'}"
20,"{'泰康资产管理有限责任公司', '现金', '北信瑞丰基金管理有限公司', '298136600', '2399999630', '124099300', '万家基金管理有限公司', '998999365', '1599999485', '竞价', '601003340', '198757700', '99378800', '中国人寿资产管理有限公司', '泰达宏利基金管理有限公司', '799999340', '诺德基金管理有限公司', '万家共赢资产管理有限公司', '12', '74658800'}",18304202,1,{'竞价'},8,"{'泰康资产管理有限责任公司', '现金', '万家基金管理有限公司', '中国人寿资产管理有限公司', '泰达宏利基金管理有限公司', '诺德基金管理有限公司', '万家共赢资产管理有限公司', '12'}",19,"{'泰康资产管理有限责任公司', '298136600', '北信瑞丰基金管理有限公司', '现金', '2399999630', '124099300', '万家基金管理有限公司', '998999365', '1599999485', '601003340', '198757700', '99378800', '中国人寿资产管理有限公司', '泰达宏利基金管理有限公司', '799999340', '诺德基金管理有限公司', '万家共赢资产管理有限公司', '12', '74658800'}"
18,"{'现金', '长城国泰(舟山)产业并购重组基金合伙企业(有限合伙)', '25445292', '101781170', '400000000', '周明德', '宁波梅山保税港区厚扬启航二期股权投资中心(有限合伙)', '200000000', '湖北中经资本投资发展有限公司', '新疆沣华盛鼎股权投资管理有限公司', '楚昌投资集团有限公司', '2000000000', '300000000', '500000000', '10178117', '15267175', '36', '20356234'}",16377083,5,"{'400000000', '300000000', '2000000000', '500000000', '200000000'}",6,"{'现金', '周明德', '湖北中经资本投资发展有限公司', '楚昌投资集团有限公司', '新疆沣华盛鼎股权投资管理有限公司', '36'}",13,"{'现金', '长城国泰(舟山)产业并购重组基金合伙企业(有限合伙)', '25445292', '101781170', '周明德', '宁波梅山保税港区厚扬启航二期股权投资中心(有限合伙)', '湖北中经资本投资发展有限公司', '新疆沣华盛鼎股权投资管理有限公司', '楚昌投资集团有限公司', '10178117', '15267175', '36', '20356234'}"
15,"{'150000000', '现金', '600000000', '350000000', '定价', '200000000', '47021943', '62695924', '延万华', '黄山海慧科技投资有限公司', '109717868', '新华联控股有限公司', '36', '杜玉岱', '188087774'}",16923905,3,"{'62695924', '109717868', '188087774'}",7,"{'现金', '定价', '延万华', '黄山海慧科技投资有限公司', '新华联控股有限公司', '36', '杜玉岱'}",12,"{'150000000', '现金', '600000000', '350000000', '定价', '47021943', '延万华', '黄山海慧科技投资有限公司', '200000000', '新华联控股有限公司', '36', '杜玉岱'}"
9,"{'20000000', '陕西有色', '现金', '定价', '143000000', '17000000', '延长石油', '民生银行', '36'}",1130400,3,"{'20000000', '17000000', '143000000'}",6,"{'陕西有色', '现金', '定价', '延长石油', '民生银行', '36'}",6,"{'陕西有色', '现金', '定价', '延长石油', '民生银行', '36'}"
5,"{'现金', '600000000', '竞价', '桑德集团', '36'}",348611,1,{'600000000'},4,"{'竞价', '现金', '桑德集团', '36'}",4,"{'竞价', '现金', '桑德集团', '36'}"
16,"{'25252525', '36', '福能集团', '现金', '599999994', '平安资管公司', '12626262', '199999998', '福建投资集团', '25252527', '竞价', '75757575', '200000013.8', '99999995.04', '福建交通运输集团', '福汽集团'}",478865,9,"{'25252525', '12626262', '599999994', '199999998', '75757575', '25252527', '竞价', '99999995.04', '200000013.8'}",7,"{'福能集团', '36', '现金', '平安资管公司', '福建投资集团', '福建交通运输集团', '福汽集团'}",7,"{'福能集团', '现金', '平安资管公司', '福汽集团', '福建投资集团', '福建交通运输集团', '36'}"
23,"{'中国华电集团公司', '153500000', '68000000', '广发基金管理有限公司', '易方达基金管理有限公司', '374400000', '54600000', '478920000', '上海电气集团股份有限公司', '竞价', '17500000', '鹏华基金管理有限公司', '212160000', '上海景林景通股权投资中心(有限合伙)', '36', '60000000', '上海国泰君安证券资产管理有限公司', '61000000', '120000000', '187200000', '上海东方证券资产管理有限公司', '190320000', '12'}",1304268,8,"{'60000000', '374400000', '17500000', '54600000', '190320000', '187200000', '212160000', '478920000'}",4,"{'36', '竞价', '中国华电集团公司', '12'}",15,"{'上海景林景通股权投资中心(有限合伙)', '36', '中国华电集团公司', '上海电气集团股份有限公司', '153500000', '68000000', '广发基金管理有限公司', '易方达基金管理有限公司', '上海国泰君安证券资产管理有限公司', '竞价', '61000000', '上海东方证券资产管理有限公司', '120000000', '鹏华基金管理有限公司', '12'}"
4,"{'竞价', '现金', '36', '巨化集团'}",1109297,0,set(),4,"{'竞价', '现金', '36', '巨化集团'}",4,"{'竞价', '现金', '36', '巨化集团'}"
11,"{'现金', '西藏益升投资合伙企业(有限合伙)', '71326676', '1000000000', '深圳前海复星瑞哲恒嘉投资管理企业(有限合伙)', '500000000', '35663338', '14265335', '200000000', '叶远东', '36'}",276421,2,"{'1000000000', '200000000'}",3,"{'现金', '叶远东', '36'}",9,"{'现金', '西藏益升投资合伙企业(有限合伙)', '71326676', '深圳前海复星瑞哲恒嘉投资管理企业(有限合伙)', '500000000', '35663338', '14265335', '叶远东', '36'}"
13,"{'华宝兴业基金管理有限公司', '现金', '深圳中金投基金管理有限公司', '华安基金管理有限公司', '九泰基金管理有限公司', '定价', '平安资产管理有限责任公司', '郭信平', '7945900', '1338000', '3211100', '2140800', '36'}",1657306,4,"{'2140800', '7945900', '1338000', '3211100'}",9,"{'华宝兴业基金管理有限公司', '现金', '深圳中金投基金管理有限公司', '华安基金管理有限公司', '九泰基金管理有限公司', '定价', '平安资产管理有限责任公司', '郭信平', '36'}",9,"{'华宝兴业基金管理有限公司', '现金', '深圳中金投基金管理有限公司', '华安基金管理有限公司', '九泰基金管理有限公司', '定价', '平安资产管理有限责任公司', '郭信平', '36'}"
24,"{'136249909.6', '国联安基金管理有限公司', '24303797', '383999992.6', '12642411', '23746835', '12658228', '现金', '华夏资本管理有限公司', '财通基金管理有限公司', '12658227', '北信瑞丰基金管理有限公司', '199999986.6', '199750093.8', '上海国泰君安证券资产管理有限公司', '375199993', '200000002.4', '292800006.8', '江信基金管理有限公司', '兴证证券资产管理有限公司', '18531646', '中信信诚资产管理有限公司', '12', '8623412'}",349000,1,{'现金'},9,"{'华夏资本管理有限公司', '江信基金管理有限公司', '兴证证券资产管理有限公司', '北信瑞丰基金管理有限公司', '国联安基金管理有限公司', '财通基金管理有限公司', '上海国泰君安证券资产管理有限公司', '中信信诚资产管理有限公司', '12'}",23,"{'136249909.6', '国联安基金管理有限公司', '24303797', '383999992.6', '12642411', '23746835', '12658228', '华夏资本管理有限公司', '财通基金管理有限公司', '12658227', '北信瑞丰基金管理有限公司', '199999986.6', '199750093.8', '上海国泰君安证券资产管理有限公司', '375199993', '200000002.4', '292800006.8', '江信基金管理有限公司', '兴证证券资产管理有限公司', '18531646', '中信信诚资产管理有限公司', '12', '8623412'}"
22,"{'重庆广电', '8957219', '新长城基金', '10784314', '17825312', '上峰控股', '现金', '竞价', '华锐投资', '39215686', '204991087', '浙江富润', '39197861', '35650624', '太子龙控股', '新湖中宝', '长城集团', '7664884', '7219251', '祥生实业', '36', '天津一诺'}",308849,1,{'竞价'},12,"{'上峰控股', '现金', '太子龙控股', '重庆广电', '新湖中宝', '长城集团', '新长城基金', '浙江富润', '华锐投资', '祥生实业', '36', '天津一诺'}",21,"{'重庆广电', '8957219', '新长城基金', '10784314', '17825312', '上峰控股', '现金', '华锐投资', '39215686', '204991087', '浙江富润', '39197861', '35650624', '太子龙控股', '新湖中宝', '长城集团', '7664884', '7219251', '祥生实业', '36', '天津一诺'}"
6,"{'现金', '27412280', '249999993.6', '李润生', '李安东', '36'}",15556532,0,set(),4,"{'36', '李润生', '现金', '李安东'}",6,"{'现金', '27412280', '249999993.6', '李润生', '李安东', '36'}"
7,"{'现金', '王民', '6334200', '竞价', '吉林利源精制股份有限公司-第一期员工持股计划', '8880994', '36'}",1924143,2,"{'竞价', '8880994'}",3,"{'现金', '王民', '36'}",5,"{'现金', '王民', '6334200', '吉林利源精制股份有限公司-第一期员工持股计划', '36'}"
5,"{'现金', '定价', '84656000', '侯建芳', '36'}",1015139,0,set(),4,"{'定价', '现金', '36', '侯建芳'}",5,"{'现金', '定价', '84656000', '侯建芳', '36'}"
4,"{'美克投资集团有限公司', '定价', '36', '60376100'}",547402,1,{'60376100'},3,"{'美克投资集团有限公司', '定价', '36'}",3,"{'美克投资集团有限公司', '定价', '36'}"
5,"{'深圳投资控股有限公司', '现金', '深圳市国资局全资子公司深圳市深超科技投资有限公司', '竞价', '36'}",592518,0,set(),4,"{'深圳投资控股有限公司', '竞价', '现金', '深圳市国资局全资子公司深圳市深超科技投资有限公司'}",5,"{'深圳投资控股有限公司', '现金', '深圳市国资局全资子公司深圳市深超科技投资有限公司', '竞价', '36'}"
4,"{'36', '竞价', '现金', '刘梦龙'}",9895237,0,set(),4,"{'36', '竞价', '现金', '刘梦龙'}",4,"{'36', '竞价', '现金', '刘梦龙'}"
4,"{'36', '竞价', '现金', '王玫'}",1906198,0,set(),4,"{'36', '竞价', '现金', '王玫'}",4,"{'36', '竞价', '现金', '王玫'}"
9,"{'湖南泰兴创业投资有限公司', '12', '竞价', '29923345', '4355400', '长沙矿冶研究院有限责任公司', '1000000', '36', '东海证券有限责任公司'}",235628,1,{'竞价'},3,"{'36', '长沙矿冶研究院有限责任公司', '12'}",8,"{'湖南泰兴创业投资有限公司', '12', '29923345', '4355400', '长沙矿冶研究院有限责任公司', '1000000', '36', '东海证券有限责任公司'}"
9,"{'孙建科', '李占明', '现金', '7022933', '5016373', '定价', '46150546', '杨媛', '36'}",1692027,0,set(),5,"{'孙建科', '李占明', '现金', '定价', '杨媛'}",9,"{'孙建科', '李占明', '现金', '7022933', '5016373', '定价', '46150546', '杨媛', '36'}"
5,"{'中国东方航空集团公司', '5562641250', '定价', '1437375000', '36'}",1441274,1,{'5562641250'},3,"{'中国东方航空集团公司', '定价', '36'}",4,"{'1437375000', '中国东方航空集团公司', '定价', '36'}"
4,"{'拉法基中国海外控股公司', '竞价', '36', '147578300'}",1573067,2,"{'147578300', '竞价'}",2,"{'拉法基中国海外控股公司', '36'}",2,"{'拉法基中国海外控股公司', '36'}"
20,"{'平安大华基金管理有限公司', '现金', '2927445', '76142844.45', '99999996.75', '5767012', '4229142', '博时基金管理有限公司', '149999982.1', '申万菱信(上海)资产管理有限公司', '财通基金管理有限公司', '3844675', '109999983.4', '东海基金管理有限责任公司', '竞价', '7689350', '申万菱信基金管理有限公司', '民生通惠资产管理有限公司', '199999993.5', '12'}",2255872,1,{'竞价'},8,"{'平安大华基金管理有限公司', '现金', '博时基金管理有限公司', '东海基金管理有限责任公司', '财通基金管理有限公司', '申万菱信基金管理有限公司', '民生通惠资产管理有限公司', '12'}",19,"{'平安大华基金管理有限公司', '现金', '2927445', '76142844.45', '99999996.75', '5767012', '4229142', '博时基金管理有限公司', '149999982.1', '申万菱信(上海)资产管理有限公司', '财通基金管理有限公司', '3844675', '109999983.4', '东海基金管理有限责任公司', '7689350', '申万菱信基金管理有限公司', '民生通惠资产管理有限公司', '199999993.5', '12'}"
5,"{'现金', '65000000', '百利电气', '竞价', '12'}",505919,2,"{'65000000', '竞价'}",3,"{'现金', '12', '百利电气'}",3,"{'现金', '12', '百利电气'}"
5,"{'现金', '880952400', '竞价', '云南冶金集团股份有限公司', '36'}",1771382,1,{'880952400'},4,"{'云南冶金集团股份有限公司', '竞价', '现金', '36'}",4,"{'36', '竞价', '现金', '云南冶金集团股份有限公司'}"
15,"{'399999798', '83857400', '现金', '199999899', '宁波理瑞', '天津恒丰', '41928700', '宁波贝鑫', '竞价', '52410900', '249999993', '长沙泽瑞', '长沙泽洺', '36', '英达钢构'}",1274526,1,{'竞价'},8,"{'现金', '长沙泽瑞', '宁波理瑞', '天津恒丰', '宁波贝鑫', '长沙泽洺', '36', '英达钢构'}",14,"{'399999798', '现金', '83857400', '199999899', '宁波理瑞', '天津恒丰', '41928700', '宁波贝鑫', '52410900', '249999993', '长沙泽瑞', '长沙泽洺', '36', '英达钢构'}"
18,"{'云南省工业投资控股集团有限责任公司', '20000000', '现金', '1999999998', '121200000', '云南国鼎投资有限公司', '陈亮', '302600003.6', '定价', '山东中瑞现代物流有限公司', '云南禾溪投资有限公司', '49933994', '181800000', '云南省滇中产业发展集团有限责任公司', '30000000', '36', '云南九天工贸有限公司', '330033003'}",1685074,2,"{'定价', '山东中瑞现代物流有限公司'}",8,"{'云南省工业投资控股集团有限责任公司', '陈亮', '现金', '云南国鼎投资有限公司', '云南禾溪投资有限公司', '云南省滇中产业发展集团有限责任公司', '36', '云南九天工贸有限公司'}",16,"{'云南省工业投资控股集团有限责任公司', '20000000', '121200000', '1999999998', '陈亮', '云南国鼎投资有限公司', '现金', '302600003.6', '云南禾溪投资有限公司', '49933994', '181800000', '云南省滇中产业发展集团有限责任公司', '30000000', '36', '云南九天工贸有限公司', '330033003'}"
4,"{'14931420', '现金', '36', '员工持股计划'}",2371936,1,{'14931420'},3,"{'现金', '36', '员工持股计划'}",3,"{'现金', '36', '员工持股计划'}"
18,"{'9240000', '周慧云', '现金', '8000000', '华安基金管理有限公司', '1000000', '定价', '新世纪基金管理有限公司', '6160000', '红塔证券股份有限公司', '1500000', '49280000', '东吴证券有限责任公司', '10000000', '王秀梅', '斯坦福大学', '12', '61600000'}",1157090,5,"{'9240000', '6160000', '1500000', '49280000', '61600000'}",10,"{'周慧云', '现金', '华安基金管理有限公司', '定价', '新世纪基金管理有限公司', '红塔证券股份有限公司', '东吴证券有限责任公司', '王秀梅', '斯坦福大学', '12'}",13,"{'周慧云', '现金', '8000000', '华安基金管理有限公司', '1000000', '新世纪基金管理有限公司', '定价', '红塔证券股份有限公司', '东吴证券有限责任公司', '10000000', '王秀梅', '斯坦福大学', '12'}"
5,"{'现金', '陕西煤业化工集团有限责任公司', '定价', '西安投资控股有限公司', '36'}",208290,0,set(),5,"{'现金', '陕西煤业化工集团有限责任公司', '定价', '西安投资控股有限公司', '36'}",5,"{'现金', '陕西煤业化工集团有限责任公司', '定价', '西安投资控股有限公司', '36'}"
4,"{'现金', '竞价', '史万福', '36'}",677059,0,set(),4,"{'36', '竞价', '史万福', '现金'}",4,"{'现金', '竞价', '史万福', '36'}"
17,"{'南京瑞森投资管理合伙企业(有限合伙)', '现金', '16000000', '兴证证券资产管理有限公司', '兴业全球基金管理有限公司', '16700000', '定价', '国华人寿保险股份有限公司', '东海基金管理有限责任公司', '15700000', '申万菱信(上海)资产管理有限公司', '融通基金管理有限公司', '嘉实基金管理有限公司', '东方国际(集团)有限公司', '21208700', '20500000', '12'}",314581,3,"{'16700000', '21208700', '20500000'}",4,"{'定价', '现金', '12', '国华人寿保险股份有限公司'}",14,"{'南京瑞森投资管理合伙企业(有限合伙)', '现金', '16000000', '兴证证券资产管理有限公司', '兴业全球基金管理有限公司', '国华人寿保险股份有限公司', '申万菱信(上海)资产管理有限公司', '东海基金管理有限责任公司', '15700000', '融通基金管理有限公司', '嘉实基金管理有限公司', '定价', '东方国际(集团)有限公司', '12'}"
5,"{'331564986', '4999999989', '申万宏源证券有限公司', '竞价', '12'}",2239179,1,{'4999999989'},3,"{'申万宏源证券有限公司', '竞价', '12'}",4,"{'申万宏源证券有限公司', '竞价', '331564986', '12'}"
20,"{'16666700', '现金', '深圳市红塔资产管理有限公司拟筹建资产管理计划', '苏州荣睿立人投资管理合伙企业(有限合伙)', '杭州乐远股权投资合伙企业(有限合伙)', '苏州立众和瑞投资管理合伙企业(有限合伙)', '350000000', '宁波卓木众石投资合伙企业(有限合伙)', '定价', '100000000', '41666700', '深圳天风天成资产管理有限公司成立拟筹建资产管理计划', '250000000', '大成创新资本管理有限公司', '50000000', '300000000', '上海华富利得资产管理有限公司拟筹建资产管理计划', '58333300', '新疆协和股权投资合伙企业(有限合伙)', '36'}",1778635,8,"{'苏州立众和瑞投资管理合伙企业(有限合伙)', '350000000', '41666700', '250000000', '300000000', '50000000', '58333300', '16666700'}",7,"{'现金', '深圳市红塔资产管理有限公司拟筹建资产管理计划', '定价', '深圳天风天成资产管理有限公司成立拟筹建资产管理计划', '大成创新资本管理有限公司', '上海华富利得资产管理有限公司拟筹建资产管理计划', '36'}",12,"{'现金', '苏州荣睿立人投资管理合伙企业(有限合伙)', '深圳市红塔资产管理有限公司拟筹建资产管理计划', '杭州乐远股权投资合伙企业(有限合伙)', '100000000', '宁波卓木众石投资合伙企业(有限合伙)', '定价', '新疆协和股权投资合伙企业(有限合伙)', '深圳天风天成资产管理有限公司成立拟筹建资产管理计划', '大成创新资本管理有限公司', '上海华富利得资产管理有限公司拟筹建资产管理计划', '36'}"
12,"{'覃晓梅', '22931261', '5028785', '87349995.45', '1005757', '398316003.6', '17469999.09', '竞价', '贺立德', '黄生田', '36', '杨竞忠'}",1858507,1,{'398316003.6'},6,"{'覃晓梅', '竞价', '贺立德', '黄生田', '36', '杨竞忠'}",11,"{'覃晓梅', '22931261', '5028785', '87349995.45', '1005757', '17469999.09', '竞价', '贺立德', '黄生田', '36', '杨竞忠'}"
4,"{'远大集团', '竞价', '股权', '36'}",292724,0,set(),4,"{'远大集团', '竞价', '股权', '36'}",4,"{'远大集团', '竞价', '股权', '36'}"
14,"{'198240000', '686607', '23069995.2', '上投摩根基金管理有限公司', '12', '6400000', '567840000', '广发基金管理有限公司', '竞价', '南方基金管理有限公司', '16900000', '浙商证券股份有限公司', '5900000', '215040000'}",1141451,9,"{'198240000', '686607', '23069995.2', '6400000', '567840000', '竞价', '16900000', '5900000', '215040000'}",1,{'12'},5,"{'上投摩根基金管理有限公司', '广发基金管理有限公司', '南方基金管理有限公司', '浙商证券股份有限公司', '12'}"
7,"{'16402116', '123999997', '东海基金管理有限责任公司', '黄建新', '竞价', '屠榕皓', '12'}",19351877,2,"{'竞价', '123999997'}",4,"{'黄建新', '屠榕皓', '12', '东海基金管理有限责任公司'}",5,"{'16402116', '东海基金管理有限责任公司', '黄建新', '屠榕皓', '12'}"
4,"{'中国华电', '1150000000', '现金', '72'}",441476,1,{'1150000000'},3,"{'中国华电', '现金', '72'}",3,"{'中国华电', '现金', '72'}"
5,"{'现金', '斯米克工业有限公司', '竞价', '36', '19000000'}",978202,1,{'竞价'},3,"{'现金', '斯米克工业有限公司', '36'}",4,"{'现金', '斯米克工业有限公司', '36', '19000000'}"
18,"{'苏州高新区经济发展集团总公司', '250590006.3', '上海保港股权投资基金有限公司', '现金', '527409993.8', '刘华山', '12', '定价', '13641133', '华宝信托有限责任公司', '中信建投基金管理有限公司', '13746065', '130999999.5', '中信建投证券股份有限公司', '129999997.5', '55342077', '26294859', '36'}",1651155,4,"{'250590006.3', '130999999.5', '129999997.5', '刘华山'}",5,"{'苏州高新区经济发展集团总公司', '现金', '12', '定价', '36'}",14,"{'苏州高新区经济发展集团总公司', '上海保港股权投资基金有限公司', '现金', '527409993.8', '12', '定价', '13641133', '华宝信托有限责任公司', '中信建投基金管理有限公司', '13746065', '中信建投证券股份有限公司', '55342077', '26294859', '36'}"
12,"{'金塔投资', '现金', '长春城发', '129477298', '华安基金', '北方水泥', '108482368', '吉林敖东', '109722935', '冀东水泥', '98576482', '36'}",61930,4,"{'109722935', '108482368', '98576482', '129477298'}",8,"{'金塔投资', '现金', '长春城发', '华安基金', '北方水泥', '吉林敖东', '冀东水泥', '36'}",8,"{'金塔投资', '现金', '长春城发', '华安基金', '北方水泥', '吉林敖东', '冀东水泥', '36'}"
18,"{'太平洋资产管理有限责任公司', '现金', '华夏资本管理有限公司', '张观福', '孙飏', '3189700', '兴业全球基金管理有限公司', '窦啟玲', '12', '定价', '3508700', '广发基金管理有限公司', '中银基金管理有限公司', '4753200', '4784600', '7017500', '36', '5741600'}",1024449,0,set(),11,"{'太平洋资产管理有限责任公司', '现金', '华夏资本管理有限公司', '张观福', '孙飏', '窦啟玲', '12', '定价', '广发基金管理有限公司', '中银基金管理有限公司', '36'}",18,"{'太平洋资产管理有限责任公司', '华夏资本管理有限公司', '张观福', '孙飏', '兴业全球基金管理有限公司', '3189700', '4753200', '窦啟玲', '12', '3508700', '现金', '定价', '广发基金管理有限公司', '中银基金管理有限公司', '4784600', '7017500', '36', '5741600'}"
19,"{'11672029', '36', '9967846', '华安基金管理有限公司', '长城国融投资管理有限公司', '10321543', '深圳市创新投资集团有限公司', '10192926', '财通基金管理有限公司', '张仁华', '竞价', '中信证券股份有限公司', '13762057', '9967845', '合众人寿保险股份有限公司', '13858520', '汇添富基金管理股份有限公司', '12', '华融证券股份有限公司'}",14044285,1,{'竞价'},11,"{'华安基金管理有限公司', '长城国融投资管理有限公司', '深圳市创新投资集团有限公司', '12', '财通基金管理有限公司', '张仁华', '中信证券股份有限公司', '合众人寿保险股份有限公司', '华融证券股份有限公司', '汇添富基金管理股份有限公司', '36'}",18,"{'11672029', '36', '9967846', '华安基金管理有限公司', '长城国融投资管理有限公司', '10321543', '深圳市创新投资集团有限公司', '10192926', '财通基金管理有限公司', '张仁华', '中信证券股份有限公司', '13762057', '9967845', '合众人寿保险股份有限公司', '13858520', '汇添富基金管理股份有限公司', '12', '华融证券股份有限公司'}"
18,"{'20000000', '5000000', '现金', '21040800', '仙居县国有资产投资集团有限公司', '11074200', '平安资产管理有限责任公司', '范敏华', '财通基金管理有限公司', '2000000', '优势医药企业定增计划6号资产管理计划', '1500000', '李勤俭', '张宇松', '杭州九鸿投资合伙企业(有限合伙)', '中企汇锦投资有限公司', '仙琚制药定增盛世45号', '36'}",288850,8,"{'20000000', '5000000', '21040800', '11074200', '2000000', '1500000', '杭州九鸿投资合伙企业(有限合伙)', '优势医药企业定增计划6号资产管理计划'}",9,"{'36', '现金', '仙居县国有资产投资集团有限公司', '平安资产管理有限责任公司', '财通基金管理有限公司', '李勤俭', '张宇松', '中企汇锦投资有限公司', '范敏华'}",10,"{'36', '现金', '仙居县国有资产投资集团有限公司', '平安资产管理有限责任公司', '范敏华', '财通基金管理有限公司', '李勤俭', '张宇松', '中企汇锦投资有限公司', '仙琚制药定增盛世45号'}"
16,"{'光大金控(上海)投资中心(有限合伙)', '现金', '14500000', '宿迁华基丰润投资合伙企业(有限合伙)', '兴业全球基金管理有限公司', '18000000', '定价', '3220000', '中银基金管理有限公司', '上海东方证券资产管理有限公司', '鹏华基金管理有限公司', '7800000', '3233770', '12', '汇添富基金管理有限公司', '东海证券有限责任公司'}",919204,5,"{'14500000', '18000000', '3220000', '7800000', '3233770'}",9,"{'现金', '兴业全球基金管理有限公司', '定价', '中银基金管理有限公司', '上海东方证券资产管理有限公司', '鹏华基金管理有限公司', '12', '汇添富基金管理有限公司', '东海证券有限责任公司'}",11,"{'光大金控(上海)投资中心(有限合伙)', '现金', '宿迁华基丰润投资合伙企业(有限合伙)', '兴业全球基金管理有限公司', '定价', '中银基金管理有限公司', '上海东方证券资产管理有限公司', '鹏华基金管理有限公司', '12', '汇添富基金管理有限公司', '东海证券有限责任公司'}"
8,"{'现金', '联达东方', '35000000', '恒润达投资', '金泰公司', '17000000', '8000000', '36'}",1094003,3,"{'35000000', '8000000', '17000000'}",4,"{'金泰公司', '联达东方', '现金', '恒润达投资'}",5,"{'现金', '联达东方', '恒润达投资', '金泰公司', '36'}"
12,"{'招商财富资产管理有限公司', '现金', '上银瑞金资本管理有限公司', '14000000', '定价', '东海基金管理有限责任公司', '5714285', '财通基金管理有限公司', '3142858', '14285714', '汇添富基金管理股份有限公司', '12'}",1642515,1,{'定价'},6,"{'招商财富资产管理有限公司', '现金', '东海基金管理有限责任公司', '财通基金管理有限公司', '汇添富基金管理股份有限公司', '12'}",11,"{'招商财富资产管理有限公司', '现金', '上银瑞金资本管理有限公司', '14000000', '东海基金管理有限责任公司', '5714285', '财通基金管理有限公司', '3142858', '14285714', '汇添富基金管理股份有限公司', '12'}"
12,"{'金鹰基金管理有限公司', '张家港市金城融创投资管理有限公司', '现金', '第一创业证券股份有限公司', '260950000', '财通基金管理有限公司', '168850000', '11000000', '401349987.7', '17000000', '26146579', '12'}",1922890,5,"{'260950000', '168850000', '401349987.7', '17000000', '26146579'}",6,"{'金鹰基金管理有限公司', '张家港市金城融创投资管理有限公司', '第一创业证券股份有限公司', '现金', '财通基金管理有限公司', '12'}",7,"{'金鹰基金管理有限公司', '张家港市金城融创投资管理有限公司', '第一创业证券股份有限公司', '现金', '财通基金管理有限公司', '11000000', '12'}"
4,"{'现金', '竞价', '徐金富', '36'}",14780835,0,set(),4,"{'徐金富', '竞价', '现金', '36'}",4,"{'现金', '竞价', '徐金富', '36'}"
12,"{'杭州西子孚信科技有限公司', '5000000', '现金', '定价', '江西国际信托股份有限公司', '施宝忠', '天津凯石益盛股权投资基金合伙企业(有限合伙)', '浙江言信诚有限公司', '2550000', '7700000', '12', '赵辉'}",1458690,1,{'2550000'},8,"{'杭州西子孚信科技有限公司', '现金', '定价', '江西国际信托股份有限公司', '施宝忠', '浙江言信诚有限公司', '12', '赵辉'}",11,"{'杭州西子孚信科技有限公司', '5000000', '现金', '12', '定价', '江西国际信托股份有限公司', '施宝忠', '浙江言信诚有限公司', '7700000', '天津凯石益盛股权投资基金合伙企业(有限合伙)', '赵辉'}"
5,"{'800000000', '现金', '60', '竞价', '国发集团'}",1163865,1,{'800000000'},4,"{'竞价', '现金', '60', '国发集团'}",4,"{'竞价', '现金', '60', '国发集团'}"
3,"{'现金', '36', '大唐集团'}",15790488,0,set(),3,"{'现金', '36', '大唐集团'}",3,"{'现金', '36', '大唐集团'}"
16,"{'12000000', '兵器财务有限责任公司', '新华基金管理有限公司', '现金', '11500000', '兴业全球基金管理有限公司', '江苏瑞华投资发展有限公司', '16500000', '浙江商裕开盛创业投资合伙企业(有限合伙)', '13000000', '定价', '深圳市本是资产管理有限公司', '5500000', '天津证大金牛股权投资基金合伙企业(有限合伙)', '30000000', '12'}",1504635,0,set(),8,"{'兵器财务有限责任公司', '新华基金管理有限公司', '现金', '兴业全球基金管理有限公司', '江苏瑞华投资发展有限公司', '定价', '深圳市本是资产管理有限公司', '12'}",16,"{'12000000', '兵器财务有限责任公司', '新华基金管理有限公司', '11500000', '现金', '兴业全球基金管理有限公司', '江苏瑞华投资发展有限公司', '16500000', '浙江商裕开盛创业投资合伙企业(有限合伙)', '13000000', '定价', '深圳市本是资产管理有限公司', '5500000', '天津证大金牛股权投资基金合伙企业(有限合伙)', '30000000', '12'}"
16,"{'542005', '现金', '杨思华', '上海国药圣礼股权投资基金合伙企业(有限合伙)', '王玲', '198640000', '欧顺明', '易泽喜', '13457995', '定价', '孙忠义', '60000000', '百洋股份第一期员工持股计划', '4065041', '8000000', '36'}",1652000,3,"{'8000000', '198640000', '60000000'}",9,"{'现金', '杨思华', '王玲', '易泽喜', '欧顺明', '定价', '孙忠义', '百洋股份第一期员工持股计划', '36'}",13,"{'542005', '现金', '杨思华', '上海国药圣礼股权投资基金合伙企业(有限合伙)', '王玲', '易泽喜', '欧顺明', '13457995', '定价', '孙忠义', '百洋股份第一期员工持股计划', '4065041', '36'}"
5,"{'现金', '43781100', '竞价', '何清华', '36'}",1780944,2,"{'竞价', '43781100'}",3,"{'现金', '36', '何清华'}",3,"{'现金', '36', '何清华'}"
21,"{'深圳天风天成资产管理有限公司', '23584905', '张远捷', '南方基金管理有限公司', '申万菱信基金管理有限公司', '110999994.6', '定价', '199999994.4', '43500017.12', '5129719', '华夏人寿保险股份有限公司', '北信瑞丰基金管理有限公司', '13089622', '19457547', '诺安基金管理有限公司', '12971698', '中信证券股份有限公司', '109999999', '164999998.6', '创金合信基金管理有限公司', '12'}",1764600,6,"{'109999999', '164999998.6', '199999994.4', '43500017.12', '110999994.6', '5129719'}",11,"{'华夏人寿保险股份有限公司', '北信瑞丰基金管理有限公司', '深圳天风天成资产管理有限公司', '诺安基金管理有限公司', '定价', '张远捷', '中信证券股份有限公司', '申万菱信基金管理有限公司', '南方基金管理有限公司', '创金合信基金管理有限公司', '12'}",15,"{'华夏人寿保险股份有限公司', '北信瑞丰基金管理有限公司', '深圳天风天成资产管理有限公司', '13089622', '19457547', '诺安基金管理有限公司', '定价', '23584905', '12971698', '张远捷', '中信证券股份有限公司', '申万菱信基金管理有限公司', '南方基金管理有限公司', '创金合信基金管理有限公司', '12'}"
29,"{'6734991.9', '2134917', '夏振忠', '深圳市天中投资有限公司', '11662068', '新疆协和股权投资合伙企业(有限合伙)', '李杜若', '现金', '24983908', '774137', '竞价', '2012758', '林逸香', '郑玲娜', '36', '11595402', '盈富(天津)股权投资管理合伙企业(有限合伙)', '100879997.4', '13252874', '22280717.4', '17510994.6', '115300003.8', '股权', '2561002', '217359999.6', '101459991.6', '曹丽君', '18573777.9', '12'}",207718,0,set(),10,"{'现金', '夏振忠', '股权', '12', '曹丽君', '深圳市天中投资有限公司', '竞价', '林逸香', '郑玲娜', '36'}",29,"{'6734991.9', '2134917', '夏振忠', '深圳市天中投资有限公司', '11662068', '新疆协和股权投资合伙企业(有限合伙)', '李杜若', '现金', '24983908', '774137', '2012758', '竞价', '林逸香', '郑玲娜', '36', '11595402', '盈富(天津)股权投资管理合伙企业(有限合伙)', '100879997.4', '13252874', '22280717.4', '17510994.6', '115300003.8', '股权', '2561002', '217359999.6', '101459991.6', '曹丽君', '18573777.9', '12'}"
12,"{'德意志银行卢森堡股份有限公司', '现金', '653306499', '定价', '5594644668', '7513390077', '首钢总公司', '7101441644', '514686722', '英大国际控股集团有限公司', '36', '691204239'}",1464481,0,set(),6,"{'德意志银行卢森堡股份有限公司', '现金', '定价', '英大国际控股集团有限公司', '36', '首钢总公司'}",12,"{'36', '现金', '653306499', '定价', '5594644668', '7513390077', '首钢总公司', '7101441644', '514686722', '英大国际控股集团有限公司', '德意志银行卢森堡股份有限公司', '691204239'}"
33,"{'新疆天天', '博信优选', '16921800', '杜拥军', '3718000', '15359211', '2718400', '39819780', '79628850', '29114064', '德润共赢', '现金', '11018200', '7435000', '竞价', '5372000', '1812300', '118004922', '华信嘉诚', '19409733', '219717792', '郝军', '李志江', '1434100', '汪力军', '57534120', '20515200', '10456800', '唐伟', '111992328', '1580000', '36', '罗明'}",1659498,1,{'竞价'},12,"{'现金', '新疆天天', '博信优选', '杜拥军', '郝军', '李志江', '唐伟', '汪力军', '华信嘉诚', '德润共赢', '36', '罗明'}",32,"{'新疆天天', '博信优选', '16921800', '杜拥军', '3718000', '15359211', '2718400', '39819780', '79628850', '29114064', '德润共赢', '现金', '11018200', '7435000', '5372000', '1812300', '118004922', '华信嘉诚', '19409733', '219717792', '郝军', '李志江', '1434100', '汪力军', '57534120', '20515200', '10456800', '唐伟', '111992328', '1580000', '36', '罗明'}"
6,"{'2300000000', '现金', '振兴集团', '定价', '100832967', '36'}",15498239,2,"{'2300000000', '100832967'}",4,"{'定价', '36', '现金', '振兴集团'}",4,"{'定价', '36', '现金', '振兴集团'}"
18,"{'14336010', '现金', '6100000', '5800000', '12', '上海哲熙投资管理合伙企业(有限合伙)', '定价', '8847531', '易方达基金管理有限公司', '特变电工股份有限公司', '雅戈尔集团股份有限公司', '常州投资集团有限公司', '中国对外经济贸易信托有限公司', '宁波金联诚股权投资合伙企业(有限合伙)', '6000000', '5900000', '36', '上海彤卉实业有限公司'}",505958,6,"{'14336010', '6100000', '5800000', '8847531', '6000000', '5900000'}",10,"{'现金', '12', '定价', '易方达基金管理有限公司', '雅戈尔集团股份有限公司', '特变电工股份有限公司', '常州投资集团有限公司', '中国对外经济贸易信托有限公司', '36', '上海彤卉实业有限公司'}",12,"{'36', '现金', '上海哲熙投资管理合伙企业(有限合伙)', '定价', '易方达基金管理有限公司', '特变电工股份有限公司', '雅戈尔集团股份有限公司', '常州投资集团有限公司', '中国对外经济贸易信托有限公司', '宁波金联诚股权投资合伙企业(有限合伙)', '12', '上海彤卉实业有限公司'}"
4,"{'李东生', '竞价', '现金', '36'}",1119452,1,{'竞价'},3,"{'李东生', '现金', '36'}",3,"{'李东生', '现金', '36'}"
25,"{'中再资产管理股份有限公司①', '299999991.6', '现金', '219999993.8', '定价', '899999974.8', '10831586', '红土创新基金管理有限公司拟设立的资产管理计划', '399999988.8', '江阴市长江钢管有限公司', '295000063.2', '62893080', '中航祥瑞集合资产管理计划', '15373864', '西藏山南中和投资管理中心(有限合伙)', '20964360', '杭州新域欣源投资合伙企业(有限合伙)', '2096436', '27952480', '中钢资产管理有限责任公司', '华富资管-吉渊投资定增31号资产管理计划', '20614959', '29999999.16', '154999995.7', '36'}",1643979,3,"{'西藏山南中和投资管理中心(有限合伙)', '154999995.7', '29999999.16'}",6,"{'现金', '定价', '中钢资产管理有限责任公司', '中航祥瑞集合资产管理计划', '江阴市长江钢管有限公司', '36'}",22,"{'中再资产管理股份有限公司①', '299999991.6', '现金', '219999993.8', '定价', '899999974.8', '10831586', '红土创新基金管理有限公司拟设立的资产管理计划', '399999988.8', '江阴市长江钢管有限公司', '295000063.2', '62893080', '中航祥瑞集合资产管理计划', '2096436', '15373864', '20964360', '杭州新域欣源投资合伙企业(有限合伙)', '27952480', '中钢资产管理有限责任公司', '华富资管-吉渊投资定增31号资产管理计划', '20614959', '36'}"
16,"{'中原信托有限公司', '16000000', '江苏瑞华投资发展有限公司', '华夏基金管理有限公司', '定价', '18000000', '长盛基金管理有限公司', '广发基金管理有限公司', '22000000', '西藏自治区投资有限公司', '江西国际信托投资股份有限公司', '8000000', '中海基金管理有限公司', '30000000', '12', '海富通基金管理有限公司'}",1311586,2,"{'22000000', '30000000'}",4,"{'定价', '12', '长盛基金管理有限公司', '海富通基金管理有限公司'}",14,"{'中原信托有限公司', '16000000', '江苏瑞华投资发展有限公司', '华夏基金管理有限公司', '18000000', '长盛基金管理有限公司', '定价', '广发基金管理有限公司', '西藏自治区投资有限公司', '江西国际信托投资股份有限公司', '8000000', '中海基金管理有限公司', '12', '海富通基金管理有限公司'}"
19,"{'342', '36', '现金', '华夏基金管理有限公司', '王毅', '定价', '7000000', '华宝信托有限责任公司', '11000000', '江苏苏豪国际集团股份有限公司', '郝昌兰', '李绍君', '方正证券有限责任公司', '1610', '8000000', '江苏弘业股份有限公司', '上海天誉投资有限公司', '12', '南通产业控股集团有限公司'}",1497295,1,{'342'},14,"{'36', '现金', '华夏基金管理有限公司', '王毅', '定价', '华宝信托有限责任公司', '郝昌兰', '江苏苏豪国际集团股份有限公司', '李绍君', '方正证券有限责任公司', '江苏弘业股份有限公司', '上海天誉投资有限公司', '12', '南通产业控股集团有限公司'}",18,"{'36', '现金', '华夏基金管理有限公司', '王毅', '定价', '7000000', '华宝信托有限责任公司', '11000000', '江苏苏豪国际集团股份有限公司', '郝昌兰', '李绍君', '方正证券有限责任公司', '1610', '8000000', '江苏弘业股份有限公司', '上海天誉投资有限公司', '12', '南通产业控股集团有限公司'}"
21,"{'4000000', '易方达基金管理有限公司', '3000000', '5300000', '中国工商银行—易方达价值成长混合型证券投资基金', '5000000', '现金', '竞价', '3500000', '赵巧芳', '5500000', '2542780', '郑文平', '江阴顺元投资发展有限公司', '3200000', '中国人保资产管理股份有限公司', '深圳金石资产管理中心(有限合伙)', '全国社保基金一零九组合', '2000000', '华宝信托有限责任公司', '12'}",1500271,7,"{'3500000', '3200000', '4000000', '2000000', '2542780', '3000000', '5300000'}",10,"{'江阴顺元投资发展有限公司', '现金', '中国人保资产管理股份有限公司', '赵巧芳', '深圳金石资产管理中心(有限合伙)', '易方达基金管理有限公司', '华宝信托有限责任公司', '竞价', '郑文平', '12'}",14,"{'江阴顺元投资发展有限公司', '5000000', '现金', '中国人保资产管理股份有限公司', '赵巧芳', '深圳金石资产管理中心(有限合伙)', '全国社保基金一零九组合', '5500000', '易方达基金管理有限公司', '华宝信托有限责任公司', '竞价', '郑文平', '中国工商银行—易方达价值成长混合型证券投资基金', '12'}"
15,"{'2749130', '现金', '江信基金管理有限公司', '浙江浙商汇融投资管理有限公司', '10040161', '3975903', '财通基金管理有限公司', '易方达基金管理有限公司', '2765060', '竞价', '6047523', '富国基金管理有限公司', '1858969', '汇添富基金管理股份有限公司', '12'}",1690688,0,set(),3,"{'竞价', '现金', '12'}",15,"{'2749130', '现金', '江信基金管理有限公司', '浙江浙商汇融投资管理有限公司', '10040161', '3975903', '财通基金管理有限公司', '易方达基金管理有限公司', '2765060', '6047523', '竞价', '富国基金管理有限公司', '1858969', '汇添富基金管理股份有限公司', '12'}"
23,"{'83500198.32', '2234359', '申万菱信(上海)资产管理有限公司', '45499965.76', '现金', '国机财务有限责任公司', '1129592', '深圳前海光彩资本管理有限公司', '财通基金管理有限公司', '1241310', '1142005', '竞价', '45999961.4', '49999966.8', '89999980.52', '天治基金管理有限公司', '1117179', '44999970.12', '郑就有', '泓德基金管理有限公司', '2072994', '创金合信基金管理有限公司', '12'}",1831936,4,"{'44999970.12', '89999980.52', '83500198.32', '45499965.76'}",10,"{'现金', '国机财务有限责任公司', '深圳前海光彩资本管理有限公司', '财通基金管理有限公司', '竞价', '郑就有', '创金合信基金管理有限公司', '天治基金管理有限公司', '12', '泓德基金管理有限公司'}",19,"{'现金', '49999966.8', '2072994', '1117179', '国机财务有限责任公司', '1129592', '2234359', '申万菱信(上海)资产管理有限公司', '深圳前海光彩资本管理有限公司', '财通基金管理有限公司', '1241310', '1142005', '竞价', '郑就有', '45999961.4', '创金合信基金管理有限公司', '天治基金管理有限公司', '12', '泓德基金管理有限公司'}"
6,"{'现金', '290964777', '定价', '3799999988', '永泰集团', '36'}",20279155,1,{'3799999988'},4,"{'现金', '定价', '36', '永泰集团'}",5,"{'现金', '290964777', '定价', '永泰集团', '36'}"
4,"{'竞价', '现金', '中粮集团', '36'}",16402805,0,set(),4,"{'竞价', '现金', '中粮集团', '36'}",4,"{'竞价', '现金', '中粮集团', '36'}"
6,"{'现金', '定价', '129589632', '通威集团', '587041033', '36'}",1134707,1,{'587041033'},4,"{'通威集团', '现金', '定价', '36'}",5,"{'现金', '定价', '129589632', '通威集团', '36'}"
20,"{'5000000', '现金', '上海国际集团资产经营有限公司', '北京工业发展投资管理有限公司', '华夏基金管理有限公司', '4000000', '上海瑞熹联实业有限公司', '15000000', '厦门象屿集团有限公司', '北京鑫浩投资中心', '云南国际信托投资有限公司', '2000000', '1600000', '竞价', '3000000', '西藏大正科贸投资发展有限公司', '5900000', '成都市世旗投资顾问有限责任公司', '12', '2300000'}",820677,3,"{'竞价', '3000000', '2300000'}",11,"{'现金', '上海国际集团资产经营有限公司', '北京工业发展投资管理有限公司', '华夏基金管理有限公司', '12', '上海瑞熹联实业有限公司', '北京鑫浩投资中心', '云南国际信托投资有限公司', '西藏大正科贸投资发展有限公司', '成都市世旗投资顾问有限责任公司', '厦门象屿集团有限公司'}",17,"{'5000000', '现金', '上海国际集团资产经营有限公司', '北京工业发展投资管理有限公司', '华夏基金管理有限公司', '4000000', '上海瑞熹联实业有限公司', '15000000', '厦门象屿集团有限公司', '北京鑫浩投资中心', '云南国际信托投资有限公司', '2000000', '1600000', '西藏大正科贸投资发展有限公司', '5900000', '成都市世旗投资顾问有限责任公司', '12'}"
8,"{'银华财富资本管理(北京)有限公司', '民生加银基金管理有限公司', '华安基金管理有限公司', '70374100', '56946400', '695999849', '563199896', '12'}",1138724,0,set(),3,"{'华安基金管理有限公司', '民生加银基金管理有限公司', '12'}",8,"{'银华财富资本管理(北京)有限公司', '民生加银基金管理有限公司', '华安基金管理有限公司', '70374100', '56946400', '695999849', '563199896', '12'}"
4,"{'华仪电器集团有限公司', '竞价', '现金', '36'}",1238264,1,{'竞价'},3,"{'华仪电器集团有限公司', '现金', '36'}",3,"{'华仪电器集团有限公司', '现金', '36'}"
11,"{'现金', '陆兆禧', '诸暨通策', '吕建明', '定价', '通策1号资管计划', '10000', '23700', '80466', '5834', '36'}",15733011,0,set(),6,"{'陆兆禧', '现金', '诸暨通策', '吕建明', '定价', '36'}",11,"{'陆兆禧', '诸暨通策', '现金', '吕建明', '定价', '通策1号资管计划', '10000', '23700', '80466', '5834', '36'}"
4,"{'36', '现金', '2000000000', '中国长安'}",2135359,0,set(),3,"{'36', '现金', '中国长安'}",4,"{'36', '现金', '2000000000', '中国长安'}"
5,"{'现金', '竞价', '300000000', '钟烈华', '36'}",2356110,1,{'300000000'},4,"{'竞价', '现金', '36', '钟烈华'}",4,"{'竞价', '现金', '36', '钟烈华'}"
16,"{'光大金控(上海)投资中心(有限合伙)', '上海景林景通股权投资中心(有限合伙)', '18600000', '上投摩根基金管理有限公司', '定价', '上海六禾御秀投资中心(有限合伙)', '国泰基金管理有限公司', '57300000', '广东温氏投资有限公司', '申万菱信基金管理有限公司', '20500000', '上海东方证券资产管理有限公司', '18100000', '6645297', '12', '18500000'}",158727,6,"{'57300000', '20500000', '18100000', '6645297', '18600000', '18500000'}",7,"{'上投摩根基金管理有限公司', '定价', '国泰基金管理有限公司', '上海东方证券资产管理有限公司', '申万菱信基金管理有限公司', '广东温氏投资有限公司', '12'}",10,"{'光大金控(上海)投资中心(有限合伙)', '上海景林景通股权投资中心(有限合伙)', '上投摩根基金管理有限公司', '上海六禾御秀投资中心(有限合伙)', '定价', '国泰基金管理有限公司', '广东温氏投资有限公司', '申万菱信基金管理有限公司', '上海东方证券资产管理有限公司', '12'}"
5,"{'叶仙玉', '现金', '90000000', '竞价', '12'}",15739735,2,"{'竞价', '90000000'}",3,"{'12', '现金', '叶仙玉'}",3,"{'12', '现金', '叶仙玉'}"
20,"{'呼怀旭', '现金', '恒泰证券股份有限公司', '16000000', '广发证券股份有限公司', '中海基金管理有限公司', '铜陵天源股权投资集团有限公司', '中广核财务有限责任公司', '15000000', '陈郁凤', '竞价', '中国银河证券股份有限公司', '西藏瑞华投资发展有限公司', '16900000', '泰康资产管理有限责任公司', '7869565', '28000000', '16600000', '12', '14800000'}",1255884,9,"{'现金', '16000000', '15000000', '竞价', '16900000', '7869565', '28000000', '16600000', '14800000'}",1,{'12'},11,"{'呼怀旭', '恒泰证券股份有限公司', '广发证券股份有限公司', '铜陵天源股权投资集团有限公司', '中广核财务有限责任公司', '中国银河证券股份有限公司', '西藏瑞华投资发展有限公司', '陈郁凤', '泰康资产管理有限责任公司', '中海基金管理有限公司', '12'}"
5,"{'现金', '100000000', '竞价', '中国电子', '36'}",1221696,2,"{'100000000', '竞价'}",3,"{'36', '现金', '中国电子'}",3,"{'36', '现金', '中国电子'}"
3,"{'竞价', '现金', '上海市糖业烟酒(集团)有限公司'}",1103618,0,set(),2,"{'竞价', '现金'}",3,"{'竞价', '现金', '上海市糖业烟酒(集团)有限公司'}"
5,"{'现金', '70000000', '竞价', '郭留希', '36'}",373469,2,"{'竞价', '70000000'}",3,"{'36', '郭留希', '现金'}",3,"{'36', '郭留希', '现金'}"
4,"{'华林证券-亿利集团共赢1号资产管理计划', '现金', '竞价', '36'}",4936981,1,{'华林证券-亿利集团共赢1号资产管理计划'},3,"{'竞价', '现金', '36'}",3,"{'竞价', '现金', '36'}"
17,"{'109999997.6', '现金', '185999997.3', '52252200.78', '银华基金管理股份有限公司', '5153077', '博时基金管理有限公司', '上海并购股权投资基金合伙企业', '财通基金管理有限公司', '424577993.6', '18343195', '41871597', '常州投资集团有限公司', '119999994.7', '12', '10848126', '11834319'}",15702520,2,"{'119999994.7', '424577993.6'}",7,"{'现金', '银华基金管理股份有限公司', '博时基金管理有限公司', '上海并购股权投资基金合伙企业', '财通基金管理有限公司', '常州投资集团有限公司', '12'}",15,"{'109999997.6', '185999997.3', '52252200.78', '现金', '银华基金管理股份有限公司', '5153077', '博时基金管理有限公司', '上海并购股权投资基金合伙企业', '财通基金管理有限公司', '18343195', '41871597', '常州投资集团有限公司', '12', '10848126', '11834319'}"
5,"{'现金', '206100000', '中电投集团', '竞价', '36'}",61273,1,{'206100000'},3,"{'竞价', '现金', '中电投集团'}",4,"{'竞价', '现金', '36', '中电投集团'}"
21,"{'3901039.2', '3000000', '6806866', '41400000', '5000000', '现金', '42780000', '新的集团', '36', '93934750.8', '张寿清', '69000000', '绍兴润鑫股权投资合伙企业(有限合伙)', '3100000', '张引生', '4500000', '282684', '华宝信托有限责任公司', '62100000', '12', '天津证大金兔股权投资基金合伙企业(有限合伙)'}",502136,0,set(),7,"{'张引生', '现金', '12', '新的集团', '张寿清', '华宝信托有限责任公司', '36'}",21,"{'3901039.2', '3000000', '6806866', '41400000', '5000000', '现金', '42780000', '新的集团', '36', '93934750.8', '张寿清', '69000000', '绍兴润鑫股权投资合伙企业(有限合伙)', '3100000', '张引生', '4500000', '282684', '华宝信托有限责任公司', '62100000', '12', '天津证大金兔股权投资基金合伙企业(有限合伙)'}"
15,"{'207300000', '36', '287499988.2', '中铁宝盈资产管理有限公司', '10619877', '定价', '14728483', '59999990.4', '江苏隆力奇集团有限公司', '3073770', '王珍海', '19999996.8', '创金合信基金管理有限公司', '1024590', '12'}",16882152,1,{'287499988.2'},7,"{'创金合信基金管理有限公司', '12', '定价', '江苏隆力奇集团有限公司', '王珍海', '中铁宝盈资产管理有限公司', '36'}",14,"{'207300000', '36', '中铁宝盈资产管理有限公司', '10619877', '定价', '14728483', '59999990.4', '江苏隆力奇集团有限公司', '3073770', '王珍海', '19999996.8', '创金合信基金管理有限公司', '1024590', '12'}"
5,"{'现金', '1992239724', 'CLH12(HK) Limited', '168548200', '36'}",398134,3,"{'168548200', '1992239724', 'CLH12(HK) Limited'}",2,"{'现金', '36'}",2,"{'现金', '36'}"
21,"{'红土创新基金管理有限公司', '3458213', '建信基金管理有限责任公司', '鹏华资产管理有限公司', '7204610', '3746397', '竞价', '64999987.95', '2305478', '40000043.3', '上海中汇金锐投资管理有限公司', '69999997.7', '4034582', '武汉工业国有投资有限公司', '124999983.5', '119999991.1', '创金合信基金管理有限公司', '6916426', '银河金汇证券资产管理有限公司', '12', '59999995.55'}",15526935,1,{'竞价'},8,"{'武汉工业国有投资有限公司', '鹏华资产管理有限公司', '红土创新基金管理有限公司', '12', '创金合信基金管理有限公司', '建信基金管理有限责任公司', '银河金汇证券资产管理有限公司', '上海中汇金锐投资管理有限公司'}",20,"{'武汉工业国有投资有限公司', '124999983.5', '鹏华资产管理有限公司', '59999995.55', '7204610', '红土创新基金管理有限公司', '3458213', '119999991.1', '3746397', '64999987.95', '4034582', '2305478', '69999997.7', '40000043.3', '创金合信基金管理有限公司', '6916426', '建信基金管理有限责任公司', '银河金汇证券资产管理有限公司', '12', '上海中汇金锐投资管理有限公司'}"
16,"{'1400000', '现金', '天津证大金马股权投资基金合伙企业(有限合伙)', '16000000', '邦信资产管理有限公司', '百年化妆护理品有限公司', '西南证券股份有限公司', '上海首佳投资有限公司', '2000000', '浙江双可达纺织有限公司', '竞价', '张克强', '广东恒健资本管理有限公司', '1500000', '12', '谢林生'}",57195,3,"{'1400000', '竞价', '16000000'}",10,"{'现金', '邦信资产管理有限公司', '百年化妆护理品有限公司', '西南证券股份有限公司', '上海首佳投资有限公司', '浙江双可达纺织有限公司', '张克强', '广东恒健资本管理有限公司', '12', '谢林生'}",13,"{'现金', '天津证大金马股权投资基金合伙企业(有限合伙)', '邦信资产管理有限公司', '百年化妆护理品有限公司', '西南证券股份有限公司', '上海首佳投资有限公司', '2000000', '浙江双可达纺织有限公司', '张克强', '1500000', '广东恒健资本管理有限公司', '12', '谢林生'}"
5,"{'现金', '湖南泓鑫控股有限公司', '362500000', '50000000', '36'}",163135,2,"{'362500000', '50000000'}",3,"{'湖南泓鑫控股有限公司', '现金', '36'}",3,"{'湖南泓鑫控股有限公司', '现金', '36'}"
15,"{'北京中金信国资产管理中心(有限合伙)', '天津军博葳投资发展有限公司', '现金', '39840000', '中邮创业基金管理有限公司', '诺安基金管理有限公司', '1500000', '北京中金信融资产管理中心(有限合伙)', '9960000', '3000000', '19920000', '6000000', '12', '汇添富基金管理有限公司', '东海证券有限责任公司'}",1144901,4,"{'1500000', '9960000', '19920000', '39840000'}",2,"{'现金', '12'}",11,"{'北京中金信国资产管理中心(有限合伙)', '天津军博葳投资发展有限公司', '现金', '中邮创业基金管理有限公司', '诺安基金管理有限公司', '北京中金信融资产管理中心(有限合伙)', '3000000', '6000000', '12', '汇添富基金管理有限公司', '东海证券有限责任公司'}"
23,"{'260000000', '600000000', '北京泰生鸿明投资中心(有限合伙)', '杭州渝逸投资管理合伙企业(有限合伙)', '厦门国贸资产管理有限公司设立的国贸资管定增一号资产管理计划', '37681159', '厦门建发股份有限公司', '21739130', '200000000', '宁波梅山保税港区弘茂互联投资合伙企业(有限合伙)', '现金', '390000000', '定价', '72463768', '28985507', '150000000', '珠海市蓝桥基金管理有限公司', '杭州渝洋投资管理合伙企业(有限合伙)', '86956521', '杨学平', '56521739', '500000000', '36'}",15632470,12,"{'150000000', '260000000', '390000000', '600000000', '56521739', '37681159', '72463768', '500000000', '21739130', '86956521', '28985507', '200000000'}",7,"{'现金', '珠海市蓝桥基金管理有限公司', '定价', '厦门国贸资产管理有限公司设立的国贸资管定增一号资产管理计划', '厦门建发股份有限公司', '杨学平', '36'}",11,"{'宁波梅山保税港区弘茂互联投资合伙企业(有限合伙)', '现金', '珠海市蓝桥基金管理有限公司', '北京泰生鸿明投资中心(有限合伙)', '定价', '杭州渝逸投资管理合伙企业(有限合伙)', '厦门国贸资产管理有限公司设立的国贸资管定增一号资产管理计划', '厦门建发股份有限公司', '杭州渝洋投资管理合伙企业(有限合伙)', '杨学平', '36'}"
15,"{'20979020', '广发证券资产管理(广东)有限公司', '11988011', '38701298', '王敏', '申万菱信(上海)资产管理有限公司', '东海基金管理有限责任公司', '财通基金管理有限公司', '16431568', '竞价', '14985014', '泰达宏利基金管理有限公司', '4807197', '汇添富基金管理股份有限公司', '12'}",310686,6,"{'20979020', '38701298', '16431568', '竞价', '14985014', '4807197'}",1,{'12'},9,"{'广发证券资产管理(广东)有限公司', '11988011', '王敏', '申万菱信(上海)资产管理有限公司', '东海基金管理有限责任公司', '财通基金管理有限公司', '泰达宏利基金管理有限公司', '汇添富基金管理股份有限公司', '12'}"
5,"{'现金', '广西黑五类食品集团有限责任公司', '77972709', '竞价', '36'}",1717569,0,set(),4,"{'竞价', '现金', '广西黑五类食品集团有限责任公司', '36'}",5,"{'现金', '广西黑五类食品集团有限责任公司', '77972709', '竞价', '36'}"
19,"{'招商财富资产管理有限公司', '109090909', '149999998.5', '现金', '天津滨海发展投资控股有限公司', '博时资本管理有限公司', '167099999', '华夏基金管理有限公司', '7254546', '申万菱信(上海)资产管理有限公司', '30381818', '东海基金管理有限责任公司', '27272727', '39900003', '599999999.5', '81818181', '36', '上海沅乙投资中心(有限合伙)', '449999995.5'}",1560299,0,set(),7,"{'招商财富资产管理有限公司', '现金', '博时资本管理有限公司', '华夏基金管理有限公司', '东海基金管理有限责任公司', '36', '天津滨海发展投资控股有限公司'}",19,"{'招商财富资产管理有限公司', '109090909', '149999998.5', '167099999', '博时资本管理有限公司', '天津滨海发展投资控股有限公司', '现金', '华夏基金管理有限公司', '7254546', '申万菱信(上海)资产管理有限公司', '30381818', '东海基金管理有限责任公司', '27272727', '39900003', '599999999.5', '81818181', '36', '上海沅乙投资中心(有限合伙)', '449999995.5'}"
4,"{'江苏爱康实业集团有限公司', '竞价', '现金', '36'}",1782328,1,{'竞价'},3,"{'江苏爱康实业集团有限公司', '现金', '36'}",3,"{'江苏爱康实业集团有限公司', '现金', '36'}"
5,"{'150000000', '现金', '陈高琪', '竞价', '36'}",1494753,1,{'150000000'},4,"{'陈高琪', '现金', '竞价', '36'}",4,"{'陈高琪', '现金', '竞价', '36'}"
9,"{'光大金控(上海)投资中心(有限合伙)', '现金', '华安基金管理有限公司', '定价', '山南智佳投资咨询有限公司', '1238000', '光大金控(上海)投资咨询合伙企业(有限合伙)', '长城证券有限责任公司', '1000000'}",938467,3,"{'1000000', '1238000', '山南智佳投资咨询有限公司'}",4,"{'长城证券有限责任公司', '定价', '现金', '华安基金管理有限公司'}",6,"{'光大金控(上海)投资中心(有限合伙)', '现金', '华安基金管理有限公司', '定价', '光大金控(上海)投资咨询合伙企业(有限合伙)', '长城证券有限责任公司'}"
9,"{'445200000', '现金', '40000000', '马玲芝', '556500000', '竞价', '50000000', '张亦斌', '36'}",1782282,5,"{'40000000', '556500000', '竞价', '50000000', '445200000'}",4,"{'马玲芝', '现金', '张亦斌', '36'}",4,"{'马玲芝', '现金', '张亦斌', '36'}"
10,"{'广发证券资产管理(广东)有限公司', '现金', '宝盈基金管理有限公司', '平安资产管理有限责任公司', '财通基金管理有限公司', '鹏华基金管理有限公司', '信达证券股份有限公司', '建信基金管理有限责任公司', '12', '国联证券股份有限公司'}",287398,0,set(),2,"{'现金', '12'}",10,"{'广发证券资产管理(广东)有限公司', '现金', '宝盈基金管理有限公司', '平安资产管理有限责任公司', '财通基金管理有限公司', '鹏华基金管理有限公司', '信达证券股份有限公司', '建信基金管理有限责任公司', '12', '国联证券股份有限公司'}"
6,"{'100000000', '60000000', '竞价', '安徽江淮汽车集团有限公司', '合肥市国有资产控股有限公司', '36'}",1530891,1,{'竞价'},2,"{'36', '安徽江淮汽车集团有限公司'}",5,"{'100000000', '60000000', '安徽江淮汽车集团有限公司', '合肥市国有资产控股有限公司', '36'}"
12,"{'20000000', '朱妙福', '现金', '8000000', '天津硅谷天堂', '科达商贸', '4000000', '刘洋', '37000000', '10000000', '36', '吴仲翔'}",1630597,3,"{'8000000', '37000000', '4000000'}",8,"{'20000000', '36', '现金', '天津硅谷天堂', '科达商贸', '刘洋', '朱妙福', '吴仲翔'}",9,"{'20000000', '朱妙福', '现金', '天津硅谷天堂', '科达商贸', '刘洋', '10000000', '36', '吴仲翔'}"
24,"{'252780000', '600000000', '14241633', '6749659', '7120816', '6000000', '284363100', '韬蕴十号', '8440473', '现金', '定价', '9904100', '300000000', '12580109', '员工持股计划', '辉石盛世', '飞鹏投资', '530000000', '泽浩基金', '355597130', '417259770', '联礼阳', '湾流投资', '36'}",1875994,14,"{'252780000', '12580109', '6000000', '8440473', '600000000', '530000000', '14241633', '9904100', '355597130', '417259770', '6749659', '300000000', '7120816', '284363100'}",10,"{'飞鹏投资', '现金', '泽浩基金', '定价', '员工持股计划', '辉石盛世', '联礼阳', '湾流投资', '36', '韬蕴十号'}",10,"{'飞鹏投资', '现金', '定价', '泽浩基金', '员工持股计划', '辉石盛世', '联礼阳', '湾流投资', '36', '韬蕴十号'}"
13,"{'117000000', '现金', '山东海洋投资有限公司', '山东高速集团有限公司', '中国长城资产管理公司', '73600000', '兖矿集团有限公司', '中国华融资产管理公司', '39000000', '18878600', '12', '山东省国有资产投资控股有限公司', '78000000'}",1464157,2,"{'18878600', '78000000'}",5,"{'现金', '中国长城资产管理公司', '兖矿集团有限公司', '中国华融资产管理公司', '12'}",11,"{'117000000', '现金', '山东海洋投资有限公司', '山东高速集团有限公司', '中国长城资产管理公司', '73600000', '兖矿集团有限公司', '中国华融资产管理公司', '39000000', '12', '山东省国有资产投资控股有限公司'}"
5,"{'现金', '航天投资', '上航工业', '竞价', '36'}",1817982,0,set(),5,"{'现金', '航天投资', '上航工业', '竞价', '36'}",5,"{'现金', '航天投资', '上航工业', '竞价', '36'}"
6,"{'6536098800', '现金', '286671000', '定价', '杭州云溪投资合伙企业(有限合伙)', '36'}",1634307,2,"{'6536098800', '杭州云溪投资合伙企业(有限合伙)'}",3,"{'定价', '现金', '36'}",4,"{'现金', '定价', '36', '286671000'}"
7,"{'现金', '25765200', '嘉实基金管理有限公司', '11225400', '中船投资发展有限公司', '9354500', '汇安基金管理有限责任公司'}",15699949,0,set(),4,"{'中船投资发展有限公司', '现金', '嘉实基金管理有限公司', '汇安基金管理有限责任公司'}",7,"{'现金', '25765200', '嘉实基金管理有限公司', '11225400', '中船投资发展有限公司', '9354500', '汇安基金管理有限责任公司'}"
25,"{'102000000', '116800036.8', '15931372', '申万菱信(上海)资产管理有限公司', '西藏自治区投资有限公司', '12500000', '112999998.2', '11887254', '14313730', '12', '定价', '129999995.5', '财通基金管理有限公司', '96999992.64', '华夏人寿保险股份有限公司', '97999992.48', '诺安基金管理有限公司', '东海基金管理有限责任公司', '12009803', '北京鼎博文化发展有限公司', '13848039', '华宝信托有限责任公司', '14215686', '中国华电集团资本控股有限公司', '115999997.8'}",1807828,3,"{'96999992.64', '115999997.8', '97999992.48'}",10,"{'华夏人寿保险股份有限公司', '中国华电集团资本控股有限公司', '诺安基金管理有限公司', '定价', '东海基金管理有限责任公司', '财通基金管理有限公司', '西藏自治区投资有限公司', '华宝信托有限责任公司', '北京鼎博文化发展有限公司', '12'}",22,"{'102000000', '15931372', '申万菱信(上海)资产管理有限公司', '西藏自治区投资有限公司', '12500000', '112999998.2', '11887254', '14313730', '12', '定价', '129999995.5', '财通基金管理有限公司', '华夏人寿保险股份有限公司', '诺安基金管理有限公司', '东海基金管理有限责任公司', '12009803', '北京鼎博文化发展有限公司', '13848039', '华宝信托有限责任公司', '14215686', '116800036.8', '中国华电集团资本控股有限公司'}"
13,"{'14000000', '13000000', '融通基金管理有限公司', '15000000', '张大中', '7000000', '国泰基金管理有限公司', '海通证券股份有限公司', '鹏华基金管理有限公司', '10000000', '12', '江苏开元国际集团轻工业品进出口股份有限公司', '太平资产管理有限公司'}",1242245,1,{'14000000'},8,"{'融通基金管理有限公司', '张大中', '国泰基金管理有限公司', '海通证券股份有限公司', '鹏华基金管理有限公司', '12', '江苏开元国际集团轻工业品进出口股份有限公司', '太平资产管理有限公司'}",12,"{'13000000', '融通基金管理有限公司', '15000000', '张大中', '7000000', '国泰基金管理有限公司', '海通证券股份有限公司', '鹏华基金管理有限公司', '10000000', '12', '江苏开元国际集团轻工业品进出口股份有限公司', '太平资产管理有限公司'}"
18,"{'5000000', '现金', '光大证券股份有限公司', '华安基金管理有限公司', '4000000', '博时基金管理有限公司', '嘉实基金管理有限公司', '2000000', '易方达基金管理有限公司', '广发基金管理有限公司', '3000000', '750000', '4380000', '中国人寿资产管理有限公司', '建信基金管理有限责任公司', '荷兰银行有限公司', '12', '海富通基金管理有限公司'}",537385,2,"{'750000', '4380000'}",4,"{'光大证券股份有限公司', '现金', '荷兰银行有限公司', '12'}",16,"{'5000000', '现金', '光大证券股份有限公司', '华安基金管理有限公司', '4000000', '博时基金管理有限公司', '嘉实基金管理有限公司', '2000000', '易方达基金管理有限公司', '广发基金管理有限公司', '3000000', '中国人寿资产管理有限公司', '建信基金管理有限责任公司', '荷兰银行有限公司', '12', '海富通基金管理有限公司'}"
4,"{'36', '竞价', '现金', '陈志成'}",1810601,0,set(),4,"{'36', '竞价', '现金', '陈志成'}",4,"{'36', '竞价', '现金', '陈志成'}"
20,"{'广发证券资产管理(广东)有限公司', '115111100', '现金', '49980000', '30300000', '12', '121380000', '英大基金管理有限公司', '16122000', '7000000', '竞价', '17000000', '57900000', '413406000', '216342000', '宝盈基金管理有限公司', '厦门建发股份有限公司', '东海证券股份有限公司', '姚雄杰', '36'}",578394,9,"{'115111100', '49980000', '30300000', '121380000', '16122000', '竞价', '57900000', '413406000', '216342000'}",8,"{'现金', '12', '英大基金管理有限公司', '东海证券股份有限公司', '厦门建发股份有限公司', '宝盈基金管理有限公司', '姚雄杰', '36'}",11,"{'广发证券资产管理(广东)有限公司', '36', '现金', '英大基金管理有限公司', '7000000', '东海证券股份有限公司', '17000000', '厦门建发股份有限公司', '宝盈基金管理有限公司', '姚雄杰', '12'}"
3,"{'现金', '36', '深圳市华融泰资产管理有限公司'}",1025809,0,set(),3,"{'现金', '36', '深圳市华融泰资产管理有限公司'}",3,"{'现金', '36', '深圳市华融泰资产管理有限公司'}"
4,"{'竞价', '现金', '36', '海南筑华科工贸有限公司'}",887686,0,set(),4,"{'竞价', '现金', '36', '海南筑华科工贸有限公司'}",4,"{'竞价', '现金', '36', '海南筑华科工贸有限公司'}"
18,"{'浙江天堂硅谷盈丰股权投资合伙企业(有限合伙)', '现金', '新华基金管理有限公司', '8090000', '33620000', '25800000', '广发证券股份有限公司', '建信基金管理有限责任公司', '中广核财务有限责任公司', '华泰资产管理有限公司', '29700000', '25700000', '21300000', '成尧妹', '2650000', '宝盈基金管理有限公司', '64280000', '12'}",1045208,0,set(),3,"{'现金', '12', '华泰资产管理有限公司'}",18,"{'浙江天堂硅谷盈丰股权投资合伙企业(有限合伙)', '现金', '新华基金管理有限公司', '8090000', '33620000', '25800000', '广发证券股份有限公司', '建信基金管理有限责任公司', '中广核财务有限责任公司', '华泰资产管理有限公司', '29700000', '25700000', '21300000', '成尧妹', '2650000', '宝盈基金管理有限公司', '64280000', '12'}"
5,"{'223199749', '定价', '南京南瑞集团公司', '股权', '36'}",1062878,1,{'定价'},3,"{'股权', '36', '南京南瑞集团公司'}",4,"{'223199749', '股权', '36', '南京南瑞集团公司'}"
13,"{'现金', '896057', '兴业全球基金管理有限公司', '王学海', '67204301', '8960573', '1344086', '定价', '武汉当代科技产业集团股份有限公司', '35842292', '李杰', '汇添富基金管理股份有限公司', '36'}",1574059,2,"{'定价', '35842292'}",6,"{'现金', '王学海', '武汉当代科技产业集团股份有限公司', '李杰', '汇添富基金管理股份有限公司', '36'}",11,"{'现金', '896057', '兴业全球基金管理有限公司', '王学海', '67204301', '8960573', '1344086', '武汉当代科技产业集团股份有限公司', '李杰', '汇添富基金管理股份有限公司', '36'}"
5,"{'现金', '竞价', '300000000', '钟烈华', '36'}",4929265,1,{'300000000'},4,"{'竞价', '现金', '36', '钟烈华'}",4,"{'竞价', '现金', '36', '钟烈华'}"
10,"{'中信华东', '150000000', '国之杰', '现金', '中信集团', '242420023', '竞价', '969680093', '股权', '36'}",1357260,1,{'竞价'},6,"{'中信华东', '国之杰', '现金', '中信集团', '股权', '36'}",9,"{'中信华东', '150000000', '国之杰', '现金', '中信集团', '242420023', '969680093', '股权', '36'}"
4,"{'东方投控', '竞价', '现金', '36'}",1760442,0,set(),4,"{'东方投控', '竞价', '现金', '36'}",4,"{'东方投控', '竞价', '现金', '36'}"
15,"{'潘加龙', '现金', '兵器财务有限责任公司', '16000000', '天津证大金龙股权投资基金合伙企业(有限合伙)', '吴燕恋', '百年化妆护理品有限公司', '江苏瑞华投资发展有限公司', '15000000', '9000000', '浙江天堂硅谷乐通股权投资合伙企业(有限合伙)', '东吴证券股份有限公司', '景隆融尊(天津)股权投资基金合伙企业(有限合伙)', '10000000', '12'}",1506059,0,set(),11,"{'潘加龙', '现金', '兵器财务有限责任公司', '天津证大金龙股权投资基金合伙企业(有限合伙)', '吴燕恋', '百年化妆护理品有限公司', '江苏瑞华投资发展有限公司', '浙江天堂硅谷乐通股权投资合伙企业(有限合伙)', '东吴证券股份有限公司', '景隆融尊(天津)股权投资基金合伙企业(有限合伙)', '12'}",15,"{'潘加龙', '兵器财务有限责任公司', '现金', '16000000', '天津证大金龙股权投资基金合伙企业(有限合伙)', '吴燕恋', '百年化妆护理品有限公司', '江苏瑞华投资发展有限公司', '15000000', '9000000', '浙江天堂硅谷乐通股权投资合伙企业(有限合伙)', '东吴证券股份有限公司', '景隆融尊(天津)股权投资基金合伙企业(有限合伙)', '10000000', '12'}"
17,"{'400140187.2', '5293627', '定价', '东海基金管理有限责任公司', '财通基金管理有限公司', '嘉实基金管理有限公司', '8677884', '406124971.2', '400823982', '8564615', '广发基金管理有限公司', '8550004', '宝盈基金管理有限公司', '11648912', '545169081.6', '247741743.6', '12'}",12020762,0,set(),7,"{'定价', '东海基金管理有限责任公司', '嘉实基金管理有限公司', '财通基金管理有限公司', '广发基金管理有限公司', '宝盈基金管理有限公司', '12'}",17,"{'400140187.2', '5293627', '定价', '东海基金管理有限责任公司', '嘉实基金管理有限公司', '财通基金管理有限公司', '8677884', '406124971.2', '400823982', '8564615', '广发基金管理有限公司', '8550004', '宝盈基金管理有限公司', '11648912', '545169081.6', '247741743.6', '12'}"
4,"{'36', '定价', '上海建筑材料(集团)总公司', '20999317'}",1501636,1,{'定价'},1,{'36'},3,"{'36', '上海建筑材料(集团)总公司', '20999317'}"
6,"{'现金', '定价', '第一期员工持股计划', '254000000', '25000000', '36'}",4953205,2,"{'254000000', '25000000'}",4,"{'第一期员工持股计划', '36', '定价', '现金'}",4,"{'第一期员工持股计划', '定价', '现金', '36'}"
28,"{'3833866', '59999987.25', '10000350', '5600000', '19875500', '现金', '上海远洋渔业有限公司', '定价', '60000002.9', '王梅', '财通基金管理有限公司', '联储证券有限责任公司', '12999985.5', '14663526', '87640000', '36', '上海市北高新股份有限公司', '830670', '229484181.9', '华福证券有限责任公司', '大连隆泰创业投资有限责任公司', '1270000', '7667731', '隋启海', '119999990.2', '639000', '12', '3833865'}",18273972,1,{'119999990.2'},12,"{'36', '现金', '上海远洋渔业有限公司', '上海市北高新股份有限公司', '定价', '隋启海', '王梅', '财通基金管理有限公司', '联储证券有限责任公司', '华福证券有限责任公司', '大连隆泰创业投资有限责任公司', '12'}",27,"{'3833866', '59999987.25', '10000350', '5600000', '19875500', '现金', '上海远洋渔业有限公司', '60000002.9', '定价', '王梅', '财通基金管理有限公司', '联储证券有限责任公司', '12999985.5', '14663526', '87640000', '36', '上海市北高新股份有限公司', '830670', '229484181.9', '华福证券有限责任公司', '大连隆泰创业投资有限责任公司', '1270000', '7667731', '隋启海', '639000', '12', '3833865'}"
22,"{'853113', '华夏基金—全国社保基金一零七组合', '685564', '720124', '华夏基金—华夏蓝筹核心混合型证券投资基金( LOF)', '华夏基金—华夏复兴股票型证券投资基金', '华夏基金—华夏成长证券投资基金', '现金', '定价', '华夏基金—华夏平稳增长混合型证券投资基金', '富国基金—汉盛证券投资基金', '华夏基金—华夏红利混合型开放式证券投资基金', '500000', '华夏基金—华夏优势增长股票型证券投资基金', '163547', '108336', '大成基金—大成创新成长混合型证券投资基金', '2000000', '969316', '富国基金—汉兴证券投资基金', '1000000', '12'}",1345532,9,"{'853113', '685564', '500000', '720124', '2000000', '华夏基金—华夏蓝筹核心混合型证券投资基金( LOF)', '969316', '163547', '108336'}",3,"{'定价', '现金', '12'}",13,"{'现金', '华夏基金—全国社保基金一零七组合', '富国基金—汉盛证券投资基金', '华夏基金—华夏红利混合型开放式证券投资基金', '定价', '大成基金—大成创新成长混合型证券投资基金', '华夏基金—华夏优势增长股票型证券投资基金', '富国基金—汉兴证券投资基金', '1000000', '华夏基金—华夏成长证券投资基金', '12', '华夏基金—华夏平稳增长混合型证券投资基金', '华夏基金—华夏复兴股票型证券投资基金'}"
14,"{'17125000', '现金', '中天资产', '定价', '13062500', '猎象资本', '盛世聚金', '盛世和金', '中睿智汇', '9000000', '28500000', '36', '14250000', '合涌源发展'}",1790753,0,set(),9,"{'现金', '中天资产', '定价', '猎象资本', '盛世聚金', '中睿智汇', '盛世和金', '36', '合涌源发展'}",14,"{'17125000', '现金', '中天资产', '定价', '13062500', '猎象资本', '盛世聚金', '盛世和金', '中睿智汇', '9000000', '28500000', '36', '14250000', '合涌源发展'}"
13,"{'36', '国金证券股份有限公司', '兵工财务有限责任公司', '定价', '18000000', '21400000', '中国长城资产管理公司', '68570000', '天津市津信实业公司', '天津药业集团有限公司', '9000000', '12', '29550000'}",237394,0,set(),6,"{'国金证券股份有限公司', '12', '定价', '天津市津信实业公司', '天津药业集团有限公司', '36'}",13,"{'36', '国金证券股份有限公司', '兵工财务有限责任公司', '18000000', '定价', '21400000', '中国长城资产管理公司', '68570000', '天津市津信实业公司', '天津药业集团有限公司', '9000000', '12', '29550000'}"
31,"{'439882697', '博时资本管理有限公司', '长江资管设立的长江兴利2号定向计划', '29325513', '54599999.3', '8005865', '广州证券股份有限公司', '199999998.7', '长江资管设立的长江兴利3号定向计划', '现金', '96774193', '299999994.6', '2999999994', '12', '1249999997', '竞价', '1140000005', '183284457', '英飞海林投资中心', '131964809', '民生加银基金管理有限公司', '东旭集团', '167155426', '昆山开发区国投', '43988269', '72639296', '659999996.3', '899999997.4', '495399998.7', '华安未来资产管理(上海)有限公司', '36'}",1840635,8,"{'299999994.6', '2999999994', '昆山开发区国投', '1249999997', '659999996.3', '竞价', '899999997.4', '199999998.7'}",8,"{'英飞海林投资中心', '民生加银基金管理有限公司', '博时资本管理有限公司', '现金', '东旭集团', '12', '广州证券股份有限公司', '36'}",23,"{'439882697', '博时资本管理有限公司', '长江资管设立的长江兴利2号定向计划', '29325513', '54599999.3', '8005865', '广州证券股份有限公司', '长江资管设立的长江兴利3号定向计划', '现金', '96774193', '1140000005', '183284457', '36', '英飞海林投资中心', '131964809', '民生加银基金管理有限公司', '东旭集团', '167155426', '43988269', '72639296', '495399998.7', '华安未来资产管理(上海)有限公司', '12'}"
6,"{'现金', '118000000', '42000000', '嘉兴市中辰建设管理有限公司', '36', '刘益谦'}",1126517,2,"{'42000000', '118000000'}",4,"{'嘉兴市中辰建设管理有限公司', '现金', '36', '刘益谦'}",4,"{'嘉兴市中辰建设管理有限公司', '现金', '36', '刘益谦'}"
5,"{'现金', '40000000', '竞价', '北汽控股', '36'}",1360943,1,{'竞价'},3,"{'现金', '北汽控股', '36'}",4,"{'40000000', '现金', '北汽控股', '36'}"
9,"{'18947360', '179999920', '719999680', '12', '定价', '昆明钢铁控股有限公司', '75789440', '建信基金管理有限责任公司', '36'}",395602,4,"{'719999680', '18947360', '179999920', '75789440'}",5,"{'12', '定价', '昆明钢铁控股有限公司', '建信基金管理有限责任公司', '36'}",5,"{'36', '定价', '昆明钢铁控股有限公司', '建信基金管理有限责任公司', '12'}"
6,"{'5000000', '现金', '竞价', '工投集团', '南天集团', '36'}",1232501,1,{'竞价'},4,"{'工投集团', '南天集团', '现金', '36'}",5,"{'5000000', '现金', '工投集团', '南天集团', '36'}"
22,"{'阳光财产保险股份有限公司', '265486726', '北京能源集团有限责任公司', '北京联东投资(集团)有限公司', '144000000', '现金', '6341283179', '1026720000', '定价', '889380530', '北京市国有资产经营有限责任公司', '1514336279', '1892920356', '720000000', '212389380', 'ING Bank N.V.', '2839380527', '中国长江三峡集团公司', '阳光人寿保险股份有限公司', '398230088', '5133600000', '36'}",18856621,5,"{'212389380', '6341283179', '265486726', '889380530', '144000000'}",9,"{'现金', 'ING Bank N.V.', '阳光财产保险股份有限公司', '中国长江三峡集团公司', '定价', '阳光人寿保险股份有限公司', '北京能源集团有限责任公司', '北京市国有资产经营有限责任公司', '36'}",17,"{'1892920356', '现金', '2839380527', '阳光财产保险股份有限公司', 'ING Bank N.V.', '中国长江三峡集团公司', '1026720000', '定价', '阳光人寿保险股份有限公司', '398230088', '北京能源集团有限责任公司', '720000000', '北京市国有资产经营有限责任公司', '1514336279', '5133600000', '北京联东投资(集团)有限公司', '36'}"
16,"{'南京瑞森投资管理合伙企业(有限合伙)', '北方凌云工业集团有限公司', '中兵投资管理有限责任公司', '现金', '11152416', '150000000', '400000000', '长城国融投资管理有限公司', '3717472', '定价', '苏州瑞顺创业投资企业(有限合伙)', '50000000', '200000000', '29739776', '36', '14869888'}",1823462,1,{'定价'},5,"{'北方凌云工业集团有限公司', '中兵投资管理有限责任公司', '现金', '长城国融投资管理有限公司', '36'}",15,"{'南京瑞森投资管理合伙企业(有限合伙)', '北方凌云工业集团有限公司', '中兵投资管理有限责任公司', '150000000', '11152416', '3717472', '400000000', '长城国融投资管理有限公司', '现金', '苏州瑞顺创业投资企业(有限合伙)', '50000000', '200000000', '29739776', '36', '14869888'}"
5,"{'财通基金管理有限公司', '86699994', '竞价', '3729032', '12'}",1734589,2,"{'86699994', '竞价'}",2,"{'12', '财通基金管理有限公司'}",3,"{'3729032', '12', '财通基金管理有限公司'}"
24,"{'深圳天风天成资产管理有限公司', '26116838', '国联安基金管理有限公司', '易方达基金管理有限公司', '20525265', '华富基金管理有限公司', '835999984.4', '现金', '1491000000', '定价', '财通基金管理有限公司', '26023117', '36363636', '839999986', '26241799', '中信证券股份有限公司', '657013732.7', '浙江浙银资本管理有限公司', '金鹰基金管理有限公司', '1163999988', '832999975.2', '46579194', '12', '汇安基金管理有限责任公司'}",15621163,5,"{'835999984.4', '839999986', '1491000000', '832999975.2', '657013732.7'}",12,"{'金鹰基金管理有限公司', '现金', '深圳天风天成资产管理有限公司', '定价', '国联安基金管理有限公司', '财通基金管理有限公司', '易方达基金管理有限公司', '中信证券股份有限公司', '浙江浙银资本管理有限公司', '华富基金管理有限公司', '12', '汇安基金管理有限责任公司'}",19,"{'金鹰基金管理有限公司', '现金', '深圳天风天成资产管理有限公司', '26241799', '定价', '1163999988', '26116838', '财通基金管理有限公司', '汇安基金管理有限责任公司', '易方达基金管理有限公司', '国联安基金管理有限公司', '中信证券股份有限公司', '46579194', '20525265', '浙江浙银资本管理有限公司', '华富基金管理有限公司', '36363636', '12', '26023117'}"
9,"{'中国中化股份有限公司', '中国石油化工集团公司', '现金', '定价', '214330000', '490844000', '153175400', '中国人寿保险股份有限公司', '36'}",557091,2,"{'490844000', '153175400'}",6,"{'中国中化股份有限公司', '中国石油化工集团公司', '现金', '定价', '中国人寿保险股份有限公司', '36'}",7,"{'中国中化股份有限公司', '现金', '中国石油化工集团公司', '定价', '214330000', '中国人寿保险股份有限公司', '36'}"
19,"{'5719844', '146999990.8', '36', '现金', '5227238', '九泰基金管理有限公司', '149999977.5', '144999991.1', '林菁', '134340016.6', '财通基金管理有限公司', '竞价', '5642023', '100000010.7', '5836575', '北京和聚投资管理有限公司', '3891051', '12', '西藏泓涵股权投资管理有限公司'}",15335586,0,set(),6,"{'现金', '林菁', '12', '财通基金管理有限公司', '竞价', '36'}",19,"{'5719844', '146999990.8', '36', '现金', '5227238', '九泰基金管理有限公司', '149999977.5', '144999991.1', '林菁', '134340016.6', '财通基金管理有限公司', '竞价', '5642023', '100000010.7', '5836575', '北京和聚投资管理有限公司', '3891051', '12', '西藏泓涵股权投资管理有限公司'}"
9,"{'5000000', '现金', '宝钢集团有限公司', '深圳广晟投资发展有限公司', '12', '易方达基金管理有限公司', '25000000', '30000000', '36'}",967088,0,set(),3,"{'现金', '宝钢集团有限公司', '12'}",9,"{'5000000', '现金', '宝钢集团有限公司', '深圳广晟投资发展有限公司', '12', '易方达基金管理有限公司', '25000000', '30000000', '36'}"
21,"{'蒋亨福', '深圳市方德智联投资管理有限公司', '3000000', '49740000', '6000000', '现金', '定价', '1989600', '长安财富资产管理有限公司', '570571701.6', '43937000', '34413251', '1800000', '120000', '吴美莉', '上海善达投资管理有限公司', '吴国仕', '99480000', '29844000', '2650000', '36'}",1669805,3,"{'29844000', '570571701.6', '1800000'}",9,"{'现金', '定价', '蒋亨福', '深圳市方德智联投资管理有限公司', '吴美莉', '上海善达投资管理有限公司', '吴国仕', '36', '长安财富资产管理有限公司'}",18,"{'现金', '99480000', '43937000', '定价', '1989600', '34413251', '2650000', '蒋亨福', '120000', '深圳市方德智联投资管理有限公司', '上海善达投资管理有限公司', '吴美莉', '3000000', '49740000', '6000000', '吴国仕', '36', '长安财富资产管理有限公司'}"
3,"{'竞价', '现金', '千石元享定增1号'}",4940184,0,set(),2,"{'竞价', '现金'}",3,"{'竞价', '现金', '千石元享定增1号'}"
16,"{'苏州高新区国有资产经营公司', '109000000', '121000000', '苏州国际发展集团有限公司', '中新苏州工业园区城市投资运营有限公司', '60', '70000000', '张家港市直属公有资产经营有限公司', '130000000', '苏州风景园林投资发展集团有限公司', '中国人寿资产管理有限公司', '中船投资发展有限公司', '华富基金管理有限公司', '30000000', '12', '苏州交通投资有限责任公司'}",396645,1,{'109000000'},11,"{'苏州高新区国有资产经营公司', '苏州国际发展集团有限公司', '中新苏州工业园区城市投资运营有限公司', '60', '张家港市直属公有资产经营有限公司', '苏州风景园林投资发展集团有限公司', '中国人寿资产管理有限公司', '中船投资发展有限公司', '华富基金管理有限公司', '12', '苏州交通投资有限责任公司'}",15,"{'苏州高新区国有资产经营公司', '121000000', '苏州国际发展集团有限公司', '中新苏州工业园区城市投资运营有限公司', '60', '70000000', '张家港市直属公有资产经营有限公司', '130000000', '苏州风景园林投资发展集团有限公司', '中国人寿资产管理有限公司', '中船投资发展有限公司', '华富基金管理有限公司', '30000000', '12', '苏州交通投资有限责任公司'}"
18,"{'2978723', '姚必正', '李冠男', '现金', '4893617', '400000000', '上银基金财富55号资产管理计划', '70000000', '定价', '上银基金春兴精工1号资产管理计划', '袁斌', '305000000', '300000000', '12765957', '12978723', '115000000', '36', '17021276'}",1674364,11,"{'4893617', '上银基金财富55号资产管理计划', '70000000', '上银基金春兴精工1号资产管理计划', '305000000', '300000000', '12978723', '12765957', '115000000', '2978723', '17021276'}",6,"{'姚必正', '李冠男', '现金', '定价', '袁斌', '36'}",7,"{'姚必正', '李冠男', '现金', '400000000', '定价', '袁斌', '36'}"
15,"{'800000000', '150000000', '现金', '生态1期计划', '277850000', '844316', '财富证券', '定价', '65897858', '12355848', '10250000', '昆明农投', '云投集团', '22887149', '36'}",1774006,0,set(),6,"{'现金', '财富证券', '定价', '昆明农投', '云投集团', '36'}",15,"{'800000000', '150000000', '现金', '生态1期计划', '277850000', '844316', '财富证券', '定价', '65897858', '12355848', '10250000', '昆明农投', '云投集团', '22887149', '36'}"
14,"{'12650000', '4750000', '现金', '银华基金管理有限公司', '4950000', '上投摩根基金管理有限公司', '9500000', '定价', '平安资产管理有限责任公司', '博时基金管理有限公司', '7450000', '海通证券股份有限公司', '民生通惠资产管理有限公司', '12'}",983620,6,"{'12650000', '4750000', '4950000', '9500000', '定价', '7450000'}",2,"{'现金', '12'}",8,"{'现金', '银华基金管理有限公司', '上投摩根基金管理有限公司', '博时基金管理有限公司', '平安资产管理有限责任公司', '海通证券股份有限公司', '民生通惠资产管理有限公司', '12'}"
15,"{'4182951', '金鹰基金管理有限公司', '3299405', '现金', '张家港市金城融创投资管理有限公司', '西部证券股份有限公司', '定价', '财通基金管理有限公司', '2980199', '1707048', '2202643', '富安达资产管理(上海)有限公司', '2147577', '张家港市金茂创业投资有限公司', '12'}",310782,0,set(),8,"{'金鹰基金管理有限公司', '现金', '张家港市金城融创投资管理有限公司', '西部证券股份有限公司', '定价', '财通基金管理有限公司', '张家港市金茂创业投资有限公司', '12'}",15,"{'4182951', '金鹰基金管理有限公司', '3299405', '张家港市金城融创投资管理有限公司', '现金', '西部证券股份有限公司', '定价', '财通基金管理有限公司', '2980199', '1707048', '2202643', '富安达资产管理(上海)有限公司', '2147577', '张家港市金茂创业投资有限公司', '12'}"
5,"{'现金', '竞价', '62536443', '建信基金管理有限责任公司', '12'}",1096141,0,set(),4,"{'竞价', '现金', '12', '建信基金管理有限责任公司'}",5,"{'现金', '竞价', '62536443', '建信基金管理有限责任公司', '12'}"
14,"{'平安大华基金管理有限公司', '现金', '第一创业证券股份有限公司', '5552470', '12', '8883952', '财通基金管理有限公司', '北京矿冶研究总院', '4469738', '竞价', '1081844', '国投瑞银基金管理有限公司', '36', '2221876'}",1806901,1,{'竞价'},8,"{'平安大华基金管理有限公司', '36', '现金', '第一创业证券股份有限公司', '财通基金管理有限公司', '北京矿冶研究总院', '国投瑞银基金管理有限公司', '12'}",13,"{'平安大华基金管理有限公司', '现金', '第一创业证券股份有限公司', '5552470', '12', '8883952', '财通基金管理有限公司', '北京矿冶研究总院', '4469738', '1081844', '国投瑞银基金管理有限公司', '36', '2221876'}"
12,"{'370780042', '现金', '青岛海尔股份有限公司', '定价', '上海文化广播影视集团有限公司', '2200000000', '上海东方明珠新媒体股份有限公司', '89001554', '178003108', '1100000000', '30000000', '36'}",1673337,3,"{'370780042', '1100000000', '2200000000'}",6,"{'现金', '青岛海尔股份有限公司', '定价', '上海文化广播影视集团有限公司', '上海东方明珠新媒体股份有限公司', '36'}",9,"{'现金', '青岛海尔股份有限公司', '定价', '上海文化广播影视集团有限公司', '上海东方明珠新媒体股份有限公司', '89001554', '178003108', '30000000', '36'}"
4,"{'中国节能环保集团公司', '现金', '竞价', '36'}",343499,1,{'36'},3,"{'中国节能环保集团公司', '现金', '竞价'}",3,"{'中国节能环保集团公司', '现金', '竞价'}"
13,"{'鲁商集团', '鲁商有限', '东方航华', '1181600', '通利商业', '12', '定价', '34432500', '38441600', '366739200', '23923100', '世贸中心', '36'}",1205275,0,set(),8,"{'鲁商集团', '鲁商有限', '东方航华', '36', '通利商业', '定价', '世贸中心', '12'}",13,"{'鲁商集团', '鲁商有限', '东方航华', '1181600', '通利商业', '12', '定价', '34432500', '38441600', '366739200', '23923100', '世贸中心', '36'}"
26,"{'北京北广传媒投资发展中心', '600000000', '10033444', '20066889', '200000000', '现金', '金砖丝路投资(深圳)合伙企业(有限合伙)', '650000000', '定价', '300000000', '百视通新媒体股份有限公司', '中国电影股份有限公司', '新湖中宝股份有限公司', '40133779', '43478260', '150000000', '6688963', '33444816', '中信证券股份有限公司', '江西省广播电视网络传输有限公司', '北京广播公司', '13377926', '100000000', '中信建投证券股份有限公司', '500000000', '36'}",74067,7,"{'150000000', '650000000', '100000000', '600000000', '300000000', '500000000', '200000000'}",11,"{'百视通新媒体股份有限公司', '现金', '北京北广传媒投资发展中心', '定价', '中信证券股份有限公司', '中信建投证券股份有限公司', '新湖中宝股份有限公司', '中国电影股份有限公司', '江西省广播电视网络传输有限公司', '北京广播公司', '36'}",19,"{'百视通新媒体股份有限公司', '现金', '金砖丝路投资(深圳)合伙企业(有限合伙)', '北京北广传媒投资发展中心', '定价', '6688963', '33444816', '10033444', '20066889', '中信证券股份有限公司', '43478260', '中信建投证券股份有限公司', '新湖中宝股份有限公司', '中国电影股份有限公司', '江西省广播电视网络传输有限公司', '40133779', '北京广播公司', '36', '13377926'}"
12,"{'重庆交通运输控股(集团)有限公司', '12', '定价', '重庆市能源投资集团有限公司', '122520000', '重庆市水务资产经营有限公司', '147150000', '建信基金管理有限公司', '200000000', '129880000', '深圳市平安创新资本投资有限公司', '17663780'}",1085852,1,{'122520000'},5,"{'12', '定价', '重庆市能源投资集团有限公司', '重庆市水务资产经营有限公司', '深圳市平安创新资本投资有限公司'}",11,"{'重庆交通运输控股(集团)有限公司', '12', '定价', '重庆市能源投资集团有限公司', '重庆市水务资产经营有限公司', '147150000', '建信基金管理有限公司', '200000000', '129880000', '深圳市平安创新资本投资有限公司', '17663780'}"
5,"{'国联环保', '现金', '22000000', '竞价', '36'}",1221395,1,{'22000000'},4,"{'国联环保', '竞价', '现金', '36'}",4,"{'国联环保', '竞价', '现金', '36'}"
27,"{'20000000', '200000002.8', '24271844', '35015934', '星通创投', '中企港', '432796944.2', '320000004.5', '上海星鸿', '现金', '300000004.2', '750004800', '平安资管', '华夏人寿', '德溢慧心', '中邮基金', '12136000', '24271845', '16181230', '247200000', '299999991.8', '汇垠磐涅', '150000960', '60680000', '深圳中植', '25889968', '36'}",1554857,1,{'320000004.5'},11,"{'36', '现金', '中企港', '星通创投', '平安资管', '深圳中植', '华夏人寿', '德溢慧心', '中邮基金', '汇垠磐涅', '上海星鸿'}",26,"{'20000000', '200000002.8', '24271844', '35015934', '星通创投', '中企港', '432796944.2', '上海星鸿', '现金', '300000004.2', '750004800', '平安资管', '华夏人寿', '德溢慧心', '中邮基金', '12136000', '24271845', '16181230', '247200000', '299999991.8', '汇垠磐涅', '150000960', '60680000', '深圳中植', '25889968', '36'}"
16,"{'宁波协慧投资合伙企业(有限合伙)', '199999996.9', '249999981.3', '现金', '10095912', '149999992.7', '200000016.7', '7571933', '竞价', '中信建投证券股份有限公司', '太仓铭源投资中心(有限合伙)', '12619888', '六安信实资产管理有限公司', '10095911', '李威', '36'}",1815911,2,"{'竞价', '249999981.3'}",5,"{'现金', '中信建投证券股份有限公司', '李威', '六安信实资产管理有限公司', '36'}",14,"{'宁波协慧投资合伙企业(有限合伙)', '199999996.9', '现金', '10095912', '149999992.7', '200000016.7', '7571933', '中信建投证券股份有限公司', '太仓铭源投资中心(有限合伙)', '12619888', '六安信实资产管理有限公司', '10095911', '李威', '36'}"
